chrom,chromStart,chromEnd,name,score,strand,thickStart,thickEnd,itemRgb,blockCount,blockstart,blockSizes,blockStarts,blackend,start,end,Intron,severity
24943ref,1839,10458,JUNC00000035,236,+,1839,10458,255;0;0,2,142,150,0,8469,1981,10308,8327,1
24943ref,1203,8795,JUNC00000027,2,+,1203,8795,255;0;0,2,105,73,0,7519,1308,8722,7414,1
24943ref,1120,7710,JUNC00000023,2,+,1120,7710,255;0;0,2,82,148,0,6442,1202,7562,6360,1
24943ref,1124,6307,JUNC00000025,2,+,1124,6307,255;0;0,2,146,30,0,5153,1270,6277,5007,1
24943ref,2827,8065,JUNC00000039,238,+,2827,8065,255;0;0,2,92,143,0,5095,2919,7922,5003,1
24943ref,5459,10116,JUNC00000061,3,+,5459,10116,255;0;0,2,104,146,0,4511,5563,9970,4407,1
24943ref,5196,9309,JUNC00000058,2,+,5196,9309,255;0;0,2,141,112,0,4001,5337,9197,3860,1
24943ref,973,4126,JUNC00000019,3073,+,973,4126,255;0;0,2,149,150,0,3003,1122,3976,2854,1
24943ref,4257,5791,JUNC00000048,61,-,4257,5791,255;0;0,2,43,148,0,1386,4300,5643,1343,1
24943ref,5478,6831,JUNC00000063,93,+,5478,6831,255;0;0,2,148,149,0,1204,5626,6682,1056,1
24943ref,5018,6189,JUNC00000057,3,-,5018,6189,255;0;0,2,148,63,0,1108,5166,6126,960,1
24943ref,5789,6641,JUNC00000070,45,+,5789,6641,255;0;0,2,148,143,0,709,5937,6498,561,1
24943ref,6110,6665,JUNC00000073,6,-,6110,6665,255;0;0,2,145,57,0,498,6255,6608,353,1
24943ref,652,1133,JUNC00000007,12,+,652,1133,255;0;0,2,22,118,0,363,674,1015,341,1
24943ref,492,1126,JUNC00000005,60,+,492,1126,255;0;0,2,148,150,0,484,640,976,336,1
24943ref,7339,7681,JUNC00000079,1,-,7339,7681,255;0;0,2,97,54,0,288,7436,7627,191,1
24943ref,7316,7718,JUNC00000078,2,-,7316,7718,255;0;0,2,120,95,0,307,7436,7623,187,1
24943ref,8317,8636,JUNC00000097,1,+,8317,8636,255;0;0,2,121,30,0,289,8438,8606,168,1
24943ref,8298,8747,JUNC00000098,20,+,8298,8747,255;0;0,2,148,147,0,302,8446,8600,154,1
24943ref,468,818,JUNC00000003,29,-,468,818,255;0;0,2,60,149,0,201,528,669,141,1
24943ref,582,1013,JUNC00000009,176,+,582,1013,255;0;0,2,148,147,0,284,730,866,136,1
24943ref,4389,4755,JUNC00000053,261,-,4389,4755,255;0;0,2,143,88,0,278,4532,4667,135,1
24943ref,4412,4815,JUNC00000054,171,-,4412,4815,255;0;0,2,127,141,0,262,4539,4674,135,1
24943ref,5347,5779,JUNC00000060,27,-,5347,5779,255;0;0,2,150,148,0,284,5497,5631,134,1
24943ref,1719,1981,JUNC00000032,2,-,1719,1981,255;0;0,2,107,26,0,236,1826,1955,129,1
24943ref,494,805,JUNC00000004,94,+,494,805,255;0;0,2,52,149,0,162,546,656,110,1
24943ref,5784,6182,JUNC00000069,5,-,5784,6182,255;0;0,2,149,147,0,251,5933,6035,102,1
24943ref,8884,9276,JUNC00000101,10,+,8884,9276,255;0;0,2,146,146,0,246,9030,9130,100,1
24943ref,659,1019,JUNC00000010,131,+,659,1019,255;0;0,2,124,148,0,212,783,871,88,1
24943ref,7743,8071,JUNC00000087,7,-,7743,8071,255;0;0,2,92,149,0,179,7835,7922,87,1
24943ref,1701,2057,JUNC00000031,52,-,1701,2057,255;0;0,2,125,145,0,211,1826,1912,86,1
24943ref,3990,4372,JUNC00000046,900,-,3990,4372,255;0;0,2,150,150,0,232,4140,4222,82,1
24943ref,5018,5241,JUNC00000056,3,-,5018,5241,255;0;0,2,148,8,0,215,5166,5233,67,1
24943ref,7362,7725,JUNC00000081,105,-,7362,7725,255;0;0,2,149,147,0,216,7511,7578,67,1
24943ref,4370,4688,JUNC00000052,1288,-,4370,4688,255;0;0,2,127,133,0,185,4497,4555,58,1
24943ref,826,1171,JUNC00000014,20,+,826,1171,255;0;0,2,143,149,0,196,969,1022,53,1
24943ref,1800,2060,JUNC00000033,4,-,1800,2060,255;0;0,2,60,148,0,112,1860,1912,52,1
24943ref,5756,6015,JUNC00000066,16,-,5756,6015,255;0;0,2,64,145,0,114,5820,5870,50,1
24943ref,5680,5902,JUNC00000067,2,+,5680,5902,255;0;0,2,150,23,0,199,5830,5879,49,1
24943ref,2408,2753,JUNC00000037,64,+,2408,2753,255;0;0,2,148,150,0,195,2556,2603,47,1
24943ref,6645,6983,JUNC00000075,606,-,6645,6983,255;0;0,2,141,150,0,188,6786,6833,47,1
24943ref,949,1295,JUNC00000016,24,-,949,1295,255;0;0,2,150,150,0,196,1099,1145,46,1
24943ref,9017,9214,JUNC00000103,7,+,9017,9214,255;0;0,2,145,10,0,187,9162,9204,42,1
24943ref,6644,6968,JUNC00000074,102,-,6644,6968,255;0;0,2,134,150,0,174,6778,6818,40,1
24943ref,9090,9281,JUNC00000104,1,+,9090,9281,255;0;0,2,107,44,0,147,9197,9237,40,1
24943ref,5587,5924,JUNC00000064,43,+,5587,5924,255;0;0,2,149,149,0,188,5736,5775,39,1
24943ref,7964,8300,JUNC00000095,66,-,7964,8300,255;0;0,2,148,150,0,186,8112,8150,38,1
24943ref,7502,7835,JUNC00000083,56,-,7502,7835,255;0;0,2,147,150,0,183,7649,7685,36,1
24943ref,7512,7839,JUNC00000084,9,+,7512,7839,255;0;0,2,148,143,0,184,7660,7696,36,1
24943ref,1123,1453,JUNC00000024,15,+,1123,1453,255;0;0,2,147,148,0,182,1270,1305,35,1
24943ref,1127,1456,JUNC00000026,35,-,1127,1456,255;0;0,2,148,146,0,183,1275,1310,35,1
24943ref,6071,6257,JUNC00000072,2,-,6071,6257,255;0;0,2,110,41,0,145,6181,6216,35,1
24943ref,7911,8243,JUNC00000092,8,-,7911,8243,255;0;0,2,150,149,0,183,8061,8094,33,1
24943ref,2885,3214,JUNC00000040,3,+,2885,3214,255;0;0,2,148,150,0,179,3033,3064,31,1
24943ref,979,1308,JUNC00000021,52,-,979,1308,255;0;0,2,149,150,0,179,1128,1158,30,1
24943ref,4183,4511,JUNC00000049,34,+,4183,4511,255;0;0,2,148,150,0,178,4331,4361,30,1
24943ref,4238,4531,JUNC00000050,74,-,4238,4531,255;0;0,2,114,149,0,144,4352,4382,30,1
24943ref,5495,5776,JUNC00000062,40,-,5495,5776,255;0;0,2,109,143,0,138,5604,5633,29,1
24943ref,8259,8587,JUNC00000096,1829,+,8259,8587,255;0;0,2,150,149,0,179,8409,8438,29,1
24943ref,3232,3433,JUNC00000042,83,-,3232,3433,255;0;0,2,25,149,0,52,3257,3284,27,1
24943ref,668,868,JUNC00000011,6,-,668,868,255;0;0,2,148,26,0,174,816,842,26,1
24943ref,962,1287,JUNC00000017,8,+,962,1287,255;0;0,2,149,150,0,175,1111,1137,26,1
24943ref,976,1191,JUNC00000018,7,+,976,1191,255;0;0,2,146,44,0,171,1122,1147,25,1
24943ref,1835,2151,JUNC00000034,13,-,1835,2151,255;0;0,2,146,145,0,171,1981,2006,25,1
24943ref,1205,1527,JUNC00000028,15,+,1205,1527,255;0;0,2,148,150,0,172,1353,1377,24,1
24943ref,2669,2988,JUNC00000038,6,-,2669,2988,255;0;0,2,147,148,0,171,2816,2840,24,1
24943ref,3803,4043,JUNC00000045,215,+,3803,4043,255;0;0,2,67,149,0,91,3870,3894,24,1
24943ref,7785,7973,JUNC00000086,82,-,7785,7973,255;0;0,2,21,146,0,42,7806,7827,21,1
24943ref,978,1295,JUNC00000020,42,+,978,1295,255;0;0,2,149,148,0,169,1127,1147,20,1
24943ref,7661,7969,JUNC00000085,39,+,7661,7969,255;0;0,2,139,149,0,159,7800,7820,20,1
24943ref,2240,2556,JUNC00000036,26,+,2240,2556,255;0;0,2,148,149,0,167,2388,2407,19,1
24943ref,5796,5989,JUNC00000065,4,-,5796,5989,255;0;0,2,24,150,0,43,5820,5839,19,1
24943ref,634,821,JUNC00000006,41,+,634,821,255;0;0,2,22,147,0,40,656,674,18,1
24943ref,4690,4933,JUNC00000055,2119,+,4690,4933,255;0;0,2,75,150,0,93,4765,4783,18,1
24943ref,7311,7626,JUNC00000080,3,-,7311,7626,255;0;0,2,149,148,0,167,7460,7478,18,1
24943ref,7946,8242,JUNC00000093,2,+,7946,8242,255;0;0,2,131,148,0,148,8077,8094,17,1
24943ref,7963,8279,JUNC00000094,80,-,7963,8279,255;0;0,2,149,150,0,166,8112,8129,17,1
24943ref,7709,7898,JUNC00000089,2,+,7709,7898,255;0;0,2,148,25,0,164,7857,7873,16,1
24943ref,3735,3915,JUNC00000044,4,-,3735,3915,255;0;0,2,119,46,0,134,3854,3869,15,1
24943ref,4107,4418,JUNC00000047,28,+,4107,4418,255;0;0,2,150,147,0,164,4257,4271,14,1
24943ref,3023,3336,JUNC00000041,307,-,3023,3336,255;0;0,2,150,150,0,163,3173,3186,13,1
24943ref,8765,9076,JUNC00000099,553,+,8765,9076,255;0;0,2,150,148,0,163,8915,8928,13,1
24943ref,331,642,JUNC00000002,20,+,331,642,255;0;0,2,150,150,0,161,481,492,11,1
24943ref,701,871,JUNC00000008,151,+,701,871,255;0;0,2,9,150,0,20,710,721,11,1
24943ref,920,1229,JUNC00000015,2,-,920,1229,255;0;0,2,148,150,0,159,1068,1079,11,1
24943ref,7117,7427,JUNC00000077,836,+,7117,7427,255;0;0,2,150,150,0,160,7267,7277,10,1
24943ref,304,610,JUNC00000001,33,+,304,610,255;0;0,2,150,147,0,159,454,463,9,1
24943ref,3229,3389,JUNC00000043,1,+,3229,3389,255;0;0,2,133,18,0,142,3362,3371,9,1
24943ref,5248,5556,JUNC00000059,261,+,5248,5556,255;0;0,2,150,149,0,159,5398,5407,9,1
24943ref,1003,1307,JUNC00000022,51,-,1003,1307,255;0;0,2,147,149,0,155,1150,1158,8,1
24943ref,1601,1908,JUNC00000030,449,+,1601,1908,255;0;0,2,150,149,0,158,1751,1759,8,1
24943ref,824,1126,JUNC00000013,42,+,824,1126,255;0;0,2,145,150,0,152,969,976,7,1
24943ref,1289,1517,JUNC00000029,6,-,1289,1517,255;0;0,2,149,72,0,156,1438,1445,7,1
24943ref,7709,8014,JUNC00000088,7,+,7709,8014,255;0;0,2,148,150,0,155,7857,7864,7,1
24943ref,7718,7910,JUNC00000090,36,+,7718,7910,255;0;0,2,148,37,0,155,7866,7873,7,1
24943ref,713,1014,JUNC00000012,67,-,713,1014,255;0;0,2,147,148,0,153,860,866,6,1
24943ref,4233,4530,JUNC00000051,542,-,4233,4530,255;0;0,2,149,142,0,155,4382,4388,6,1
24943ref,5728,6031,JUNC00000068,10,+,5728,6031,255;0;0,2,150,147,0,156,5878,5884,6,1
24943ref,6855,7161,JUNC00000076,1822,-,6855,7161,255;0;0,2,150,150,0,156,7005,7011,6,1
24943ref,8952,9257,JUNC00000102,23,-,8952,9257,255;0;0,2,150,149,0,156,9102,9108,6,1
24943ref,5955,6133,JUNC00000071,35,+,5955,6133,255;0;0,2,150,23,0,155,6105,6110,5,1
24943ref,7423,7605,JUNC00000082,12,-,7423,7605,255;0;0,2,150,27,0,155,7573,7578,5,1
24943ref,7725,8027,JUNC00000091,33,-,7725,8027,255;0;0,2,150,147,0,155,7875,7880,5,1
24943ref,8799,9078,JUNC00000100,2139,+,8799,9078,255;0;0,2,124,150,0,129,8923,8928,5,1
24943ref,9477,9782,JUNC00000105,744,+,9477,9782,255;0;0,2,150,150,0,155,9627,9632,5,1
21909ref,974,10341,JUNC00000064,42,+,974,10341,255;0;0,2,148,50,0,9317,1122,10291,9169,1
21909ref,975,10399,JUNC00000063,160,+,975,10399,255;0;0,2,147,145,0,9279,1122,10254,9132,1
21909ref,976,10285,JUNC00000062,145,+,976,10285,255;0;0,2,146,93,0,9216,1122,10192,9070,1
21909ref,551,9780,JUNC00000011,276,+,551,9780,255;0;0,2,87,148,0,9081,638,9632,8994,1
21909ref,176,9078,JUNC00000002,3,+,176,9078,255;0;0,2,148,101,0,8801,324,8977,8653,1
21909ref,1219,10132,JUNC00000080,103,-,1219,10132,255;0;0,2,148,149,0,8764,1367,9983,8616,1
21909ref,973,9804,JUNC00000061,133,+,973,9804,255;0;0,2,149,140,0,8691,1122,9664,8542,1
21909ref,258,9078,JUNC00000003,734,+,258,9078,255;0;0,2,150,150,0,8670,408,8928,8520,1
21909ref,1061,9751,JUNC00000075,4,+,1061,9751,255;0;0,2,149,144,0,8546,1210,9607,8397,1
21909ref,1077,9766,JUNC00000076,67,+,1077,9766,255;0;0,2,144,148,0,8541,1221,9618,8397,1
21909ref,1936,10414,JUNC00000091,1,+,1936,10414,255;0;0,2,45,106,0,8372,1981,10308,8327,1
21909ref,459,8901,JUNC00000007,27,-,459,8901,255;0;0,2,45,148,0,8294,504,8753,8249,1
21909ref,379,8921,JUNC00000008,43,+,379,8921,255;0;0,2,147,146,0,8396,526,8775,8249,1
21909ref,973,9127,JUNC00000060,19,+,973,9127,255;0;0,2,149,55,0,8099,1122,9072,7950,1
21909ref,1305,9266,JUNC00000079,1,-,1305,9266,255;0;0,2,58,93,0,7868,1363,9173,7810,1
21909ref,1846,9385,JUNC00000093,3,+,1846,9385,255;0;0,2,149,71,0,7468,1995,9314,7319,1
21909ref,999,8176,JUNC00000072,65,+,999,8176,255;0;0,2,149,82,0,7095,1148,8094,6946,1
21909ref,1002,8179,JUNC00000074,39,-,1002,8179,255;0;0,2,148,83,0,7094,1150,8096,6946,1
21909ref,979,8037,JUNC00000069,19,+,979,8037,255;0;0,2,148,149,0,6909,1127,7888,6761,1
21909ref,980,7733,JUNC00000030,43,+,980,7733,255;0;0,2,16,148,0,6605,996,7585,6589,1
21909ref,973,7857,JUNC00000059,92,+,973,7857,255;0;0,2,149,146,0,6738,1122,7711,6589,1
21909ref,2436,9170,JUNC00000106,1,+,2436,9170,255;0;0,2,129,22,0,6712,2565,9148,6583,1
21909ref,2433,9141,JUNC00000108,3,+,2433,9141,255;0;0,2,145,26,0,6682,2578,9115,6537,1
21909ref,866,7695,JUNC00000035,10,+,866,7695,255;0;0,2,149,144,0,6685,1015,7551,6536,1
21909ref,2417,9237,JUNC00000105,12,+,2417,9237,255;0;0,2,148,137,0,6683,2565,9100,6535,1
21909ref,2561,9269,JUNC00000117,133,+,2561,9269,255;0;0,2,136,72,0,6636,2697,9197,6500,1
21909ref,949,7726,JUNC00000043,578,-,949,7726,255;0;0,2,150,148,0,6629,1099,7578,6479,1
21909ref,934,7655,JUNC00000040,10,+,934,7655,255;0;0,2,149,147,0,6574,1083,7508,6425,1
21909ref,977,7616,JUNC00000068,99,+,977,7616,255;0;0,2,150,68,0,6571,1127,7548,6421,1
21909ref,3024,9504,JUNC00000132,22,+,3024,9504,255;0;0,2,149,8,0,6472,3173,9496,6323,1
21909ref,1163,7674,JUNC00000078,13,+,1163,7674,255;0;0,2,145,123,0,6388,1308,7551,6243,1
21909ref,933,7312,JUNC00000039,23,+,933,7312,255;0;0,2,150,21,0,6358,1083,7291,6208,1
21909ref,963,7435,JUNC00000047,4,+,963,7435,255;0;0,2,148,148,0,6324,1111,7287,6176,1
21909ref,2947,9278,JUNC00000130,6,+,2947,9278,255;0;0,2,148,148,0,6183,3095,9130,6035,1
21909ref,1275,7532,JUNC00000082,5,+,1275,7532,255;0;0,2,144,150,0,6107,1419,7382,5963,1
21909ref,679,6579,JUNC00000013,6,+,679,6579,255;0;0,2,44,147,0,5753,723,6432,5709,1
21909ref,4488,10264,JUNC00000153,28,-,4488,10264,255;0;0,2,67,122,0,5654,4555,10142,5587,1
21909ref,4618,9988,JUNC00000155,11,+,4618,9988,255;0;0,2,37,27,0,5343,4655,9961,5306,1
21909ref,2072,7567,JUNC00000096,3,+,2072,7567,255;0;0,2,147,59,0,5436,2219,7508,5289,1
21909ref,4892,10291,JUNC00000164,1,+,4892,10291,255;0;0,2,142,8,0,5391,5034,10283,5249,1
21909ref,5001,10384,JUNC00000166,9,+,5001,10384,255;0;0,2,141,76,0,5307,5142,10308,5166,1
21909ref,972,6402,JUNC00000058,34,+,972,6402,255;0;0,2,150,146,0,5284,1122,6256,5134,1
21909ref,973,6142,JUNC00000057,62,+,973,6142,255;0;0,2,149,42,0,5127,1122,6100,4978,1
21909ref,3940,9158,JUNC00000142,10,+,3940,9158,255;0;0,2,149,148,0,5070,4089,9010,4921,1
21909ref,3945,9162,JUNC00000143,4,+,3945,9162,255;0;0,2,147,149,0,5068,4092,9013,4921,1
21909ref,975,6042,JUNC00000056,307,+,975,6042,255;0;0,2,147,146,0,4921,1122,5896,4774,1
21909ref,3957,9020,JUNC00000144,12,-,3957,9020,255;0;0,2,150,143,0,4920,4107,8877,4770,1
21909ref,4579,9642,JUNC00000159,20,+,4579,9642,255;0;0,2,149,146,0,4917,4728,9496,4768,1
21909ref,2678,7700,JUNC00000124,16,+,2678,7700,255;0;0,2,149,149,0,4873,2827,7551,4724,1
21909ref,1643,6606,JUNC00000085,217,+,1643,6606,255;0;0,2,150,143,0,4820,1793,6463,4670,1
21909ref,861,5775,JUNC00000033,124,+,861,5775,255;0;0,2,141,144,0,4770,1002,5631,4629,1
21909ref,976,5719,JUNC00000055,63,+,976,5719,255;0;0,2,146,132,0,4611,1122,5587,4465,1
21909ref,5991,10262,JUNC00000175,1,-,5991,10262,255;0;0,2,31,120,0,4151,6022,10142,4120,1
21909ref,6025,10263,JUNC00000178,8,+,6025,10263,255;0;0,2,146,9,0,4229,6171,10254,4083,1
21909ref,3332,7554,JUNC00000137,63,+,3332,7554,255;0;0,2,149,26,0,4196,3481,7528,4047,1
21909ref,6129,10255,JUNC00000184,3,-,6129,10255,255;0;0,2,107,92,0,4034,6236,10163,3927,1
21909ref,769,4829,JUNC00000016,12,-,769,4829,255;0;0,2,42,109,0,3951,811,4720,3909,1
21909ref,308,4467,JUNC00000006,8,+,308,4467,255;0;0,2,146,144,0,4015,454,4323,3869,1
21909ref,1924,6009,JUNC00000095,314,+,1924,6009,255;0;0,2,110,122,0,3963,2034,5887,3853,1
21909ref,6137,10132,JUNC00000179,56,+,6137,10132,255;0;0,2,44,141,0,3854,6181,9991,3810,1
21909ref,2399,6344,JUNC00000099,1,-,2399,6344,255;0;0,2,41,108,0,3837,2440,6236,3796,1
21909ref,2431,6193,JUNC00000112,3,+,2431,6193,255;0;0,2,149,77,0,3685,2580,6116,3536,1
21909ref,6107,9901,JUNC00000186,93,-,6107,9901,255;0;0,2,148,150,0,3644,6255,9751,3496,1
21909ref,768,4409,JUNC00000022,20,-,768,4409,255;0;0,2,148,148,0,3493,916,4261,3345,1
21909ref,977,4422,JUNC00000067,55,+,977,4422,255;0;0,2,150,23,0,3422,1127,4399,3272,1
21909ref,1042,4476,JUNC00000042,9,+,1042,4476,255;0;0,2,53,149,0,3285,1095,4327,3232,1
21909ref,2661,6063,JUNC00000121,43,+,2661,6063,255;0;0,2,145,51,0,3351,2806,6012,3206,1
21909ref,2669,6083,JUNC00000123,65,-,2669,6083,255;0;0,2,147,61,0,3353,2816,6022,3206,1
21909ref,1075,4268,JUNC00000077,31,+,1075,4268,255;0;0,2,149,49,0,3144,1224,4219,2995,1
21909ref,6060,9294,JUNC00000181,10,+,6060,9294,255;0;0,2,146,149,0,3085,6206,9145,2939,1
21909ref,2696,5917,JUNC00000127,19,+,2696,5917,255;0;0,2,150,148,0,3073,2846,5769,2923,1
21909ref,4578,7574,JUNC00000156,83,-,4578,7574,255;0;0,2,96,147,0,2849,4674,7427,2753,1
21909ref,3327,6203,JUNC00000135,19,+,3327,6203,255;0;0,2,67,146,0,2730,3394,6057,2663,1
21909ref,3284,6111,JUNC00000136,24,-,3284,6111,255;0;0,2,148,21,0,2806,3432,6090,2658,1
21909ref,975,3827,JUNC00000054,181,+,975,3827,255;0;0,2,147,145,0,2707,1122,3682,2560,1
21909ref,2479,4958,JUNC00000111,1,+,2479,4958,255;0;0,2,101,50,0,2429,2580,4908,2328,1
21909ref,2696,5310,JUNC00000126,2,+,2696,5310,255;0;0,2,145,146,0,2468,2841,5164,2323,1
21909ref,973,3445,JUNC00000053,110,+,973,3445,255;0;0,2,149,141,0,2331,1122,3304,2182,1
21909ref,2885,5313,JUNC00000129,246,+,2885,5313,255;0;0,2,148,149,0,2279,3033,5164,2131,1
21909ref,970,3068,JUNC00000049,10,+,970,3068,255;0;0,2,146,149,0,1949,1116,2919,1803,1
21909ref,2503,4471,JUNC00000107,3,+,2503,4471,255;0;0,2,75,148,0,1820,2578,4323,1745,1
21909ref,977,2886,JUNC00000066,62,+,977,2886,255;0;0,2,150,41,0,1868,1127,2845,1718,1
21909ref,4364,6202,JUNC00000150,263,+,4364,6202,255;0;0,2,129,21,0,1817,4493,6181,1688,1
21909ref,5752,7733,JUNC00000174,15,+,5752,7733,255;0;0,2,149,148,0,1833,5901,7585,1684,1
21909ref,5613,7532,JUNC00000171,147,+,5613,7532,255;0;0,2,144,147,0,1772,5757,7385,1628,1
21909ref,973,2851,JUNC00000052,135,+,973,2851,255;0;0,2,149,147,0,1731,1122,2704,1582,1
21909ref,4418,6209,JUNC00000154,18,+,4418,6209,255;0;0,2,148,143,0,1648,4566,6066,1500,1
21909ref,7938,9650,JUNC00000212,249,+,7938,9650,255;0;0,2,69,146,0,1566,8007,9504,1497,1
21909ref,4581,6123,JUNC00000158,17,+,4581,6123,255;0;0,2,147,23,0,1519,4728,6100,1372,1
21909ref,6055,7657,JUNC00000180,12,+,6055,7657,255;0;0,2,148,106,0,1496,6203,7551,1348,1
21909ref,6088,7698,JUNC00000183,5,-,6088,7698,255;0;0,2,148,147,0,1463,6236,7551,1315,1
21909ref,969,2543,JUNC00000046,30,+,969,2543,255;0;0,2,142,150,0,1424,1111,2393,1282,1
21909ref,7406,8923,JUNC00000196,35,+,7406,8923,255;0;0,2,148,100,0,1417,7554,8823,1269,1
21909ref,6253,7662,JUNC00000187,4,+,6253,7662,255;0;0,2,49,150,0,1259,6302,7512,1210,1
21909ref,5669,6858,JUNC00000170,2,-,5669,6858,255;0;0,2,64,75,0,1114,5733,6783,1050,1
21909ref,9179,10361,JUNC00000233,3,+,9179,10361,255;0;0,2,149,70,0,1112,9328,10291,963,1
21909ref,1005,1935,JUNC00000071,8,+,1005,1935,255;0;0,2,143,50,0,880,1148,1885,737,1
21909ref,695,1606,JUNC00000015,263,-,695,1606,255;0;0,2,90,100,0,811,785,1506,721,1
21909ref,304,1099,JUNC00000005,3891,+,304,1099,255;0;0,2,150,15,0,780,454,1084,630,1
21909ref,2741,3481,JUNC00000118,62,+,2741,3481,255;0;0,2,30,141,0,599,2771,3340,569,1
21909ref,4984,5741,JUNC00000165,159,+,4984,5741,255;0;0,2,80,110,0,647,5064,5631,567,1
21909ref,306,967,JUNC00000004,9,+,306,967,255;0;0,2,148,18,0,643,454,949,495,1
21909ref,5019,5641,JUNC00000167,3,+,5019,5641,255;0;0,2,145,18,0,604,5164,5623,459,1
21909ref,974,1694,JUNC00000051,177,+,974,1694,255;0;0,2,148,146,0,574,1122,1548,426,1
21909ref,9515,10124,JUNC00000237,897,+,9515,10124,255;0;0,2,124,77,0,532,9639,10047,408,1
21909ref,9057,9758,JUNC00000231,6,-,9057,9758,255;0;0,2,149,150,0,551,9206,9608,402,1
21909ref,4531,5201,JUNC00000157,40,+,4531,5201,255;0;0,2,150,149,0,521,4681,5052,371,1
21909ref,174,808,JUNC00000001,266,+,174,808,255;0;0,2,150,117,0,517,324,691,367,1
21909ref,5774,6280,JUNC00000172,11,+,5774,6280,255;0;0,2,10,143,0,363,5784,6137,353,1
21909ref,8478,9109,JUNC00000220,4,+,8478,9109,255;0;0,2,150,148,0,483,8628,8961,333,1
21909ref,878,1453,JUNC00000034,67,+,878,1453,255;0;0,2,137,145,0,430,1015,1308,293,1
21909ref,3558,4122,JUNC00000138,9,+,3558,4122,255;0;0,2,132,148,0,416,3690,3974,284,1
21909ref,7551,8006,JUNC00000205,34,+,7551,8006,255;0;0,2,150,33,0,422,7701,7973,272,1
21909ref,2433,2989,JUNC00000110,8,+,2433,2989,255;0;0,2,147,149,0,407,2580,2840,260,1
21909ref,2784,3184,JUNC00000125,3,+,2784,3184,255;0;0,2,46,105,0,295,2830,3079,249,1
21909ref,8928,9377,JUNC00000226,17,+,8928,9377,255;0;0,2,69,147,0,302,8997,9230,233,1
21909ref,8652,9031,JUNC00000221,1,+,8652,9031,255;0;0,2,22,129,0,250,8674,8902,228,1
21909ref,4325,4731,JUNC00000148,18,-,4325,4731,255;0;0,2,50,150,0,256,4375,4581,206,1
21909ref,2497,2979,JUNC00000116,5,-,2497,2979,255;0;0,2,146,147,0,335,2643,2832,189,1
21909ref,7551,7891,JUNC00000204,28,+,7551,7891,255;0;0,2,148,18,0,322,7699,7873,174,1
21909ref,8358,8677,JUNC00000217,1,+,8358,8677,255;0;0,2,80,71,0,248,8438,8606,168,1
21909ref,7405,7837,JUNC00000195,56,+,7405,7837,255;0;0,2,149,117,0,315,7554,7720,166,1
21909ref,8771,9233,JUNC00000224,1507,+,8771,9233,255;0;0,2,150,150,0,312,8921,9083,162,1
21909ref,379,735,JUNC00000009,11,+,379,735,255;0;0,2,149,47,0,309,528,688,160,1
21909ref,3702,4015,JUNC00000140,7,+,3702,4015,255;0;0,2,148,29,0,284,3850,3986,136,1
21909ref,4400,4682,JUNC00000152,2,-,4400,4682,255;0;0,2,139,8,0,274,4539,4674,135,1
21909ref,2698,3067,JUNC00000128,21,+,2698,3067,255;0;0,2,150,87,0,282,2848,2980,132,1
21909ref,7820,8073,JUNC00000210,3,+,7820,8073,255;0;0,2,96,29,0,224,7916,8044,128,1
21909ref,7628,8037,JUNC00000207,64,-,7628,8037,255;0;0,2,148,146,0,263,7776,7891,115,1
21909ref,4168,4562,JUNC00000145,14,-,4168,4562,255;0;0,2,132,148,0,246,4300,4414,114,1
21909ref,4176,4568,JUNC00000146,237,+,4176,4568,255;0;0,2,147,133,0,259,4323,4435,112,1
21909ref,7794,8192,JUNC00000211,4,+,7794,8192,255;0;0,2,148,148,0,250,7942,8044,102,1
21909ref,1409,1706,JUNC00000083,95,+,1409,1706,255;0;0,2,56,141,0,156,1465,1565,100,1
21909ref,1518,1912,JUNC00000084,36,+,1518,1912,255;0;0,2,148,148,0,246,1666,1764,98,1
21909ref,2390,2776,JUNC00000103,11,-,2390,2776,255;0;0,2,146,147,0,239,2536,2629,93,1
21909ref,2394,2781,JUNC00000104,143,-,2394,2781,255;0;0,2,150,145,0,242,2544,2636,92,1
21909ref,2329,2612,JUNC00000098,11,-,2329,2612,255;0;0,2,44,148,0,135,2373,2464,91,1
21909ref,6681,6964,JUNC00000190,4,-,6681,6964,255;0;0,2,44,149,0,134,6725,6815,90,1
21909ref,977,1237,JUNC00000032,14,+,977,1237,255;0;0,2,25,147,0,113,1002,1090,88,1
21909ref,1818,2026,JUNC00000087,3,-,1818,2026,255;0;0,2,8,114,0,94,1826,1912,86,1
21909ref,452,829,JUNC00000010,4,-,452,829,255;0;0,2,146,146,0,231,598,683,85,1
21909ref,9029,9267,JUNC00000230,5,+,9029,9267,255;0;0,2,150,8,0,230,9179,9259,80,1
21909ref,7712,7967,JUNC00000206,100,+,7712,7967,255;0;0,2,29,147,0,108,7741,7820,79,1
21909ref,672,1040,JUNC00000017,19,+,672,1040,255;0;0,2,144,148,0,220,816,892,76,1
21909ref,1669,2032,JUNC00000086,8,-,1669,2032,255;0;0,2,146,147,0,216,1815,1885,70,1
21909ref,7260,7624,JUNC00000192,11,-,7260,7624,255;0;0,2,149,146,0,218,7409,7478,69,1
21909ref,6488,6724,JUNC00000188,5,-,6488,6724,255;0;0,2,23,146,0,90,6511,6578,67,1
21909ref,7362,7725,JUNC00000193,269,-,7362,7725,255;0;0,2,149,147,0,216,7511,7578,67,1
21909ref,4205,4455,JUNC00000147,2,-,4205,4455,255;0;0,2,145,47,0,203,4350,4408,58,1
21909ref,4389,4685,JUNC00000151,930,-,4389,4685,255;0;0,2,108,130,0,166,4497,4555,58,1
21909ref,4864,5072,JUNC00000162,1,-,4864,5072,255;0;0,2,43,107,0,101,4907,4965,58,1
21909ref,8372,8581,JUNC00000219,2,+,8372,8581,255;0;0,2,116,35,0,174,8488,8546,58,1
21909ref,955,1306,JUNC00000044,4430,-,955,1306,255;0;0,2,146,148,0,203,1101,1158,57,1
21909ref,1781,2033,JUNC00000089,13,+,1781,2033,255;0;0,2,50,148,0,104,1831,1885,54,1
21909ref,826,1171,JUNC00000026,34,+,826,1171,255;0;0,2,143,149,0,196,969,1022,53,1
21909ref,4791,5140,JUNC00000163,73,+,4791,5140,255;0;0,2,147,149,0,200,4938,4991,53,1
21909ref,1820,2061,JUNC00000090,3,-,1820,2061,255;0;0,2,40,149,0,92,1860,1912,52,1
21909ref,1684,2029,JUNC00000088,32,+,1684,2029,255;0;0,2,145,149,0,196,1829,1880,51,1
21909ref,2433,2776,JUNC00000109,7,+,2433,2776,255;0;0,2,147,147,0,196,2580,2629,49,1
21909ref,5681,6009,JUNC00000173,10,+,5681,6009,255;0;0,2,149,130,0,198,5830,5879,49,1
21909ref,9989,10186,JUNC00000242,4,+,9989,10186,255;0;0,2,143,9,0,188,10132,10177,45,1
21909ref,891,1221,JUNC00000036,5,+,891,1221,255;0;0,2,147,140,0,190,1038,1081,43,1
21909ref,9013,9212,JUNC00000228,10,+,9013,9212,255;0;0,2,149,8,0,191,9162,9204,42,1
21909ref,599,808,JUNC00000014,122,-,599,808,255;0;0,2,145,23,0,186,744,785,41,1
21909ref,7631,7968,JUNC00000208,74,+,7631,7968,255;0;0,2,148,148,0,189,7779,7820,41,1
21909ref,7512,7777,JUNC00000199,5,+,7512,7777,255;0;0,2,148,81,0,184,7660,7696,36,1
21909ref,2168,2501,JUNC00000097,21,+,2168,2501,255;0;0,2,148,150,0,183,2316,2351,35,1
21909ref,2448,2782,JUNC00000113,3827,-,2448,2782,255;0;0,2,150,149,0,185,2598,2633,35,1
21909ref,9535,9868,JUNC00000238,6,-,9535,9868,255;0;0,2,149,149,0,184,9684,9719,35,1
21909ref,963,1153,JUNC00000045,6,+,963,1153,255;0;0,2,148,8,0,182,1111,1145,34,1
21909ref,2658,2988,JUNC00000120,21,+,2658,2988,255;0;0,2,148,148,0,182,2806,2840,34,1
21909ref,8245,8430,JUNC00000215,1,+,8245,8430,255;0;0,2,37,114,0,71,8282,8316,34,1
21909ref,9680,9984,JUNC00000239,455,-,9680,9984,255;0;0,2,144,126,0,178,9824,9858,34,1
21909ref,946,1277,JUNC00000041,31,+,946,1277,255;0;0,2,149,149,0,182,1095,1128,33,1
21909ref,1842,2031,JUNC00000092,6,+,1842,2031,255;0;0,2,147,9,0,180,1989,2022,33,1
21909ref,5504,5780,JUNC00000169,21,-,5504,5780,255;0;0,2,96,147,0,129,5600,5633,33,1
21909ref,733,961,JUNC00000020,6,+,733,961,255;0;0,2,145,51,0,177,878,910,32,1
21909ref,6822,7103,JUNC00000191,291,-,6822,7103,255;0;0,2,103,147,0,134,6925,6956,31,1
21909ref,979,1305,JUNC00000070,314,-,979,1305,255;0;0,2,149,147,0,179,1128,1158,30,1
21909ref,6106,6434,JUNC00000185,20,+,6106,6434,255;0;0,2,149,150,0,178,6255,6284,29,1
21909ref,2473,2796,JUNC00000114,57,-,2473,2796,255;0;0,2,148,147,0,176,2621,2649,28,1
21909ref,3229,3433,JUNC00000133,76,-,3229,3433,255;0;0,2,28,149,0,55,3257,3284,27,1
21909ref,3022,3345,JUNC00000131,85,+,3022,3345,255;0;0,2,149,149,0,174,3171,3196,25,1
21909ref,3674,3915,JUNC00000139,3,-,3674,3915,255;0;0,2,68,148,0,93,3742,3767,25,1
21909ref,506,824,JUNC00000012,16,+,506,824,255;0;0,2,150,144,0,174,656,680,24,1
21909ref,1029,1224,JUNC00000038,9,+,1029,1224,255;0;0,2,26,145,0,50,1055,1079,24,1
21909ref,7426,7633,JUNC00000198,31,+,7426,7633,255;0;0,2,150,33,0,174,7576,7600,24,1
21909ref,4237,4434,JUNC00000149,51,+,4237,4434,255;0;0,2,145,29,0,168,4382,4405,23,1
21909ref,9831,10132,JUNC00000240,259,+,9831,10132,255;0;0,2,139,139,0,162,9970,9993,23,1
21909ref,9831,10149,JUNC00000241,18,+,9831,10149,255;0;0,2,147,148,0,170,9978,10001,23,1
21909ref,7549,7815,JUNC00000200,5,+,7549,7815,255;0;0,2,125,119,0,147,7674,7696,22,1
21909ref,8192,8508,JUNC00000216,28,-,8192,8508,255;0;0,2,148,147,0,169,8340,8361,21,1
21909ref,977,1292,JUNC00000065,80,+,977,1292,255;0;0,2,150,145,0,170,1127,1147,20,1
21909ref,3769,3961,JUNC00000141,3,-,3769,3961,255;0;0,2,150,22,0,170,3919,3939,20,1
21909ref,8300,8619,JUNC00000218,8,+,8300,8619,255;0;0,2,149,150,0,169,8449,8469,20,1
21909ref,945,1137,JUNC00000025,132,+,945,1137,255;0;0,2,24,149,0,43,969,988,19,1
21909ref,4730,4922,JUNC00000160,104,+,4730,4922,255;0;0,2,35,139,0,53,4765,4783,18,1
21909ref,966,1258,JUNC00000048,72,+,966,1258,255;0;0,2,150,125,0,167,1116,1133,17,1
21909ref,7963,8278,JUNC00000213,84,-,7963,8278,255;0;0,2,149,149,0,166,8112,8129,17,1
21909ref,2668,2883,JUNC00000122,20,-,2668,2883,255;0;0,2,148,51,0,164,2816,2832,16,1
21909ref,7535,7847,JUNC00000202,26,-,7535,7847,255;0;0,2,150,146,0,166,7685,7701,16,1
21909ref,7980,8277,JUNC00000214,26,+,7980,8277,255;0;0,2,149,132,0,165,8129,8145,16,1
21909ref,1244,1416,JUNC00000081,16,+,1244,1416,255;0;0,2,149,8,0,164,1393,1408,15,1
21909ref,4714,5028,JUNC00000161,3,-,4714,5028,255;0;0,2,149,150,0,164,4863,4878,15,1
21909ref,9092,9260,JUNC00000232,16,+,9092,9260,255;0;0,2,145,8,0,160,9237,9252,15,1
21909ref,8774,9081,JUNC00000223,3,-,8774,9081,255;0;0,2,145,148,0,159,8919,8933,14,1
21909ref,8954,9123,JUNC00000227,13,+,8954,9123,255;0;0,2,147,8,0,161,9101,9115,14,1
21909ref,775,1085,JUNC00000023,129,-,775,1085,255;0;0,2,147,150,0,160,922,935,13,1
21909ref,977,1161,JUNC00000031,13,+,977,1161,255;0;0,2,25,146,0,38,1002,1015,13,1
21909ref,847,1027,JUNC00000019,29,+,847,1027,255;0;0,2,20,149,0,31,867,878,11,1
21909ref,6094,6280,JUNC00000177,416,-,6094,6280,255;0;0,2,26,149,0,37,6120,6131,11,1
21909ref,970,1151,JUNC00000028,6,-,970,1151,255;0;0,2,22,149,0,32,992,1002,10,1
21909ref,848,1148,JUNC00000029,10,+,848,1148,255;0;0,2,148,142,0,158,996,1006,10,1
21909ref,976,1081,JUNC00000037,4,+,976,1081,255;0;0,2,69,26,0,79,1045,1055,10,1
21909ref,6485,6685,JUNC00000189,14,-,6485,6685,255;0;0,2,41,149,0,51,6526,6536,10,1
21909ref,3257,3416,JUNC00000134,1,+,3257,3416,255;0;0,2,105,45,0,114,3362,3371,9,1
21909ref,5092,5318,JUNC00000168,7,+,5092,5318,255;0;0,2,146,71,0,155,5238,5247,9,1
21909ref,7517,7698,JUNC00000194,3,+,7517,7698,255;0;0,2,25,147,0,34,7542,7551,9,1
21909ref,9030,9196,JUNC00000229,9,+,9030,9196,255;0;0,2,149,8,0,158,9179,9188,9,1
21909ref,762,1067,JUNC00000021,42,-,762,1067,255;0;0,2,147,150,0,155,909,917,8,1
21909ref,1002,1306,JUNC00000073,1381,-,1002,1306,255;0;0,2,148,148,0,156,1150,1158,8,1
21909ref,2659,2963,JUNC00000119,28,+,2659,2963,255;0;0,2,147,149,0,155,2806,2814,8,1
21909ref,824,1126,JUNC00000024,1037,+,824,1126,255;0;0,2,145,150,0,152,969,976,7,1
21909ref,952,1128,JUNC00000027,23,+,952,1128,255;0;0,2,26,143,0,33,978,985,7,1
21909ref,1857,2164,JUNC00000094,93,+,1857,2164,255;0;0,2,150,150,0,157,2007,2014,7,1
21909ref,2440,2619,JUNC00000100,3,+,2440,2619,255;0;0,2,24,148,0,31,2464,2471,7,1
21909ref,2482,2660,JUNC00000115,2,+,2482,2660,255;0;0,2,149,22,0,156,2631,2638,7,1
21909ref,7529,7833,JUNC00000201,11,+,7529,7833,255;0;0,2,149,148,0,156,7678,7685,7,1
21909ref,7540,7845,JUNC00000203,20,+,7540,7845,255;0;0,2,149,149,0,156,7689,7696,7,1
21909ref,9515,9792,JUNC00000236,10,+,9515,9792,255;0;0,2,124,146,0,131,9639,9646,7,1
21909ref,973,1273,JUNC00000050,4,+,973,1273,255;0;0,2,149,145,0,155,1122,1128,6,1
21909ref,2353,2650,JUNC00000102,73,+,2353,2650,255;0;0,2,148,143,0,154,2501,2507,6,1
21909ref,6069,6233,JUNC00000182,4,+,6069,6233,255;0;0,2,150,8,0,156,6219,6225,6,1
21909ref,710,1007,JUNC00000018,95,-,710,1007,255;0;0,2,145,147,0,150,855,860,5,1
21909ref,2446,2635,JUNC00000101,5,+,2446,2635,255;0;0,2,35,149,0,40,2481,2486,5,1
21909ref,5955,6260,JUNC00000176,8,+,5955,6260,255;0;0,2,150,150,0,155,6105,6110,5,1
21909ref,7501,7603,JUNC00000197,12,-,7501,7603,255;0;0,2,72,25,0,77,7573,7578,5,1
21909ref,7725,7906,JUNC00000209,11,-,7725,7906,255;0;0,2,150,26,0,155,7875,7880,5,1
21909ref,8760,9062,JUNC00000222,3,+,8760,9062,255;0;0,2,148,149,0,153,8908,8913,5,1
21909ref,8807,9078,JUNC00000225,18607,+,8807,9078,255;0;0,2,116,150,0,121,8923,8928,5,1
21909ref,9452,9663,JUNC00000234,502,+,9452,9663,255;0;0,2,58,148,0,63,9510,9515,5,1
21909ref,9479,9656,JUNC00000235,10,+,9479,9656,255;0;0,2,148,24,0,153,9627,9632,5,1
21909ref,10162,10318,JUNC00000243,1,+,10162,10318,255;0;0,2,141,10,0,146,10303,10308,5,1
22749ref,219,9246,JUNC00000004,3,+,219,9246,255;0;0,2,149,149,0,8878,368,9097,8729,1
22749ref,721,9059,JUNC00000021,7,+,721,9059,255;0;0,2,9,144,0,8194,730,8915,8185,1
22749ref,909,9303,JUNC00000038,7,+,909,9303,255;0;0,2,146,66,0,8328,1055,9237,8182,1
22749ref,792,9054,JUNC00000028,43,+,792,9054,255;0;0,2,34,139,0,8123,826,8915,8089,1
22749ref,964,9238,JUNC00000050,8,+,964,9238,255;0;0,2,150,150,0,8124,1114,9088,7974,1
22749ref,1219,9378,JUNC00000062,7,-,1219,9378,255;0;0,2,148,144,0,8015,1367,9234,7867,1
22749ref,1261,9214,JUNC00000070,211,+,1261,9214,255;0;0,2,150,23,0,7930,1411,9191,7780,1
22749ref,1884,9838,JUNC00000089,78,-,1884,9838,255;0;0,2,58,150,0,7804,1942,9688,7746,1
22749ref,1307,9175,JUNC00000065,2,+,1307,9175,255;0;0,2,76,75,0,7793,1383,9100,7717,1
22749ref,1851,9669,JUNC00000090,1,+,1851,9669,255;0;0,2,121,30,0,7788,1972,9639,7667,1
22749ref,919,8655,JUNC00000040,8,-,919,8655,255;0;0,2,149,145,0,7591,1068,8510,7442,1
22749ref,2549,10127,JUNC00000110,18,+,2549,10127,255;0;0,2,148,80,0,7498,2697,10047,7350,1
22749ref,2251,9554,JUNC00000096,1,+,2251,9554,255;0;0,2,8,26,0,7277,2259,9528,7269,1
22749ref,2190,9610,JUNC00000097,1,-,2190,9610,255;0;0,2,86,65,0,7355,2276,9545,7269,1
22749ref,322,7701,JUNC00000005,43,+,322,7701,255;0;0,2,149,120,0,7259,471,7581,7110,1
22749ref,1082,8484,JUNC00000059,11,-,1082,8484,255;0;0,2,142,150,0,7252,1224,8334,7110,1
22749ref,615,7637,JUNC00000025,26,+,615,7637,255;0;0,2,149,86,0,6936,764,7551,6787,1
22749ref,1005,7719,JUNC00000036,24,+,1005,7719,255;0;0,2,10,145,0,6569,1015,7574,6559,1
22749ref,908,7701,JUNC00000037,73,+,908,7701,255;0;0,2,147,141,0,6652,1055,7560,6505,1
22749ref,1793,8578,JUNC00000088,3,-,1793,8578,255;0;0,2,149,147,0,6638,1942,8431,6489,1
22749ref,972,7736,JUNC00000054,87,+,972,7736,255;0;0,2,150,146,0,6618,1122,7590,6468,1
22749ref,934,7550,JUNC00000043,5,+,934,7550,255;0;0,2,149,46,0,6570,1083,7504,6421,1
22749ref,3046,9631,JUNC00000123,11,+,3046,9631,255;0;0,2,150,24,0,6561,3196,9607,6411,1
22749ref,2627,8586,JUNC00000109,3,+,2627,8586,255;0;0,2,55,148,0,5811,2682,8438,5756,1
22749ref,3378,9124,JUNC00000130,3,+,3378,9124,255;0;0,2,8,147,0,5599,3386,8977,5591,1
22749ref,4582,10237,JUNC00000159,5,+,4582,10237,255;0;0,2,142,95,0,5560,4724,10142,5418,1
22749ref,972,6312,JUNC00000053,23,+,972,6312,255;0;0,2,150,143,0,5197,1122,6169,5047,1
22749ref,1287,6161,JUNC00000064,3,+,1287,6161,255;0;0,2,96,55,0,4819,1383,6106,4723,1
22749ref,4984,9792,JUNC00000171,13,-,4984,9792,255;0;0,2,146,137,0,4671,5130,9655,4525,1
22749ref,4577,9124,JUNC00000157,1,+,4577,9124,255;0;0,2,120,9,0,4538,4697,9115,4418,1
22749ref,975,5224,JUNC00000039,1,-,975,5224,255;0;0,2,93,58,0,4191,1068,5166,4098,1
22749ref,1857,6241,JUNC00000091,4,+,1857,6241,255;0;0,2,150,138,0,4246,2007,6103,4096,1
22749ref,2010,6050,JUNC00000093,367,+,2010,6050,255;0;0,2,24,32,0,4008,2034,6018,3984,1
22749ref,4290,8363,JUNC00000150,4,+,4290,8363,255;0;0,2,74,23,0,4050,4364,8340,3976,1
22749ref,1761,5791,JUNC00000083,2,-,1761,5791,255;0;0,2,33,148,0,3882,1794,5643,3849,1
22749ref,4962,9032,JUNC00000170,2,+,4962,9032,255;0;0,2,147,119,0,3951,5109,8913,3804,1
22749ref,977,4853,JUNC00000056,74,+,977,4853,255;0;0,2,150,12,0,3864,1127,4841,3714,1
22749ref,977,4802,JUNC00000055,106,+,977,4802,255;0;0,2,150,62,0,3763,1127,4740,3613,1
22749ref,3195,6955,JUNC00000127,361,+,3195,6955,255;0;0,2,147,104,0,3656,3342,6851,3509,1
22749ref,4237,8004,JUNC00000152,13,-,4237,8004,255;0;0,2,145,147,0,3620,4382,7857,3475,1
22749ref,6141,9259,JUNC00000197,2,+,6141,9259,255;0;0,2,40,111,0,3007,6181,9148,2967,1
22749ref,6136,9188,JUNC00000196,2,+,6136,9188,255;0;0,2,35,116,0,2936,6171,9072,2901,1
22749ref,4685,7811,JUNC00000166,5,+,4685,7811,255;0;0,2,124,140,0,2986,4809,7671,2862,1
22749ref,972,3999,JUNC00000052,27,+,972,3999,255;0;0,2,150,25,0,3002,1122,3974,2852,1
22749ref,3243,6165,JUNC00000129,2,+,3243,6165,255;0;0,2,124,23,0,2899,3367,6142,2775,1
22749ref,6100,9102,JUNC00000198,7,+,6100,9102,255;0;0,2,147,105,0,2897,6247,8997,2750,1
22749ref,962,3986,JUNC00000048,23,+,962,3986,255;0;0,2,149,148,0,2876,1111,3838,2727,1
22749ref,5016,7770,JUNC00000172,13,+,5016,7770,255;0;0,2,148,29,0,2725,5164,7741,2577,1
22749ref,3338,6023,JUNC00000133,10,+,3338,6023,255;0;0,2,143,86,0,2599,3481,5937,2456,1
22749ref,7558,10165,JUNC00000219,189,+,7558,10165,255;0;0,2,143,10,0,2597,7701,10155,2454,1
22749ref,6618,9207,JUNC00000204,1,+,6618,9207,255;0;0,2,44,107,0,2482,6662,9100,2438,1
22749ref,7723,10199,JUNC00000226,135,+,7723,10199,255;0;0,2,150,47,0,2429,7873,10152,2279,1
22749ref,618,2866,JUNC00000024,8,+,618,2866,255;0;0,2,146,26,0,2222,764,2840,2076,1
22749ref,6112,8312,JUNC00000203,90,+,6112,8312,255;0;0,2,149,12,0,2188,6261,8300,2039,1
22749ref,2604,4765,JUNC00000108,5,+,2604,4765,255;0;0,2,66,132,0,2029,2670,4633,1963,1
22749ref,5725,7707,JUNC00000179,5,+,5725,7707,255;0;0,2,59,46,0,1936,5784,7661,1877,1
22749ref,1312,3129,JUNC00000060,1,+,1312,3129,255;0;0,2,11,43,0,1774,1323,3086,1763,1
22749ref,1362,3212,JUNC00000074,749,-,1362,3212,255;0;0,2,149,8,0,1842,1511,3204,1693,1
22749ref,3345,5059,JUNC00000131,2,+,3345,5059,255;0;0,2,49,102,0,1612,3394,4957,1563,1
22749ref,7469,9272,JUNC00000212,13,-,7469,9272,255;0;0,2,147,150,0,1653,7616,9122,1506,1
22749ref,7967,9673,JUNC00000233,83,+,7967,9673,255;0;0,2,145,143,0,1563,8112,9530,1418,1
22749ref,6207,7811,JUNC00000200,5,+,6207,7811,255;0;0,2,42,150,0,1454,6249,7661,1412,1
22749ref,4654,6203,JUNC00000162,2,-,4654,6203,255;0;0,2,92,59,0,1490,4746,6144,1398,1
22749ref,4617,6284,JUNC00000164,18,+,4617,6284,255;0;0,2,148,142,0,1525,4765,6142,1377,1
22749ref,7693,9175,JUNC00000221,2,+,7693,9175,255;0;0,2,48,60,0,1422,7741,9115,1374,1
22749ref,4580,6248,JUNC00000161,31,+,4580,6248,255;0;0,2,148,148,0,1520,4728,6100,1372,1
22749ref,6112,7727,JUNC00000202,40,+,6112,7727,255;0;0,2,149,146,0,1469,6261,7581,1320,1
22749ref,964,2557,JUNC00000049,10,+,964,2557,255;0;0,2,150,150,0,1443,1114,2407,1293,1
22749ref,529,1994,JUNC00000020,2,+,529,1994,255;0;0,2,145,85,0,1380,674,1909,1235,1
22749ref,4581,6016,JUNC00000158,19,+,4581,6016,255;0;0,2,143,73,0,1362,4724,5943,1219,1
22749ref,7850,9138,JUNC00000229,7,+,7850,9138,255;0;0,2,126,44,0,1244,7976,9094,1118,1
22749ref,569,1826,JUNC00000019,2,+,569,1826,255;0;0,2,105,46,0,1211,674,1780,1106,1
22749ref,7782,8949,JUNC00000222,1,+,7782,8949,255;0;0,2,43,108,0,1059,7825,8841,1016,1
22749ref,7894,9034,JUNC00000231,11,+,7894,9034,255;0;0,2,140,10,0,1130,8034,9024,990,1
22749ref,6174,7308,JUNC00000199,2,+,6174,7308,255;0;0,2,75,76,0,1058,6249,7232,983,1
22749ref,7647,8816,JUNC00000218,14,+,7647,8816,255;0;0,2,52,142,0,1027,7699,8674,975,1
22749ref,933,1948,JUNC00000042,44,+,933,1948,255;0;0,2,150,149,0,866,1083,1799,716,1
22749ref,194,1125,JUNC00000003,154,+,194,1125,255;0;0,2,150,149,0,782,344,976,632,1
22749ref,8494,9345,JUNC00000246,18,+,8494,9345,255;0;0,2,149,101,0,750,8643,9244,601,1
22749ref,1000,1851,JUNC00000058,10,-,1000,1851,255;0;0,2,150,125,0,726,1150,1726,576,1
22749ref,6018,6732,JUNC00000192,8,+,6018,6732,255;0;0,2,48,128,0,586,6066,6604,538,1
22749ref,933,1614,JUNC00000041,31,+,933,1614,255;0;0,2,150,8,0,673,1083,1606,523,1
22749ref,9525,10164,JUNC00000260,300,+,9525,10164,255;0;0,2,148,9,0,630,9673,10155,482,1
22749ref,332,1096,JUNC00000007,13,+,332,1096,255;0;0,2,145,147,0,617,477,949,472,1
22749ref,332,963,JUNC00000008,155,-,332,963,255;0;0,2,149,10,0,621,481,953,472,1
22749ref,9059,9647,JUNC00000259,1,+,9059,9647,255;0;0,2,125,8,0,580,9184,9639,455,1
22749ref,8493,9234,JUNC00000245,13,+,8493,9234,255;0;0,2,150,146,0,595,8643,9088,445,1
22749ref,2588,3183,JUNC00000106,2,-,2588,3183,255;0;0,2,19,150,0,445,2607,3033,426,1
22749ref,2470,3195,JUNC00000107,11,+,2470,3195,255;0;0,2,149,150,0,575,2619,3045,426,1
22749ref,1238,1942,JUNC00000063,8,+,1238,1942,255;0;0,2,145,149,0,555,1383,1793,410,1
22749ref,4580,5162,JUNC00000160,7,+,4580,5162,255;0;0,2,148,25,0,557,4728,5137,409,1
22749ref,7133,7727,JUNC00000207,2,+,7133,7727,255;0;0,2,52,146,0,448,7185,7581,396,1
22749ref,5693,6231,JUNC00000176,2,+,5693,6231,255;0;0,2,10,141,0,397,5703,6090,387,1
22749ref,5631,6265,JUNC00000177,17,-,5631,6265,255;0;0,2,98,149,0,485,5729,6116,387,1
22749ref,3632,4149,JUNC00000135,1,+,3632,4149,255;0;0,2,26,111,0,406,3658,4038,380,1
22749ref,7865,8523,JUNC00000230,5,+,7865,8523,255;0;0,2,150,148,0,510,8015,8375,360,1
22749ref,7495,8047,JUNC00000211,9,+,7495,8047,255;0;0,2,47,150,0,402,7542,7897,355,1
22749ref,492,1126,JUNC00000017,173,+,492,1126,255;0;0,2,148,150,0,484,640,976,336,1
22749ref,3541,4125,JUNC00000134,5,+,3541,4125,255;0;0,2,101,149,0,435,3642,3976,334,1
22749ref,5624,6215,JUNC00000178,23,+,5624,6215,255;0;0,2,109,149,0,442,5733,6066,333,1
22749ref,3852,4474,JUNC00000138,3,-,3852,4474,255;0;0,2,149,143,0,479,4001,4331,330,1
22749ref,949,1475,JUNC00000045,18,+,949,1475,255;0;0,2,146,73,0,453,1095,1402,307,1
22749ref,2017,2479,JUNC00000095,6,-,2017,2479,255;0;0,2,30,125,0,337,2047,2354,307,1
22749ref,1578,2024,JUNC00000078,1,+,1578,2024,255;0;0,2,108,43,0,403,1686,1981,295,1
22749ref,938,1452,JUNC00000035,21,+,938,1452,255;0;0,2,77,144,0,370,1015,1308,293,1
22749ref,3866,4309,JUNC00000137,1,+,3866,4309,255;0;0,2,61,90,0,353,3927,4219,292,1
22749ref,2600,3141,JUNC00000111,2,+,2600,3141,255;0;0,2,106,150,0,391,2706,2991,285,1
22749ref,1587,2018,JUNC00000077,1,+,1587,2018,255;0;0,2,56,95,0,336,1643,1923,280,1
22749ref,5672,6223,JUNC00000180,3,-,5672,6223,255;0;0,2,148,133,0,418,5820,6090,270,1
22749ref,5681,6244,JUNC00000182,10,+,5681,6244,255;0;0,2,149,144,0,419,5830,6100,270,1
22749ref,3332,3818,JUNC00000132,3,+,3332,3818,255;0;0,2,149,70,0,416,3481,3748,267,1
22749ref,9679,10215,JUNC00000261,64,-,9679,10215,255;0;0,2,147,134,0,402,9826,10081,255,1
22749ref,643,1133,JUNC00000023,26,+,643,1133,255;0;0,2,121,118,0,372,764,1015,251,1
22749ref,1663,2118,JUNC00000079,8,+,1663,2118,255;0;0,2,86,146,0,309,1749,1972,223,1
22749ref,1495,1858,JUNC00000075,3,+,1495,1858,255;0;0,2,70,81,0,282,1565,1777,212,1
22749ref,7872,8232,JUNC00000228,1,-,7872,8232,255;0;0,2,44,107,0,253,7916,8125,209,1
22749ref,1732,2088,JUNC00000081,1,-,1732,2088,255;0;0,2,37,114,0,242,1769,1974,205,1
22749ref,5592,5940,JUNC00000174,2289,+,5592,5940,255;0;0,2,8,149,0,199,5600,5791,191,1
22749ref,8928,9335,JUNC00000254,12,+,8928,9335,255;0;0,2,69,147,0,260,8997,9188,191,1
22749ref,380,860,JUNC00000011,5,-,380,860,255;0;0,2,148,148,0,332,528,712,184,1
22749ref,515,850,JUNC00000014,2,+,515,850,255;0;0,2,31,120,0,215,546,730,184,1
22749ref,1276,1654,JUNC00000071,378,+,1276,1654,255;0;0,2,149,45,0,333,1425,1609,184,1
22749ref,357,835,JUNC00000009,3,-,357,835,255;0;0,2,150,149,0,329,507,686,179,1
22749ref,7573,8016,JUNC00000217,18,+,7573,8016,255;0;0,2,126,143,0,300,7699,7873,174,1
22749ref,7553,8015,JUNC00000216,14,+,7553,8015,255;0;0,2,146,148,0,314,7699,7867,168,1
22749ref,8338,8657,JUNC00000239,1,+,8338,8657,255;0;0,2,100,51,0,268,8438,8606,168,1
22749ref,2786,3142,JUNC00000114,12,+,2786,3142,255;0;0,2,41,148,0,208,2827,2994,167,1
22749ref,8780,9238,JUNC00000251,379,+,8780,9238,255;0;0,2,141,150,0,308,8921,9088,167,1
22749ref,4126,4443,JUNC00000142,2,+,4126,4443,255;0;0,2,32,120,0,197,4158,4323,165,1
22749ref,8780,9233,JUNC00000250,2446,+,8780,9233,255;0;0,2,141,150,0,303,8921,9083,162,1
22749ref,388,838,JUNC00000013,103,+,388,838,255;0;0,2,146,144,0,306,534,694,160,1
22749ref,56,438,JUNC00000001,20,+,56,438,255;0;0,2,150,73,0,309,206,365,159,1
22749ref,617,958,JUNC00000018,2,+,617,958,255;0;0,2,39,146,0,195,656,812,156,1
22749ref,1265,1606,JUNC00000069,9,+,1265,1606,255;0;0,2,146,41,0,300,1411,1565,154,1
22749ref,8299,8625,JUNC00000240,2,+,8299,8625,255;0;0,2,147,25,0,301,8446,8600,154,1
22749ref,207,455,JUNC00000002,2,-,207,455,255;0;0,2,24,71,0,177,231,384,153,1
22749ref,670,1100,JUNC00000026,16,-,670,1100,255;0;0,2,146,147,0,283,816,953,137,1
22749ref,1263,1599,JUNC00000068,41,+,1263,1599,255;0;0,2,148,51,0,285,1411,1548,137,1
22749ref,4394,4704,JUNC00000155,7,-,4394,4704,255;0;0,2,138,37,0,273,4532,4667,135,1
22749ref,4396,4729,JUNC00000156,12,-,4396,4729,255;0;0,2,143,55,0,278,4539,4674,135,1
22749ref,3962,4388,JUNC00000141,12,-,3962,4388,255;0;0,2,145,148,0,278,4107,4240,133,1
22749ref,2698,2999,JUNC00000116,11,+,2698,2999,255;0;0,2,150,19,0,282,2848,2980,132,1
22749ref,7774,8053,JUNC00000227,1,+,7774,8053,255;0;0,2,142,9,0,270,7916,8044,128,1
22749ref,2779,3056,JUNC00000118,1,+,2779,3056,255;0;0,2,142,9,0,268,2921,3047,126,1
22749ref,2437,2852,JUNC00000104,24,+,2437,2852,255;0;0,2,147,148,0,267,2584,2704,120,1
22749ref,4664,5048,JUNC00000165,10,+,4664,5048,255;0;0,2,145,121,0,263,4809,4927,118,1
22749ref,7696,8106,JUNC00000223,5,+,7696,8106,255;0;0,2,144,149,0,261,7840,7957,117,1
22749ref,1903,2170,JUNC00000092,257,+,1903,2170,255;0;0,2,131,20,0,247,2034,2150,116,1
22749ref,2453,2738,JUNC00000100,6,-,2453,2738,255;0;0,2,83,86,0,199,2536,2652,116,1
22749ref,3652,3917,JUNC00000136,2,+,3652,3917,255;0;0,2,30,121,0,144,3682,3796,114,1
22749ref,4176,4529,JUNC00000148,34,+,4176,4529,255;0;0,2,147,94,0,259,4323,4435,112,1
22749ref,4822,5160,JUNC00000168,2,-,4822,5160,255;0;0,2,78,148,0,190,4900,5012,112,1
22749ref,8986,9395,JUNC00000255,3520,+,8986,9395,255;0;0,2,150,148,0,261,9136,9247,111,1
22749ref,3208,3405,JUNC00000126,1,+,3208,3405,255;0;0,2,68,19,0,178,3276,3386,110,1
22749ref,737,1083,JUNC00000027,31,+,737,1083,255;0;0,2,89,148,0,198,826,935,109,1
22749ref,5362,5616,JUNC00000173,1,+,5362,5616,255;0;0,2,98,53,0,201,5460,5563,103,1
22749ref,4763,5016,JUNC00000167,3,-,4763,5016,255;0;0,2,100,51,0,202,4863,4965,102,1
22749ref,1333,1600,JUNC00000072,2,+,1333,1600,255;0;0,2,132,35,0,232,1465,1565,100,1
22749ref,5808,6202,JUNC00000187,3,-,5808,6202,255;0;0,2,147,150,0,244,5955,6052,97,1
22749ref,381,676,JUNC00000010,5,+,381,676,255;0;0,2,147,54,0,241,528,622,94,1
22749ref,2394,2781,JUNC00000102,76,-,2394,2781,255;0;0,2,150,145,0,242,2544,2636,92,1
22749ref,1729,2046,JUNC00000085,20,-,1729,2046,255;0;0,2,97,134,0,183,1826,1912,86,1
22749ref,525,763,JUNC00000012,2,+,525,763,255;0;0,2,9,144,0,94,534,619,85,1
22749ref,7100,7464,JUNC00000208,8,+,7100,7464,255;0;0,2,148,131,0,233,7248,7333,85,1
22749ref,1767,2001,JUNC00000082,1,+,1767,2001,255;0;0,2,26,125,0,109,1793,1876,83,1
22749ref,5781,6018,JUNC00000184,3,+,5781,6018,255;0;0,2,145,9,0,228,5926,6009,83,1
22749ref,5791,6168,JUNC00000185,32,+,5791,6168,255;0;0,2,146,148,0,229,5937,6020,83,1
22749ref,8907,9140,JUNC00000249,3,+,8907,9140,255;0;0,2,8,143,0,90,8915,8997,82,1
22749ref,570,835,JUNC00000016,3,+,570,835,255;0;0,2,38,147,0,118,608,688,80,1
22749ref,7821,8084,JUNC00000225,20,+,7821,8084,255;0;0,2,52,132,0,131,7873,7952,79,1
22749ref,4000,4229,JUNC00000139,1,+,4000,4229,255;0;0,2,25,126,0,103,4025,4103,78,1
22749ref,10238,10467,JUNC00000263,5,+,10238,10467,255;0;0,2,143,10,0,219,10381,10457,76,1
22749ref,5795,6067,JUNC00000186,11,+,5795,6067,255;0;0,2,148,49,0,223,5943,6018,75,1
22749ref,1781,2022,JUNC00000084,2,+,1781,2022,255;0;0,2,43,130,0,111,1824,1892,68,1
22749ref,1787,2066,JUNC00000086,2,+,1787,2066,255;0;0,2,63,148,0,131,1850,1918,68,1
22749ref,7473,7701,JUNC00000209,19,+,7473,7701,255;0;0,2,21,139,0,89,7494,7562,68,1
22749ref,7362,7725,JUNC00000210,349,-,7362,7725,255;0;0,2,149,147,0,216,7511,7578,67,1
22749ref,8259,8622,JUNC00000235,2,+,8259,8622,255;0;0,2,150,148,0,215,8409,8474,65,1
22749ref,8283,8643,JUNC00000237,16,+,8283,8643,255;0;0,2,148,147,0,213,8431,8496,65,1
22749ref,1219,1578,JUNC00000061,78,-,1219,1578,255;0;0,2,148,148,0,211,1367,1430,63,1
22749ref,2404,2679,JUNC00000101,4,+,2404,2679,255;0;0,2,139,73,0,202,2543,2606,63,1
22749ref,8290,8535,JUNC00000238,104,+,8290,8535,255;0;0,2,148,34,0,211,8438,8501,63,1
22749ref,7593,7805,JUNC00000220,1,+,7593,7805,255;0;0,2,135,16,0,196,7728,7789,61,1
22749ref,952,1167,JUNC00000046,11,-,952,1167,255;0;0,2,147,9,0,206,1099,1158,59,1
22749ref,4444,4698,JUNC00000154,30,-,4444,4698,255;0;0,2,53,143,0,111,4497,4555,58,1
22749ref,8377,8586,JUNC00000244,2,+,8377,8586,255;0;0,2,111,40,0,169,8488,8546,58,1
22749ref,9034,9245,JUNC00000258,7,+,9034,9245,255;0;0,2,145,8,0,203,9179,9237,58,1
22749ref,711,943,JUNC00000029,15,-,711,943,255;0;0,2,149,26,0,206,860,917,57,1
22749ref,828,1083,JUNC00000031,26,+,828,1083,255;0;0,2,50,148,0,107,878,935,57,1
22749ref,955,1307,JUNC00000047,1412,-,955,1307,255;0;0,2,146,149,0,203,1101,1158,57,1
22749ref,1750,1973,JUNC00000080,4,-,1750,1973,255;0;0,2,19,147,0,76,1769,1826,57,1
22749ref,5899,6107,JUNC00000188,2,+,5899,6107,255;0;0,2,66,85,0,123,5965,6022,57,1
22749ref,5995,6232,JUNC00000195,7,-,5995,6232,255;0;0,2,149,34,0,203,6144,6198,54,1
22749ref,825,1171,JUNC00000033,51,+,825,1171,255;0;0,2,144,149,0,197,969,1022,53,1
22749ref,4249,4455,JUNC00000146,2,+,4249,4455,255;0;0,2,8,145,0,61,4257,4310,53,1
22749ref,4885,5223,JUNC00000169,5,+,4885,5223,255;0;0,2,149,136,0,202,5034,5087,53,1
22749ref,8166,8432,JUNC00000234,199,-,8166,8432,255;0;0,2,63,150,0,116,8229,8282,53,1
22749ref,2432,2639,JUNC00000103,5,+,2432,2639,255;0;0,2,148,10,0,197,2580,2629,49,1
22749ref,5680,5916,JUNC00000181,7,+,5680,5916,255;0;0,2,150,37,0,199,5830,5879,49,1
22749ref,740,955,JUNC00000022,39,+,740,955,255;0;0,2,24,143,0,72,764,812,48,1
22749ref,8304,8505,JUNC00000242,24,+,8304,8505,255;0;0,2,145,9,0,192,8449,8496,47,1
22749ref,5687,5889,JUNC00000175,793,-,5687,5889,255;0;0,2,8,148,0,54,5695,5741,46,1
22749ref,2869,3070,JUNC00000117,2,-,2869,3070,255;0;0,2,35,121,0,80,2904,2949,45,1
22749ref,3270,3459,JUNC00000128,1,+,3270,3459,255;0;0,2,80,65,0,124,3350,3394,44,1
22749ref,6924,7091,JUNC00000206,1,-,6924,7091,255;0;0,2,87,39,0,128,7011,7052,41,1
22749ref,2948,3143,JUNC00000119,65,+,2948,3143,255;0;0,2,8,147,0,48,2956,2996,40,1
22749ref,1936,2126,JUNC00000094,1,-,1936,2126,255;0;0,2,111,40,0,150,2047,2086,39,1
22749ref,4246,4443,JUNC00000145,9,+,4246,4443,255;0;0,2,11,148,0,49,4257,4295,38,1
22749ref,2238,2573,JUNC00000098,10,-,2238,2573,255;0;0,2,150,149,0,186,2388,2424,36,1
22749ref,7511,7846,JUNC00000213,6,+,7511,7846,255;0;0,2,149,150,0,185,7660,7696,36,1
22749ref,8760,9091,JUNC00000248,3,+,8760,9091,255;0;0,2,148,147,0,184,8908,8944,36,1
22749ref,9008,9337,JUNC00000257,95,-,9008,9337,255;0;0,2,150,143,0,186,9158,9194,36,1
22749ref,2449,2781,JUNC00000105,1018,-,2449,2781,255;0;0,2,149,148,0,184,2598,2633,35,1
22749ref,5956,6147,JUNC00000193,4,+,5956,6147,255;0;0,2,149,8,0,183,6105,6139,34,1
22749ref,946,1276,JUNC00000044,9,+,946,1276,255;0;0,2,149,148,0,182,1095,1128,33,1
22749ref,4127,4417,JUNC00000143,3,+,4127,4417,255;0;0,2,111,146,0,144,4238,4271,33,1
22749ref,7914,8244,JUNC00000232,5,-,7914,8244,255;0;0,2,147,150,0,180,8061,8094,33,1
22749ref,729,1055,JUNC00000030,6,+,729,1055,255;0;0,2,149,145,0,181,878,910,32,1
22749ref,4216,4492,JUNC00000149,138,-,4216,4492,255;0;0,2,136,110,0,166,4352,4382,30,1
22749ref,977,1157,JUNC00000034,18,+,977,1157,255;0;0,2,25,126,0,54,1002,1031,29,1
22749ref,6846,7026,JUNC00000205,1,+,6846,7026,255;0;0,2,108,43,0,137,6954,6983,29,1
22749ref,3190,3433,JUNC00000125,45,-,3190,3433,255;0;0,2,67,149,0,94,3257,3284,27,1
22749ref,2889,3193,JUNC00000120,3,+,2889,3193,255;0;0,2,130,148,0,156,3019,3045,26,1
22749ref,3023,3345,JUNC00000122,171,+,3023,3345,255;0;0,2,148,149,0,173,3171,3196,25,1
22749ref,6106,6313,JUNC00000201,6,+,6106,6313,255;0;0,2,149,33,0,174,6255,6280,25,1
22749ref,2704,2866,JUNC00000113,6,-,2704,2866,255;0;0,2,112,26,0,136,2816,2840,24,1
22749ref,2918,3122,JUNC00000121,3,-,2918,3122,255;0;0,2,147,35,0,169,3065,3087,22,1
22749ref,970,1285,JUNC00000051,5,+,970,1285,255;0;0,2,146,148,0,167,1116,1137,21,1
22749ref,2344,2520,JUNC00000099,8,+,2344,2520,255;0;0,2,147,8,0,168,2491,2512,21,1
22749ref,10212,10297,JUNC00000262,1,+,10212,10297,255;0;0,2,42,23,0,62,10254,10274,20,1
22749ref,4616,4908,JUNC00000163,18,+,4616,4908,255;0;0,2,149,125,0,167,4765,4783,18,1
22749ref,2667,2981,JUNC00000112,10,-,2667,2981,255;0;0,2,149,149,0,165,2816,2832,16,1
22749ref,5950,6214,JUNC00000191,251,+,5950,6214,255;0;0,2,100,148,0,116,6050,6066,16,1
22749ref,329,641,JUNC00000006,6,+,329,641,255;0;0,2,148,149,0,163,477,492,15,1
22749ref,2680,2991,JUNC00000115,6,+,2680,2991,255;0;0,2,150,146,0,165,2830,2845,15,1
22749ref,4065,4230,JUNC00000140,1,+,4065,4230,255;0;0,2,27,124,0,41,4092,4106,14,1
22749ref,4131,4418,JUNC00000144,20,+,4131,4418,255;0;0,2,126,147,0,140,4257,4271,14,1
22749ref,1457,1626,JUNC00000076,115,+,1457,1626,255;0;0,2,148,8,0,161,1605,1618,13,1
22749ref,4216,4476,JUNC00000147,2,+,4216,4476,255;0;0,2,107,140,0,120,4323,4336,13,1
22749ref,5760,5924,JUNC00000183,1,+,5760,5924,255;0;0,2,81,70,0,94,5841,5854,13,1
22749ref,6110,6280,JUNC00000194,50,-,6110,6280,255;0;0,2,10,149,0,21,6120,6131,11,1
22749ref,7708,7913,JUNC00000224,9,+,7708,7913,255;0;0,2,149,46,0,159,7857,7867,10,1
22749ref,8928,9147,JUNC00000253,9,+,8928,9147,255;0;0,2,60,150,0,69,8988,8997,9,1
22749ref,1003,1255,JUNC00000057,1336,-,1003,1255,255;0;0,2,147,97,0,155,1150,1158,8,1
22749ref,824,1126,JUNC00000032,1041,+,824,1126,255;0;0,2,145,150,0,152,969,976,7,1
22749ref,3048,3212,JUNC00000124,9,-,3048,3212,255;0;0,2,149,8,0,156,3197,3204,7,1
22749ref,7530,7834,JUNC00000214,3,+,7530,7834,255;0;0,2,148,149,0,155,7678,7685,7,1
22749ref,7540,7843,JUNC00000215,3,+,7540,7843,255;0;0,2,149,147,0,156,7689,7696,7,1
22749ref,8283,8523,JUNC00000236,7,+,8283,8523,255;0;0,2,148,85,0,155,8431,8438,7,1
22749ref,422,724,JUNC00000015,3,+,422,724,255;0;0,2,149,147,0,155,571,577,6,1
22749ref,1401,1558,JUNC00000073,1,-,1401,1558,255;0;0,2,105,46,0,111,1506,1512,6,1
22749ref,1769,2015,JUNC00000087,7,+,1769,2015,255;0;0,2,91,149,0,97,1860,1866,6,1
22749ref,4235,4483,JUNC00000151,456,-,4235,4483,255;0;0,2,147,95,0,153,4382,4388,6,1
22749ref,5927,6084,JUNC00000189,1,+,5927,6084,255;0;0,2,85,66,0,91,6012,6018,6,1
22749ref,9099,9309,JUNC00000256,2,+,9099,9309,255;0;0,2,57,147,0,63,9156,9162,6,1
22749ref,1244,1442,JUNC00000066,47,+,1244,1442,255;0;0,2,149,44,0,154,1393,1398,5,1
22749ref,1263,1425,JUNC00000067,6,+,1263,1425,255;0;0,2,148,9,0,153,1411,1416,5,1
22749ref,4334,4490,JUNC00000153,4,+,4334,4490,255;0;0,2,142,9,0,147,4476,4481,5,1
22749ref,6017,6203,JUNC00000190,21,+,6017,6203,255;0;0,2,33,148,0,38,6050,6055,5,1
22749ref,8300,8602,JUNC00000241,5,+,8300,8602,255;0;0,2,149,148,0,154,8449,8454,5,1
22749ref,8436,8611,JUNC00000243,3,+,8436,8611,255;0;0,2,22,148,0,27,8458,8463,5,1
22749ref,8760,9062,JUNC00000247,3,+,8760,9062,255;0;0,2,148,149,0,153,8908,8913,5,1
22749ref,8826,9078,JUNC00000252,37699,+,8826,9078,255;0;0,2,97,150,0,102,8923,8928,5,1
20769ref2,1227,9247,JUNC00000041,1,+,1227,9247,255;0;0,2,55,96,0,7924,1282,9151,7869,1
20769ref2,1824,9210,JUNC00000054,1,-,1824,9210,255;0;0,2,109,42,0,7344,1933,9168,7235,1
20769ref2,2384,9659,JUNC00000062,1,+,2384,9659,255;0;0,2,22,129,0,7146,2406,9530,7124,1
20769ref2,1240,8194,JUNC00000042,42,+,1240,8194,255;0;0,2,146,150,0,6804,1386,8044,6658,1
20769ref2,2336,9062,JUNC00000063,2,+,2336,9062,255;0;0,2,126,147,0,6579,2462,8915,6453,1
20769ref2,3224,9322,JUNC00000083,1,+,3224,9322,255;0;0,2,126,25,0,6073,3350,9297,5947,1
20769ref2,4535,9119,JUNC00000095,11,+,4535,9119,255;0;0,2,31,142,0,4442,4566,8977,4411,1
20769ref2,3828,8157,JUNC00000084,2,+,3828,8157,255;0;0,2,57,146,0,4183,3885,8011,4126,1
20769ref2,974,5310,JUNC00000037,566,+,974,5310,255;0;0,2,148,146,0,4190,1122,5164,4042,1
20769ref2,3278,6214,JUNC00000082,2,+,3278,6214,255;0;0,2,72,148,0,2788,3350,6066,2716,1
20769ref2,7657,10092,JUNC00000136,2,-,7657,10092,255;0;0,2,72,106,0,2329,7729,9986,2257,1
20769ref2,1000,3015,JUNC00000030,6,+,1000,3015,255;0;0,2,55,96,0,1919,1055,2919,1864,1
20769ref2,6061,7988,JUNC00000111,1,-,6061,7988,255;0;0,2,89,62,0,1865,6150,7926,1776,1
20769ref2,7822,9697,JUNC00000142,1,-,7822,9697,255;0;0,2,142,9,0,1866,7964,9688,1724,1
20769ref2,4468,6337,JUNC00000094,1,+,4468,6337,255;0;0,2,98,53,0,1816,4566,6284,1718,1
20769ref2,7550,9287,JUNC00000135,5,+,7550,9287,255;0;0,2,149,139,0,1598,7699,9148,1449,1
20769ref2,6102,7668,JUNC00000113,15,-,6102,7668,255;0;0,2,147,62,0,1504,6249,7606,1357,1
20769ref2,7882,9221,JUNC00000141,1,+,7882,9221,255;0;0,2,45,106,0,1233,7927,9115,1188,1
20769ref2,5020,6185,JUNC00000100,1,-,5020,6185,255;0;0,2,110,41,0,1124,5130,6144,1014,1
20769ref2,3217,4337,JUNC00000081,2,-,3217,4337,255;0;0,2,73,120,0,1000,3290,4217,927,1
20769ref2,1675,2527,JUNC00000050,1,+,1675,2527,255;0;0,2,125,26,0,826,1800,2501,701,1
20769ref2,2024,2802,JUNC00000056,1,+,2024,2802,255;0;0,2,46,105,0,673,2070,2697,627,1
20769ref2,1955,2839,JUNC00000057,5,-,1955,2839,255;0;0,2,150,149,0,735,2105,2690,585,1
20769ref2,526,1133,JUNC00000005,6,+,526,1133,255;0;0,2,26,118,0,489,552,1015,463,1
20769ref2,7605,8211,JUNC00000134,1,+,7605,8211,255;0;0,2,94,56,0,550,7699,8155,456,1
20769ref2,7840,8506,JUNC00000140,49,+,7840,8506,255;0;0,2,82,145,0,521,7922,8361,439,1
20769ref2,6738,7325,JUNC00000118,2,-,6738,7325,255;0;0,2,45,146,0,441,6783,7179,396,1
20769ref2,561,1128,JUNC00000007,2,+,561,1128,255;0;0,2,47,143,0,424,608,985,377,1
20769ref2,558,1133,JUNC00000010,13,+,558,1133,255;0;0,2,69,131,0,444,627,1002,375,1
20769ref2,8692,9189,JUNC00000151,1,+,8692,9189,255;0;0,2,83,44,0,453,8775,9145,370,1
20769ref2,630,1133,JUNC00000012,12,+,630,1133,255;0;0,2,26,118,0,385,656,1015,359,1
20769ref2,4635,5134,JUNC00000097,2,+,4635,5134,255;0;0,2,130,21,0,478,4765,5113,348,1
20769ref2,552,1133,JUNC00000011,16,+,552,1133,255;0;0,2,104,131,0,450,656,1002,346,1
20769ref2,9777,10270,JUNC00000167,1,-,9777,10270,255;0;0,2,47,104,0,389,9824,10166,342,1
20769ref2,1606,2052,JUNC00000049,1,+,1606,2052,255;0;0,2,80,71,0,375,1686,1981,295,1
20769ref2,871,1351,JUNC00000026,27,+,871,1351,255;0;0,2,131,56,0,424,1002,1295,293,1
20769ref2,871,1452,JUNC00000027,18,+,871,1452,255;0;0,2,144,144,0,437,1015,1308,293,1
20769ref2,3855,4299,JUNC00000085,1,+,3855,4299,255;0;0,2,69,82,0,362,3924,4217,293,1
20769ref2,2326,2751,JUNC00000060,1,-,2326,2751,255;0;0,2,44,107,0,318,2370,2644,274,1
20769ref2,7314,7740,JUNC00000121,3,+,7314,7740,255;0;0,2,8,150,0,276,7322,7590,268,1
20769ref2,974,1401,JUNC00000036,508,+,974,1401,255;0;0,2,148,24,0,403,1122,1377,255,1
20769ref2,9771,10177,JUNC00000168,1,-,9771,10177,255;0;0,2,55,96,0,310,9826,10081,255,1
20769ref2,332,839,JUNC00000001,1127,+,332,839,255;0;0,2,149,148,0,359,481,691,210,1
20769ref2,8689,9042,JUNC00000150,1,+,8689,9042,255;0;0,2,86,65,0,288,8775,8977,202,1
20769ref2,1270,1642,JUNC00000044,62,+,1270,1642,255;0;0,2,149,31,0,341,1419,1611,192,1
20769ref2,9808,10153,JUNC00000169,3,-,9808,10153,255;0;0,2,142,11,0,334,9950,10142,192,1
20769ref2,7399,7737,JUNC00000123,2,-,7399,7737,255;0;0,2,37,114,0,224,7436,7623,187,1
20769ref2,609,1084,JUNC00000016,5,-,609,1084,255;0;0,2,148,144,0,331,757,940,183,1
20769ref2,620,1099,JUNC00000017,205,-,620,1099,255;0;0,2,150,146,0,333,770,953,183,1
20769ref2,1011,1329,JUNC00000029,2,+,1011,1329,255;0;0,2,44,99,0,219,1055,1230,175,1
20769ref2,7551,7965,JUNC00000133,14,+,7551,7965,255;0;0,2,148,92,0,322,7699,7873,174,1
20769ref2,4024,4340,JUNC00000088,1,+,4024,4340,255;0;0,2,108,43,0,273,4132,4297,165,1
20769ref2,2896,3210,JUNC00000075,2,+,2896,3210,255;0;0,2,137,14,0,300,3033,3196,163,1
20769ref2,8773,9233,JUNC00000154,2405,+,8773,9233,255;0;0,2,148,150,0,310,8921,9083,162,1
20769ref2,5017,5344,JUNC00000102,3,+,5017,5344,255;0;0,2,147,20,0,307,5164,5324,160,1
20769ref2,7692,8002,JUNC00000137,12,+,7692,8002,255;0;0,2,145,8,0,302,7837,7994,157,1
20769ref2,562,1012,JUNC00000014,2,+,562,1012,255;0;0,2,148,148,0,302,710,864,154,1
20769ref2,682,1018,JUNC00000015,15,+,682,1018,255;0;0,2,35,147,0,189,717,871,154,1
20769ref2,1265,1634,JUNC00000043,10,+,1265,1634,255;0;0,2,146,69,0,300,1411,1565,154,1
20769ref2,7259,7705,JUNC00000122,262,-,7259,7705,255;0;0,2,150,145,0,301,7409,7560,151,1
20769ref2,395,698,JUNC00000003,17,-,395,698,255;0;0,2,143,22,0,281,538,676,138,1
20769ref2,4393,4733,JUNC00000093,15,-,4393,4733,255;0;0,2,146,59,0,281,4539,4674,135,1
20769ref2,418,693,JUNC00000002,2,-,418,693,255;0;0,2,118,24,0,251,536,669,133,1
20769ref2,8749,9032,JUNC00000149,1674,+,8749,9032,255;0;0,2,26,125,0,158,8775,8907,132,1
20769ref2,767,1133,JUNC00000020,19,+,767,1133,255;0;0,2,111,131,0,235,878,1002,124,1
20769ref2,7987,8410,JUNC00000145,14,-,7987,8410,255;0;0,2,149,150,0,273,8136,8260,124,1
20769ref2,498,827,JUNC00000006,9,-,498,827,255;0;0,2,60,147,0,182,558,680,122,1
20769ref2,2166,2437,JUNC00000058,1,-,2166,2437,255;0;0,2,53,98,0,173,2219,2339,120,1
20769ref2,4984,5310,JUNC00000099,2,-,4984,5310,255;0;0,2,146,63,0,263,5130,5247,117,1
20769ref2,6967,7383,JUNC00000120,7,+,6967,7383,255;0;0,2,150,149,0,267,7117,7234,117,1
20769ref2,2389,2674,JUNC00000065,2,-,2389,2674,255;0;0,2,147,22,0,263,2536,2652,116,1
20769ref2,8385,8650,JUNC00000147,1,-,8385,8650,255;0;0,2,95,56,0,209,8480,8594,114,1
20769ref2,5342,5605,JUNC00000103,1,+,5342,5605,255;0;0,2,34,117,0,146,5376,5488,112,1
20769ref2,972,1378,JUNC00000035,25,+,972,1378,255;0;0,2,150,146,0,260,1122,1232,110,1
20769ref2,2854,3110,JUNC00000073,59,+,2854,3110,255;0;0,2,146,8,0,248,3000,3102,102,1
20769ref2,1350,1692,JUNC00000045,2,+,1350,1692,255;0;0,2,115,127,0,215,1465,1565,100,1
20769ref2,2356,2609,JUNC00000059,3,-,2356,2609,255;0;0,2,8,145,0,108,2364,2464,100,1
20769ref2,8884,9276,JUNC00000157,127,+,8884,9276,255;0;0,2,146,146,0,246,9030,9130,100,1
20769ref2,758,1151,JUNC00000021,7,+,758,1151,255;0;0,2,145,149,0,244,903,1002,99,1
20769ref2,2670,2920,JUNC00000069,3,-,2670,2920,255;0;0,2,146,8,0,242,2816,2912,96,1
20769ref2,2757,3067,JUNC00000070,5,+,2757,3067,255;0;0,2,66,148,0,162,2823,2919,96,1
20769ref2,7921,8308,JUNC00000143,59,-,7921,8308,255;0;0,2,145,150,0,237,8066,8158,92,1
20769ref2,9856,10097,JUNC00000170,2,+,9856,10097,255;0;0,2,101,50,0,191,9957,10047,90,1
20769ref2,1722,2041,JUNC00000052,14,-,1722,2041,255;0;0,2,104,129,0,190,1826,1912,86,1
20769ref2,6354,6586,JUNC00000116,1,-,6354,6586,255;0;0,2,101,50,0,182,6455,6536,81,1
20769ref2,5737,5968,JUNC00000105,12,-,5737,5968,255;0;0,2,136,15,0,216,5873,5953,80,1
20769ref2,2817,3194,JUNC00000072,45,-,2817,3194,255;0;0,2,150,149,0,228,2967,3045,78,1
20769ref2,3993,4221,JUNC00000087,2,+,3993,4221,255;0;0,2,32,118,0,110,4025,4103,78,1
20769ref2,7551,7824,JUNC00000129,19,+,7551,7824,255;0;0,2,85,113,0,160,7636,7711,75,1
20769ref2,699,961,JUNC00000019,11,+,699,961,255;0;0,2,147,45,0,217,846,916,70,1
20769ref2,1402,1738,JUNC00000048,4,+,1402,1738,255;0;0,2,146,120,0,216,1548,1618,70,1
20769ref2,1706,2031,JUNC00000051,6,-,1706,2031,255;0;0,2,109,146,0,179,1815,1885,70,1
20769ref2,8928,9246,JUNC00000156,25,+,8928,9246,255;0;0,2,102,146,0,172,9030,9100,70,1
20769ref2,2887,3110,JUNC00000074,8,+,2887,3110,255;0;0,2,146,8,0,215,3033,3102,69,1
20769ref2,1814,1940,JUNC00000053,1,+,1814,1940,255;0;0,2,36,22,0,104,1850,1918,68,1
20769ref2,9000,9219,JUNC00000160,2,+,9000,9219,255;0;0,2,120,31,0,188,9120,9188,68,1
20769ref2,7362,7725,JUNC00000125,278,-,7362,7725,255;0;0,2,149,147,0,216,7511,7578,67,1
20769ref2,2797,3136,JUNC00000071,7,+,2797,3136,255;0;0,2,127,147,0,192,2924,2989,65,1
20769ref2,1451,1663,JUNC00000046,1,+,1451,1663,255;0;0,2,53,98,0,114,1504,1565,61,1
20769ref2,787,902,JUNC00000018,1,-,787,902,255;0;0,2,31,24,0,91,818,878,60,1
20769ref2,451,647,JUNC00000004,7,+,451,647,255;0;0,2,98,39,0,157,549,608,59,1
20769ref2,4402,4701,JUNC00000091,56,-,4402,4701,255;0;0,2,95,146,0,153,4497,4555,58,1
20769ref2,8400,8694,JUNC00000148,18,+,8400,8694,255;0;0,2,88,148,0,146,8488,8546,58,1
20769ref2,955,1259,JUNC00000032,1172,-,955,1259,255;0;0,2,146,101,0,203,1101,1158,57,1
20769ref2,572,779,JUNC00000013,1,+,572,779,255;0;0,2,102,49,0,158,674,730,56,1
20769ref2,7541,7814,JUNC00000128,3,+,7541,7814,255;0;0,2,75,143,0,130,7616,7671,55,1
20769ref2,9021,9226,JUNC00000159,1,-,9021,9226,255;0;0,2,57,94,0,111,9078,9132,54,1
20769ref2,825,1171,JUNC00000025,43,+,825,1171,255;0;0,2,144,149,0,197,969,1022,53,1
20769ref2,7774,7975,JUNC00000139,95,-,7774,7975,255;0;0,2,92,59,0,142,7866,7916,50,1
20769ref2,574,772,JUNC00000009,2,+,574,772,255;0;0,2,53,98,0,100,627,674,47,1
20769ref2,8304,8521,JUNC00000146,18,+,8304,8521,255;0;0,2,145,25,0,192,8449,8496,47,1
20769ref2,8912,9234,JUNC00000158,6,-,8912,9234,255;0;0,2,144,131,0,191,9056,9103,47,1
20769ref2,894,1092,JUNC00000028,5,+,894,1092,255;0;0,2,144,8,0,190,1038,1084,46,1
20769ref2,10008,10205,JUNC00000171,1,+,10008,10205,255;0;0,2,138,13,0,184,10146,10192,46,1
20769ref2,1122,1344,JUNC00000040,5,+,1122,1344,255;0;0,2,148,29,0,193,1270,1315,45,1
20769ref2,3851,4047,JUNC00000086,1,+,3851,4047,255;0;0,2,95,56,0,140,3946,3991,45,1
20769ref2,949,1292,JUNC00000031,410,-,949,1292,255;0;0,2,150,150,0,193,1099,1142,43,1
20769ref2,6916,7108,JUNC00000119,1,-,6916,7108,255;0;0,2,95,56,0,136,7011,7052,41,1
20769ref2,2565,2640,JUNC00000067,1,+,2565,2640,255;0;0,2,24,11,0,64,2589,2629,40,1
20769ref2,7631,7821,JUNC00000131,1,+,7631,7821,255;0;0,2,29,122,0,68,7660,7699,39,1
20769ref2,2238,2570,JUNC00000061,13,-,2238,2570,255;0;0,2,150,146,0,186,2388,2424,36,1
20769ref2,7516,7707,JUNC00000130,6,+,7516,7707,255;0;0,2,144,11,0,180,7660,7696,36,1
20769ref2,2449,2783,JUNC00000068,1043,-,2449,2783,255;0;0,2,149,150,0,184,2598,2633,35,1
20769ref2,9761,9946,JUNC00000166,1,-,9761,9946,255;0;0,2,63,88,0,97,9824,9858,34,1
20769ref2,1845,2031,JUNC00000055,4,+,1845,2031,255;0;0,2,144,9,0,177,1989,2022,33,1
20769ref2,4440,4624,JUNC00000092,2,-,4440,4624,255;0;0,2,66,85,0,99,4506,4539,33,1
20769ref2,5826,6157,JUNC00000106,9,+,5826,6157,255;0;0,2,148,150,0,181,5974,6007,33,1
20769ref2,8771,9102,JUNC00000153,6,+,8771,9102,255;0;0,2,148,150,0,181,8919,8952,33,1
20769ref2,8989,9315,JUNC00000163,17,-,8989,9315,255;0;0,2,147,147,0,179,9136,9168,32,1
20769ref2,5826,6157,JUNC00000107,5,+,5826,6157,255;0;0,2,150,150,0,181,5976,6007,31,1
20769ref2,3022,3210,JUNC00000077,32,-,3022,3210,255;0;0,2,149,9,0,179,3171,3201,30,1
20769ref2,497,682,JUNC00000008,5,+,497,682,255;0;0,2,130,26,0,159,627,656,29,1
20769ref2,6110,6432,JUNC00000115,8,+,6110,6432,255;0;0,2,145,148,0,174,6255,6284,29,1
20769ref2,7708,8033,JUNC00000138,35,+,7708,8033,255;0;0,2,149,148,0,177,7857,7885,28,1
20769ref2,3248,3433,JUNC00000080,26,-,3248,3433,255;0;0,2,9,149,0,36,3257,3284,27,1
20769ref2,7400,7577,JUNC00000126,8,-,7400,7577,255;0;0,2,130,21,0,156,7530,7556,26,1
20769ref2,973,1290,JUNC00000034,20,+,973,1290,255;0;0,2,149,143,0,174,1122,1147,25,1
20769ref2,7526,7847,JUNC00000132,7,+,7526,7847,255;0;0,2,148,148,0,173,7674,7699,25,1
20769ref2,2916,3232,JUNC00000076,3,-,2916,3232,255;0;0,2,149,145,0,171,3065,3087,22,1
20769ref2,9262,9434,JUNC00000165,1,-,9262,9434,255;0;0,2,124,27,0,145,9386,9407,21,1
20769ref2,4683,4900,JUNC00000096,2,+,4683,4900,255;0;0,2,82,117,0,100,4765,4783,18,1
20769ref2,6086,6260,JUNC00000110,3,-,6086,6260,255;0;0,2,40,116,0,58,6126,6144,18,1
20769ref2,7963,8274,JUNC00000144,25,-,7963,8274,255;0;0,2,149,145,0,166,8112,8129,17,1
20769ref2,825,1134,JUNC00000024,69,+,825,1134,255;0;0,2,144,149,0,160,969,985,16,1
20769ref2,4993,5161,JUNC00000101,2,+,4993,5161,255;0;0,2,143,9,0,159,5136,5152,16,1
20769ref2,2435,2747,JUNC00000066,3,+,2435,2747,255;0;0,2,149,148,0,164,2584,2599,15,1
20769ref2,6015,6231,JUNC00000109,12,-,6015,6231,255;0;0,2,51,150,0,66,6066,6081,15,1
20769ref2,8988,9299,JUNC00000162,2,+,8988,9299,255;0;0,2,148,148,0,163,9136,9151,15,1
20769ref2,4156,4418,JUNC00000089,26,+,4156,4418,255;0;0,2,101,147,0,115,4257,4271,14,1
20769ref2,4783,4986,JUNC00000098,3,-,4783,4986,255;0;0,2,147,42,0,161,4930,4944,14,1
20769ref2,8773,9002,JUNC00000152,4,-,8773,9002,255;0;0,2,146,69,0,160,8919,8933,14,1
20769ref2,5717,5943,JUNC00000104,9,+,5717,5943,255;0;0,2,124,89,0,137,5841,5854,13,1
20769ref2,3177,3399,JUNC00000078,59,-,3177,3399,255;0;0,2,60,150,0,72,3237,3249,12,1
20769ref2,8988,9293,JUNC00000161,3,+,8988,9293,255;0;0,2,148,145,0,160,9136,9148,12,1
20769ref2,6582,6888,JUNC00000117,3,+,6582,6888,255;0;0,2,146,149,0,157,6728,6739,11,1
20769ref2,800,1099,JUNC00000022,125,-,800,1099,255;0;0,2,143,146,0,153,943,953,10,1
20769ref2,9030,9198,JUNC00000164,4,+,9030,9198,255;0;0,2,149,10,0,158,9179,9188,9,1
20769ref2,970,1271,JUNC00000033,6,+,970,1271,255;0;0,2,144,149,0,152,1114,1122,8,1
20769ref2,1001,1292,JUNC00000039,958,-,1001,1292,255;0;0,2,149,134,0,157,1150,1158,8,1
20769ref2,6106,6271,JUNC00000114,5,-,6106,6271,255;0;0,2,149,8,0,157,6255,6263,8,1
20769ref2,823,1126,JUNC00000023,1683,+,823,1126,255;0;0,2,146,150,0,153,969,976,7,1
20769ref2,1401,1558,JUNC00000047,2,-,1401,1558,255;0;0,2,105,46,0,111,1506,1512,6,1
20769ref2,2346,2643,JUNC00000064,6,+,2346,2643,255;0;0,2,145,146,0,151,2491,2497,6,1
20769ref2,3222,3399,JUNC00000079,711,+,3222,3399,255;0;0,2,21,150,0,27,3243,3249,6,1
20769ref2,4236,4469,JUNC00000090,580,-,4236,4469,255;0;0,2,146,81,0,152,4382,4388,6,1
20769ref2,6069,6233,JUNC00000112,13,+,6069,6233,255;0;0,2,150,8,0,156,6219,6225,6,1
20769ref2,7338,7495,JUNC00000124,1,-,7338,7495,255;0;0,2,143,8,0,149,7481,7487,6,1
20769ref2,1006,1302,JUNC00000038,2,-,1006,1302,255;0;0,2,144,147,0,149,1150,1155,5,1
20769ref2,5900,6201,JUNC00000108,19,+,5900,6201,255;0;0,2,150,146,0,155,6050,6055,5,1
20769ref2,7519,7675,JUNC00000127,4,-,7519,7675,255;0;0,2,54,97,0,59,7573,7578,5,1
20769ref2,8776,9078,JUNC00000155,42685,+,8776,9078,255;0;0,2,147,150,0,152,8923,8928,5,1
23573ref,300,9012,JUNC00000002,1,+,300,9012,255;0;0,2,24,127,0,8585,324,8885,8561,1
23573ref,699,7788,JUNC00000028,44,+,699,7788,255;0;0,2,147,89,0,7000,846,7699,6853,1
23573ref,1075,7700,JUNC00000054,20,+,1075,7700,255;0;0,2,146,149,0,6476,1221,7551,6330,1
23573ref,4380,10304,JUNC00000172,456,+,4380,10304,255;0;0,2,141,50,0,5874,4521,10254,5733,1
23573ref,3021,8752,JUNC00000131,2,+,3021,8752,255;0;0,2,141,78,0,5653,3162,8674,5512,1
23573ref,4419,9080,JUNC00000176,8,+,4419,9080,255;0;0,2,147,140,0,4521,4566,8940,4374,1
23573ref,4580,8529,JUNC00000178,56,+,4580,8529,255;0;0,2,141,91,0,3858,4721,8438,3717,1
23573ref,4248,7956,JUNC00000157,22,-,4248,7956,255;0;0,2,39,150,0,3558,4287,7806,3519,1
23573ref,4338,7572,JUNC00000170,23,-,4338,7572,255;0;0,2,148,149,0,3085,4486,7423,2937,1
23573ref,851,3184,JUNC00000034,44,-,851,3184,255;0;0,2,74,149,0,2184,925,3035,2110,1
23573ref,857,3189,JUNC00000037,103,+,857,3189,255;0;0,2,145,144,0,2188,1002,3045,2043,1
23573ref,1523,3096,JUNC00000062,166,+,1523,3096,255;0;0,2,145,150,0,1423,1668,2946,1278,1
23573ref,5476,6830,JUNC00000195,1040,+,5476,6830,255;0;0,2,150,148,0,1206,5626,6682,1056,1
23573ref,1566,2843,JUNC00000061,255,+,1566,2843,255;0;0,2,77,146,0,1131,1643,2697,1054,1
23573ref,5107,6451,JUNC00000192,6,+,5107,6451,255;0;0,2,149,149,0,1195,5256,6302,1046,1
23573ref,5045,6225,JUNC00000188,1,-,5045,6225,255;0;0,2,52,99,0,1081,5097,6126,1029,1
23573ref,871,2181,JUNC00000039,56,+,871,2181,255;0;0,2,144,147,0,1163,1015,2034,1019,1
23573ref,744,1897,JUNC00000021,25,-,744,1897,255;0;0,2,26,146,0,1007,770,1751,981,1
23573ref,871,2031,JUNC00000038,80,+,871,2031,255;0;0,2,144,146,0,1014,1015,1885,870,1
23573ref,6651,7405,JUNC00000224,19,+,6651,7405,255;0;0,2,144,148,0,606,6795,7257,462,1
23573ref,3930,4638,JUNC00000148,4,-,3930,4638,255;0;0,2,147,148,0,560,4077,4490,413,1
23573ref,6977,7558,JUNC00000229,2,+,6977,7558,255;0;0,2,20,149,0,432,6997,7409,412,1
23573ref,583,1127,JUNC00000010,46,+,583,1127,255;0;0,2,25,142,0,402,608,985,377,1
23573ref,4616,5259,JUNC00000181,38,+,4616,5259,255;0;0,2,149,146,0,497,4765,5113,348,1
23573ref,1492,1871,JUNC00000060,69,+,1492,1871,255;0;0,2,73,25,0,354,1565,1846,281,1
23573ref,575,1109,JUNC00000017,4,-,575,1109,255;0;0,2,148,149,0,385,723,960,237,1
23573ref,4715,5235,JUNC00000184,20,-,4715,5235,255;0;0,2,148,148,0,372,4863,5087,224,1
23573ref,6647,7052,JUNC00000220,26,+,6647,7052,255;0;0,2,55,149,0,256,6702,6903,201,1
23573ref,7339,7733,JUNC00000242,53,+,7339,7733,255;0;0,2,50,148,0,246,7389,7585,196,1
23573ref,9823,10313,JUNC00000311,131,+,9823,10313,255;0;0,2,147,150,0,340,9970,10163,193,1
23573ref,8846,9176,JUNC00000298,1,+,8846,9176,255;0;0,2,105,46,0,284,8951,9130,179,1
23573ref,7551,8019,JUNC00000262,36,+,7551,8019,255;0;0,2,148,146,0,322,7699,7873,174,1
23573ref,8430,8749,JUNC00000289,8,+,8430,8749,255;0;0,2,8,143,0,176,8438,8606,168,1
23573ref,543,880,JUNC00000008,19,-,543,880,255;0;0,2,26,148,0,189,569,732,163,1
23573ref,2886,3345,JUNC00000126,14,+,2886,3345,255;0;0,2,147,149,0,310,3033,3196,163,1
23573ref,635,958,JUNC00000013,47,+,635,958,255;0;0,2,21,146,0,177,656,812,156,1
23573ref,3958,4410,JUNC00000150,35,-,3958,4410,255;0;0,2,149,149,0,303,4107,4261,154,1
23573ref,6517,6968,JUNC00000219,10,+,6517,6968,255;0;0,2,147,150,0,301,6664,6818,154,1
23573ref,81,534,JUNC00000001,11,-,81,534,255;0;0,2,150,150,0,303,231,384,153,1
23573ref,2478,2768,JUNC00000091,66,+,2478,2768,255;0;0,2,23,116,0,174,2501,2652,151,1
23573ref,7562,7749,JUNC00000252,4,+,7562,7749,255;0;0,2,30,8,0,179,7592,7741,149,1
23573ref,7584,7902,JUNC00000253,6,+,7584,7902,255;0;0,2,20,149,0,169,7604,7753,149,1
23573ref,8290,8735,JUNC00000288,28,+,8290,8735,255;0;0,2,148,148,0,297,8438,8587,149,1
23573ref,4048,4386,JUNC00000149,27,+,4048,4386,255;0;0,2,41,149,0,189,4089,4237,148,1
23573ref,1003,1336,JUNC00000051,14,+,1003,1336,255;0;0,2,145,41,0,292,1148,1295,147,1
23573ref,9599,9943,JUNC00000303,8,-,9599,9943,255;0;0,2,56,143,0,201,9655,9800,145,1
23573ref,2655,2988,JUNC00000106,10,+,2655,2988,255;0;0,2,42,148,0,185,2697,2840,143,1
23573ref,2342,2779,JUNC00000089,28,+,2342,2779,255;0;0,2,149,150,0,287,2491,2629,138,1
23573ref,513,941,JUNC00000012,30,+,513,941,255;0;0,2,143,148,0,280,656,793,137,1
23573ref,9654,9970,JUNC00000304,35,-,9654,9970,255;0;0,2,34,146,0,170,9688,9824,136,1
23573ref,4395,4712,JUNC00000173,13,-,4395,4712,255;0;0,2,137,45,0,272,4532,4667,135,1
23573ref,4393,4814,JUNC00000174,40,-,4393,4814,255;0;0,2,146,140,0,281,4539,4674,135,1
23573ref,4395,4729,JUNC00000175,16,-,4395,4729,255;0;0,2,149,50,0,284,4544,4679,135,1
23573ref,2172,2598,JUNC00000081,1101,+,2172,2598,255;0;0,2,150,147,0,279,2322,2451,129,1
23573ref,7012,7437,JUNC00000233,38,-,7012,7437,255;0;0,2,148,150,0,275,7160,7287,127,1
23573ref,1793,1974,JUNC00000070,1,-,1793,1974,255;0;0,2,33,22,0,159,1826,1952,126,1
23573ref,4809,5164,JUNC00000185,222,+,4809,5164,255;0;0,2,82,147,0,208,4891,5017,126,1
23573ref,3912,4332,JUNC00000147,177,+,3912,4332,255;0;0,2,147,149,0,271,4059,4183,124,1
23573ref,489,738,JUNC00000006,41,+,489,738,255;0;0,2,45,82,0,167,534,656,122,1
23573ref,2436,2753,JUNC00000088,7,+,2436,2753,255;0;0,2,45,150,0,167,2481,2603,122,1
23573ref,2343,2763,JUNC00000090,17,+,2343,2763,255;0;0,2,150,150,0,270,2493,2613,120,1
23573ref,7323,7741,JUNC00000247,3,+,7323,7741,255;0;0,2,150,149,0,269,7473,7592,119,1
23573ref,4403,4702,JUNC00000167,71,-,4403,4702,255;0;0,2,34,147,0,152,4437,4555,118,1
23573ref,607,1014,JUNC00000019,15,-,607,1014,255;0;0,2,150,148,0,259,757,866,109,1
23573ref,636,1041,JUNC00000023,48,+,636,1041,255;0;0,2,147,149,0,256,783,892,109,1
23573ref,5626,6032,JUNC00000199,12,+,5626,6032,255;0;0,2,149,148,0,258,5775,5884,109,1
23573ref,6476,6878,JUNC00000217,2,-,6476,6878,255;0;0,2,145,148,0,254,6621,6730,109,1
23573ref,4181,4453,JUNC00000153,2,+,4181,4453,255;0;0,2,20,148,0,124,4201,4305,104,1
23573ref,7805,8046,JUNC00000270,9,-,7805,8046,255;0;0,2,70,68,0,173,7875,7978,103,1
23573ref,2160,2473,JUNC00000079,94,+,2160,2473,255;0;0,2,65,146,0,167,2225,2327,102,1
23573ref,4183,4583,JUNC00000160,52,+,4183,4583,255;0;0,2,148,150,0,250,4331,4433,102,1
23573ref,4789,5058,JUNC00000183,47,-,4789,5058,255;0;0,2,74,93,0,176,4863,4965,102,1
23573ref,1392,1710,JUNC00000058,180,+,1392,1710,255;0;0,2,73,145,0,173,1465,1565,100,1
23573ref,5783,6182,JUNC00000205,28,-,5783,6182,255;0;0,2,150,150,0,249,5933,6032,99,1
23573ref,2479,2779,JUNC00000092,17,+,2479,2779,255;0;0,2,52,150,0,150,2531,2629,98,1
23573ref,5633,6019,JUNC00000200,26,-,5633,6019,255;0;0,2,143,149,0,237,5776,5870,94,1
23573ref,2394,2786,JUNC00000093,18,-,2394,2786,255;0;0,2,150,150,0,242,2544,2636,92,1
23573ref,749,1012,JUNC00000022,172,+,749,1012,255;0;0,2,24,148,0,115,773,864,91,1
23573ref,1476,1784,JUNC00000059,119,+,1476,1784,255;0;0,2,72,146,0,162,1548,1638,90,1
23573ref,9613,9876,JUNC00000302,56,+,9613,9876,255;0;0,2,26,147,0,116,9639,9729,90,1
23573ref,10379,10634,JUNC00000312,4,+,10379,10634,255;0;0,2,122,46,0,209,10501,10588,87,1
23573ref,387,771,JUNC00000007,27,+,387,771,255;0;0,2,149,149,0,235,536,622,86,1
23573ref,1716,2059,JUNC00000069,3,-,1716,2059,255;0;0,2,110,147,0,196,1826,1912,86,1
23573ref,1600,1942,JUNC00000064,161,+,1600,1942,255;0;0,2,110,149,0,193,1710,1793,83,1
23573ref,6599,6978,JUNC00000221,18,+,6599,6978,255;0;0,2,150,147,0,232,6749,6831,82,1
23573ref,8773,9144,JUNC00000296,22,+,8773,9144,255;0;0,2,142,147,0,224,8915,8997,82,1
23573ref,1892,2183,JUNC00000074,30,+,1892,2183,255;0;0,2,61,149,0,142,1953,2034,81,1
23573ref,2640,2897,JUNC00000103,239,+,2640,2897,255;0;0,2,30,146,0,111,2670,2751,81,1
23573ref,5785,6017,JUNC00000204,11,+,5785,6017,255;0;0,2,144,8,0,224,5929,6009,80,1
23573ref,525,892,JUNC00000015,37,+,525,892,255;0;0,2,149,140,0,227,674,752,78,1
23573ref,4616,4990,JUNC00000180,94,+,4616,4990,255;0;0,2,149,147,0,227,4765,4843,78,1
23573ref,4202,4431,JUNC00000154,2,+,4202,4431,255;0;0,2,10,143,0,86,4212,4288,76,1
23573ref,4993,5368,JUNC00000189,2,+,4993,5368,255;0;0,2,149,150,0,225,5142,5218,76,1
23573ref,7541,7847,JUNC00000254,157,+,7541,7847,255;0;0,2,82,148,0,158,7623,7699,76,1
23573ref,745,992,JUNC00000020,22,-,745,992,255;0;0,2,25,147,0,100,770,845,75,1
23573ref,1606,1974,JUNC00000065,103,-,1606,1974,255;0;0,2,145,148,0,220,1751,1826,75,1
23573ref,525,886,JUNC00000014,60,+,525,886,255;0;0,2,149,141,0,220,674,745,71,1
23573ref,1768,1957,JUNC00000072,6,+,1768,1957,255;0;0,2,82,39,0,150,1850,1918,68,1
23573ref,2744,3108,JUNC00000119,29,+,2744,3108,255;0;0,2,149,147,0,217,2893,2961,68,1
23573ref,2759,3120,JUNC00000120,2,-,2759,3120,255;0;0,2,145,148,0,213,2904,2972,68,1
23573ref,7361,7726,JUNC00000249,153,-,7361,7726,255;0;0,2,150,148,0,217,7511,7578,67,1
23573ref,5015,5379,JUNC00000191,59,+,5015,5379,255;0;0,2,149,149,0,215,5164,5230,66,1
23573ref,7346,7699,JUNC00000248,24,+,7346,7699,255;0;0,2,148,139,0,214,7494,7560,66,1
23573ref,1659,2024,JUNC00000068,6,-,1659,2024,255;0;0,2,150,150,0,215,1809,1874,65,1
23573ref,7254,7619,JUNC00000243,20,-,7254,7619,255;0;0,2,150,150,0,215,7404,7469,65,1
23573ref,8282,8535,JUNC00000286,23,+,8282,8535,255;0;0,2,149,39,0,214,8431,8496,65,1
23573ref,4013,4346,JUNC00000152,3,+,4013,4346,255;0;0,2,123,146,0,187,4136,4200,64,1
23573ref,828,1062,JUNC00000031,7,+,828,1062,255;0;0,2,24,148,0,86,852,914,62,1
23573ref,923,1282,JUNC00000040,2,+,923,1282,255;0;0,2,148,149,0,210,1071,1133,62,1
23573ref,4227,4350,JUNC00000155,6,-,4227,4350,255;0;0,2,23,38,0,85,4250,4312,62,1
23573ref,7312,7545,JUNC00000241,25,-,7312,7545,255;0;0,2,23,149,0,84,7335,7396,61,1
23573ref,7259,7615,JUNC00000246,12,-,7259,7615,255;0;0,2,150,146,0,210,7409,7469,60,1
23573ref,4616,4968,JUNC00000179,65,+,4616,4968,255;0;0,2,149,144,0,208,4765,4824,59,1
23573ref,4356,4635,JUNC00000171,48,-,4356,4635,255;0;0,2,141,80,0,199,4497,4555,58,1
23573ref,955,1306,JUNC00000043,689,-,955,1306,255;0;0,2,146,148,0,203,1101,1158,57,1
23573ref,1955,2311,JUNC00000076,13,+,1955,2311,255;0;0,2,149,150,0,206,2104,2161,57,1
23573ref,6834,7104,JUNC00000225,153,+,6834,7104,255;0;0,2,69,145,0,125,6903,6959,56,1
23573ref,8231,8579,JUNC00000282,3,+,8231,8579,255;0;0,2,143,149,0,199,8374,8430,56,1
23573ref,674,1019,JUNC00000027,163,+,674,1019,255;0;0,2,142,148,0,197,816,871,55,1
23573ref,4942,5163,JUNC00000187,74,+,4942,5163,255;0;0,2,21,146,0,75,4963,5017,54,1
23573ref,7490,7840,JUNC00000255,9,+,7490,7840,255;0;0,2,146,150,0,200,7636,7690,54,1
23573ref,7725,8010,JUNC00000269,165,-,7725,8010,255;0;0,2,150,81,0,204,7875,7929,54,1
23573ref,825,1172,JUNC00000036,31,+,825,1172,255;0;0,2,144,150,0,197,969,1022,53,1
23573ref,8559,8908,JUNC00000295,5,+,8559,8908,255;0;0,2,149,147,0,202,8708,8761,53,1
23573ref,454,703,JUNC00000005,41,-,454,703,255;0;0,2,48,149,0,100,502,554,52,1
23573ref,3012,3358,JUNC00000130,2,+,3012,3358,255;0;0,2,145,150,0,196,3157,3208,51,1
23573ref,7722,8066,JUNC00000267,40,-,7722,8066,255;0;0,2,144,150,0,194,7866,7916,50,1
23573ref,8559,8905,JUNC00000294,4,+,8559,8905,255;0;0,2,149,147,0,199,8708,8758,50,1
23573ref,2484,2778,JUNC00000096,22,+,2484,2778,255;0;0,2,96,149,0,145,2580,2629,49,1
23573ref,5680,6028,JUNC00000202,10,+,5680,6028,255;0;0,2,150,149,0,199,5830,5879,49,1
23573ref,9826,10043,JUNC00000307,224,-,9826,10043,255;0;0,2,25,143,0,74,9851,9900,49,1
23573ref,2586,2931,JUNC00000107,2,+,2586,2931,255;0;0,2,149,149,0,196,2735,2782,47,1
23573ref,2922,3144,JUNC00000121,2,+,2922,3144,255;0;0,2,25,150,0,72,2947,2994,47,1
23573ref,6778,6980,JUNC00000223,28,-,6778,6980,255;0;0,2,8,147,0,55,6786,6833,47,1
23573ref,976,1250,JUNC00000049,25,+,976,1250,255;0;0,2,146,82,0,192,1122,1168,46,1
23573ref,3722,3980,JUNC00000137,120,+,3722,3980,255;0;0,2,64,149,0,109,3786,3831,45,1
23573ref,3771,4116,JUNC00000141,44,+,3771,4116,255;0;0,2,150,150,0,195,3921,3966,45,1
23573ref,3786,4128,JUNC00000143,4,+,3786,4128,255;0;0,2,149,148,0,194,3935,3980,45,1
23573ref,4911,5071,JUNC00000186,143,-,4911,5071,255;0;0,2,48,67,0,93,4959,5004,45,1
23573ref,7130,7473,JUNC00000238,60,+,7130,7473,255;0;0,2,148,150,0,193,7278,7323,45,1
23573ref,4331,4543,JUNC00000163,74,-,4331,4543,255;0;0,2,21,148,0,64,4352,4395,43,1
23573ref,2666,3002,JUNC00000111,67,-,2666,3002,255;0;0,2,150,144,0,192,2816,2858,42,1
23573ref,600,930,JUNC00000018,64,-,600,930,255;0;0,2,144,145,0,185,744,785,41,1
23573ref,949,1288,JUNC00000042,65,-,949,1288,255;0;0,2,150,149,0,190,1099,1139,40,1
23573ref,2444,2779,JUNC00000098,10,+,2444,2779,255;0;0,2,145,150,0,185,2589,2629,40,1
23573ref,2718,3055,JUNC00000118,11,+,2718,3055,255;0;0,2,147,150,0,187,2865,2905,40,1
23573ref,4247,4582,JUNC00000166,6,+,4247,4582,255;0;0,2,146,149,0,186,4393,4433,40,1
23573ref,5807,6142,JUNC00000206,8,-,5807,6142,255;0;0,2,146,149,0,186,5953,5993,40,1
23573ref,6629,6968,JUNC00000222,16,-,6629,6968,255;0;0,2,149,150,0,189,6778,6818,40,1
23573ref,8173,8505,JUNC00000280,77,+,8173,8505,255;0;0,2,148,144,0,188,8321,8361,40,1
23573ref,7497,7832,JUNC00000256,4,+,7497,7832,255;0;0,2,150,147,0,188,7647,7685,38,1
23573ref,7963,8190,JUNC00000275,35,-,7963,8190,255;0;0,2,149,40,0,187,8112,8150,38,1
23573ref,2862,3196,JUNC00000124,15,+,2862,3196,255;0;0,2,148,149,0,185,3010,3047,37,1
23573ref,3877,4110,JUNC00000142,23,+,3877,4110,255;0;0,2,47,149,0,84,3924,3961,37,1
23573ref,3920,4121,JUNC00000144,24,+,3920,4121,255;0;0,2,19,145,0,56,3939,3976,37,1
23573ref,7182,7373,JUNC00000234,42,+,7182,7373,255;0;0,2,8,146,0,45,7190,7227,37,1
23573ref,7147,7481,JUNC00000240,6,+,7147,7481,255;0;0,2,149,148,0,186,7296,7333,37,1
23573ref,306,640,JUNC00000004,15,+,306,640,255;0;0,2,148,150,0,184,454,490,36,1
23573ref,2238,2573,JUNC00000084,94,-,2238,2573,255;0;0,2,150,149,0,186,2388,2424,36,1
23573ref,5680,6013,JUNC00000201,21,+,5680,6013,255;0;0,2,150,147,0,186,5830,5866,36,1
23573ref,1123,1452,JUNC00000056,22,+,1123,1452,255;0;0,2,147,147,0,182,1270,1305,35,1
23573ref,2448,2783,JUNC00000101,441,-,2448,2783,255;0;0,2,150,150,0,185,2598,2633,35,1
23573ref,2680,3011,JUNC00000114,16,+,2680,3011,255;0;0,2,147,149,0,182,2827,2862,35,1
23573ref,2659,2989,JUNC00000108,82,+,2659,2989,255;0;0,2,147,149,0,181,2806,2840,34,1
23573ref,722,969,JUNC00000024,39,+,722,969,255;0;0,2,71,143,0,104,793,826,33,1
23573ref,945,1278,JUNC00000041,26,+,945,1278,255;0;0,2,150,150,0,183,1095,1128,33,1
23573ref,2806,3134,JUNC00000122,3,+,2806,3134,255;0;0,2,150,145,0,183,2956,2989,33,1
23573ref,5450,5778,JUNC00000194,32,-,5450,5778,255;0;0,2,150,145,0,183,5600,5633,33,1
23573ref,7913,8244,JUNC00000273,33,-,7913,8244,255;0;0,2,148,150,0,181,8061,8094,33,1
23573ref,8007,8339,JUNC00000278,35,+,8007,8339,255;0;0,2,149,150,0,182,8156,8189,33,1
23573ref,2522,2727,JUNC00000094,108,+,2522,2727,255;0;0,2,25,149,0,56,2547,2578,31,1
23573ref,2998,3325,JUNC00000129,3,+,2998,3325,255;0;0,2,149,147,0,180,3147,3178,31,1
23573ref,8290,8538,JUNC00000287,34,+,8290,8538,255;0;0,2,148,69,0,179,8438,8469,31,1
23573ref,4183,4511,JUNC00000159,22,+,4183,4511,255;0;0,2,148,150,0,178,4331,4361,30,1
23573ref,4311,4393,JUNC00000161,3,-,4311,4393,255;0;0,2,39,13,0,69,4350,4380,30,1
23573ref,4285,4531,JUNC00000162,61,-,4285,4531,255;0;0,2,67,149,0,97,4352,4382,30,1
23573ref,2881,3068,JUNC00000125,4,+,2881,3068,255;0;0,2,150,8,0,179,3031,3060,29,1
23573ref,2989,3215,JUNC00000127,37,-,2989,3215,255;0;0,2,47,150,0,76,3036,3065,29,1
23573ref,3864,4192,JUNC00000146,2,-,3864,4192,255;0;0,2,150,149,0,179,4014,4043,29,1
23573ref,5716,5969,JUNC00000203,4,+,5716,5969,255;0;0,2,149,75,0,178,5865,5894,29,1
23573ref,6106,6434,JUNC00000215,29,+,6106,6434,255;0;0,2,149,150,0,178,6255,6284,29,1
23573ref,8279,8607,JUNC00000284,12,+,8279,8607,255;0;0,2,150,149,0,179,8429,8458,29,1
23573ref,3023,3351,JUNC00000133,746,-,3023,3351,255;0;0,2,150,150,0,178,3173,3201,28,1
23573ref,5833,6158,JUNC00000208,5,-,5833,6158,255;0;0,2,148,149,0,176,5981,6009,28,1
23573ref,2666,2992,JUNC00000110,10,-,2666,2992,255;0;0,2,150,149,0,177,2816,2843,27,1
23573ref,3200,3434,JUNC00000134,61,-,3200,3434,255;0;0,2,57,150,0,84,3257,3284,27,1
23573ref,3811,4044,JUNC00000138,35,+,3811,4044,255;0;0,2,56,150,0,83,3867,3894,27,1
23573ref,4226,4549,JUNC00000165,4,+,4226,4549,255;0;0,2,149,147,0,176,4375,4402,27,1
23573ref,7701,7948,JUNC00000264,20,-,7701,7948,255;0;0,2,147,73,0,174,7848,7875,27,1
23573ref,828,1028,JUNC00000030,11,+,828,1028,255;0;0,2,24,150,0,50,852,878,26,1
23573ref,962,1286,JUNC00000044,12,+,962,1286,255;0;0,2,149,149,0,175,1111,1137,26,1
23573ref,7382,7704,JUNC00000250,9,-,7382,7704,255;0;0,2,148,148,0,174,7530,7556,26,1
23573ref,975,1166,JUNC00000048,5,+,975,1166,255;0;0,2,147,19,0,172,1122,1147,25,1
23573ref,1976,2300,JUNC00000078,10,-,1976,2300,255;0;0,2,149,150,0,174,2125,2150,25,1
23573ref,3022,3345,JUNC00000132,105,+,3022,3345,255;0;0,2,149,149,0,174,3171,3196,25,1
23573ref,5825,6023,JUNC00000207,9,-,5825,6023,255;0;0,2,149,24,0,174,5974,5999,25,1
23573ref,6951,7275,JUNC00000230,41,-,6951,7275,255;0;0,2,150,149,0,175,7101,7126,25,1
23573ref,1621,1943,JUNC00000067,34,+,1621,1943,255;0;0,2,148,150,0,172,1769,1793,24,1
23573ref,2666,2887,JUNC00000109,3,-,2666,2887,255;0;0,2,150,47,0,174,2816,2840,24,1
23573ref,2833,3154,JUNC00000123,7,+,2833,3154,255;0;0,2,149,148,0,173,2982,3006,24,1
23573ref,3823,4044,JUNC00000139,17,+,3823,4044,255;0;0,2,47,150,0,71,3870,3894,24,1
23573ref,1977,2295,JUNC00000077,3,+,1977,2295,255;0;0,2,145,150,0,168,2122,2145,23,1
23573ref,7818,7862,JUNC00000263,1,-,7818,7862,255;0;0,2,8,13,0,31,7826,7849,23,1
23573ref,9823,10139,JUNC00000310,187,+,9823,10139,255;0;0,2,147,146,0,170,9970,9993,23,1
23573ref,779,976,JUNC00000025,41,+,779,976,255;0;0,2,25,150,0,47,804,826,22,1
23573ref,8006,8325,JUNC00000276,17,+,8006,8325,255;0;0,2,148,149,0,170,8154,8176,22,1
23573ref,5849,6166,JUNC00000209,22,+,5849,6166,255;0;0,2,148,148,0,169,5997,6018,21,1
23573ref,6376,6695,JUNC00000216,3,-,6376,6695,255;0;0,2,150,148,0,171,6526,6547,21,1
23573ref,6602,6800,JUNC00000218,23,+,6602,6800,255;0;0,2,27,150,0,48,6629,6650,21,1
23573ref,8155,8327,JUNC00000279,1,-,8155,8327,255;0;0,2,127,24,0,148,8282,8303,21,1
23573ref,8263,8507,JUNC00000281,15,-,8263,8507,255;0;0,2,77,146,0,98,8340,8361,21,1
23573ref,8964,9280,JUNC00000299,2,-,8964,9280,255;0;0,2,147,148,0,168,9111,9132,21,1
23573ref,977,1292,JUNC00000050,63,+,977,1292,255;0;0,2,150,145,0,170,1127,1147,20,1
23573ref,2177,2493,JUNC00000082,130,+,2177,2493,255;0;0,2,150,146,0,170,2327,2347,20,1
23573ref,5001,5214,JUNC00000190,5,+,5001,5214,255;0;0,2,150,43,0,170,5151,5171,20,1
23573ref,7113,7430,JUNC00000236,32,-,7113,7430,255;0;0,2,150,147,0,170,7263,7283,20,1
23573ref,7515,7710,JUNC00000258,8,+,7515,7710,255;0;0,2,150,25,0,170,7665,7685,20,1
23573ref,8300,8618,JUNC00000291,15,+,8300,8618,255;0;0,2,149,149,0,169,8449,8469,20,1
23573ref,2240,2556,JUNC00000083,25,+,2240,2556,255;0;0,2,148,149,0,167,2388,2407,19,1
23573ref,630,822,JUNC00000011,112,+,630,822,255;0;0,2,26,148,0,44,656,674,18,1
23573ref,1024,1215,JUNC00000053,2,-,1024,1215,255;0;0,2,150,23,0,168,1174,1192,18,1
23573ref,5250,5568,JUNC00000193,1623,+,5250,5568,255;0;0,2,150,150,0,168,5400,5418,18,1
23573ref,6047,6285,JUNC00000213,329,-,6047,6285,255;0;0,2,79,141,0,97,6126,6144,18,1
23573ref,2166,2483,JUNC00000080,23,-,2166,2483,255;0;0,2,150,150,0,167,2316,2333,17,1
23573ref,4058,4298,JUNC00000151,394,+,4058,4298,255;0;0,2,74,149,0,91,4132,4149,17,1
23573ref,7964,8278,JUNC00000274,75,-,7964,8278,255;0;0,2,148,149,0,165,8112,8129,17,1
23573ref,1534,1725,JUNC00000063,6,-,1534,1725,255;0;0,2,149,26,0,165,1683,1699,16,1
23573ref,1840,2148,JUNC00000075,2,-,1840,2148,255;0;0,2,145,147,0,161,1985,2001,16,1
23573ref,2717,2927,JUNC00000117,26,+,2717,2927,255;0;0,2,148,46,0,164,2865,2881,16,1
23573ref,7527,7840,JUNC00000259,10,+,7527,7840,255;0;0,2,147,150,0,163,7674,7690,16,1
23573ref,7539,7849,JUNC00000261,23,-,7539,7849,255;0;0,2,146,148,0,162,7685,7701,16,1
23573ref,1367,1555,JUNC00000057,8,+,1367,1555,255;0;0,2,26,147,0,41,1393,1408,15,1
23573ref,2434,2748,JUNC00000097,20,+,2434,2748,255;0;0,2,150,149,0,165,2584,2599,15,1
23573ref,2448,2763,JUNC00000100,12,+,2448,2763,255;0;0,2,150,150,0,165,2598,2613,15,1
23573ref,2680,2994,JUNC00000115,31,+,2680,2994,255;0;0,2,150,149,0,165,2830,2845,15,1
23573ref,3657,3917,JUNC00000135,107,-,3657,3917,255;0;0,2,95,150,0,110,3752,3767,15,1
23573ref,7130,7443,JUNC00000237,47,-,7130,7443,255;0;0,2,148,150,0,163,7278,7293,15,1
23573ref,7510,7825,JUNC00000257,3,+,7510,7825,255;0;0,2,150,150,0,165,7660,7675,15,1
23573ref,8987,9299,JUNC00000300,10,+,8987,9299,255;0;0,2,149,148,0,164,9136,9151,15,1
23573ref,968,1275,JUNC00000046,4,+,968,1275,255;0;0,2,146,147,0,160,1114,1128,14,1
23573ref,4109,4418,JUNC00000156,29,+,4109,4418,255;0;0,2,148,147,0,162,4257,4271,14,1
23573ref,8299,8613,JUNC00000290,49,+,8299,8613,255;0;0,2,150,150,0,164,8449,8463,14,1
23573ref,2803,2990,JUNC00000113,9,+,2803,2990,255;0;0,2,24,150,0,37,2827,2840,13,1
23573ref,7139,7448,JUNC00000239,106,-,7139,7448,255;0;0,2,148,148,0,161,7287,7300,13,1
23573ref,828,1012,JUNC00000029,12,+,828,1012,255;0;0,2,24,148,0,36,852,864,12,1
23573ref,1744,1923,JUNC00000066,28,-,1744,1923,255;0;0,2,19,148,0,31,1763,1775,12,1
23573ref,2385,2564,JUNC00000085,4,+,2385,2564,255;0;0,2,21,146,0,33,2406,2418,12,1
23573ref,2795,2981,JUNC00000112,6,-,2795,2981,255;0;0,2,25,149,0,37,2820,2832,12,1
23573ref,5608,5919,JUNC00000197,4,+,5608,5919,255;0;0,2,149,150,0,161,5757,5769,12,1
23573ref,5692,5925,JUNC00000198,35,+,5692,5925,255;0;0,2,71,150,0,83,5763,5775,12,1
23573ref,701,870,JUNC00000016,496,+,701,870,255;0;0,2,9,149,0,20,710,721,11,1
23573ref,721,1028,JUNC00000032,183,+,721,1028,255;0;0,2,146,150,0,157,867,878,11,1
23573ref,2939,3245,JUNC00000128,14,-,2939,3245,255;0;0,2,147,148,0,158,3086,3097,11,1
23573ref,4340,4645,JUNC00000169,8,-,4340,4645,255;0;0,2,146,148,0,157,4486,4497,11,1
23573ref,6019,6276,JUNC00000211,177,-,6019,6276,255;0;0,2,96,150,0,107,6115,6126,11,1
23573ref,6029,6280,JUNC00000212,175,-,6029,6280,255;0;0,2,91,149,0,102,6120,6131,11,1
23573ref,6959,7268,JUNC00000231,3,-,6959,7268,255;0;0,2,149,149,0,160,7108,7119,11,1
23573ref,9787,9973,JUNC00000306,30,+,9787,9973,255;0;0,2,25,150,0,36,9812,9823,11,1
23573ref,9800,10108,JUNC00000308,26,-,9800,10108,255;0;0,2,150,147,0,161,9950,9961,11,1
23573ref,776,1084,JUNC00000033,6,-,776,1084,255;0;0,2,149,149,0,159,925,935,10,1
23573ref,2697,3005,JUNC00000116,44,+,2697,3005,255;0;0,2,149,149,0,159,2846,2856,10,1
23573ref,3741,3942,JUNC00000136,1517,+,3741,3942,255;0;0,2,45,146,0,55,3786,3796,10,1
23573ref,4835,5000,JUNC00000182,25,-,4835,5000,255;0;0,2,8,147,0,18,4843,4853,10,1
23573ref,7891,8191,JUNC00000272,3,+,7891,8191,255;0;0,2,143,147,0,153,8034,8044,10,1
23573ref,8480,8786,JUNC00000293,11,+,8480,8786,255;0;0,2,148,148,0,158,8628,8638,10,1
23573ref,305,490,JUNC00000003,23,+,305,490,255;0;0,2,149,27,0,158,454,463,9,1
23573ref,7365,7565,JUNC00000245,273,-,7365,7565,255;0;0,2,44,147,0,53,7409,7418,9,1
23573ref,8007,8314,JUNC00000277,10,+,8007,8314,255;0;0,2,149,149,0,158,8156,8165,9,1
23573ref,9030,9297,JUNC00000301,17,+,9030,9297,255;0;0,2,149,109,0,158,9179,9188,9,1
23573ref,666,973,JUNC00000026,19,+,666,973,255;0;0,2,150,149,0,158,816,824,8,1
23573ref,965,1270,JUNC00000045,8,+,965,1270,255;0;0,2,149,148,0,157,1114,1122,8,1
23573ref,1003,1306,JUNC00000052,85,-,1003,1306,255;0;0,2,147,148,0,155,1150,1158,8,1
23573ref,1074,1380,JUNC00000055,21,+,1074,1380,255;0;0,2,150,148,0,158,1224,1232,8,1
23573ref,1689,1992,JUNC00000071,8,+,1689,1992,255;0;0,2,149,146,0,157,1838,1846,8,1
23573ref,2448,2755,JUNC00000099,6,+,2448,2755,255;0;0,2,150,149,0,158,2598,2606,8,1
23573ref,2637,2840,JUNC00000104,33,+,2637,2840,255;0;0,2,45,150,0,53,2682,2690,8,1
23573ref,3766,4073,JUNC00000140,17,-,3766,4073,255;0;0,2,149,150,0,157,3915,3923,8,1
23573ref,4298,4605,JUNC00000168,84,+,4298,4605,255;0;0,2,150,149,0,158,4448,4456,8,1
23573ref,5687,5879,JUNC00000196,10,+,5687,5879,255;0;0,2,35,149,0,43,5722,5730,8,1
23573ref,6105,6409,JUNC00000214,10,-,6105,6409,255;0;0,2,150,146,0,158,6255,6263,8,1
23573ref,6892,7100,JUNC00000226,24,-,6892,7100,255;0;0,2,50,150,0,58,6942,6950,8,1
23573ref,823,1125,JUNC00000035,46,+,823,1125,255;0;0,2,146,149,0,153,969,976,7,1
23573ref,2439,2621,JUNC00000086,9,+,2439,2621,255;0;0,2,25,150,0,32,2464,2471,7,1
23573ref,4229,4530,JUNC00000164,4,-,4229,4530,255;0;0,2,146,148,0,153,4375,4382,7,1
23573ref,4563,4869,JUNC00000177,11,+,4563,4869,255;0;0,2,150,149,0,157,4713,4720,7,1
23573ref,6818,7122,JUNC00000228,280,+,6818,7122,255;0;0,2,148,149,0,155,6966,6973,7,1
23573ref,7531,7834,JUNC00000260,11,+,7531,7834,255;0;0,2,147,149,0,154,7678,7685,7,1
23573ref,7707,8013,JUNC00000265,6,+,7707,8013,255;0;0,2,150,149,0,157,7857,7864,7,1
23573ref,7719,7881,JUNC00000266,4,+,7719,7881,255;0;0,2,147,8,0,154,7866,7873,7,1
23573ref,7886,8188,JUNC00000271,3,+,7886,8188,255;0;0,2,148,147,0,155,8034,8041,7,1
23573ref,8410,8568,JUNC00000283,1,+,8410,8568,255;0;0,2,8,143,0,15,8418,8425,7,1
23573ref,8283,8587,JUNC00000285,29,+,8283,8587,255;0;0,2,148,149,0,155,8431,8438,7,1
23573ref,9686,9901,JUNC00000305,36,-,9686,9901,255;0;0,2,58,150,0,65,9744,9751,7,1
23573ref,973,1276,JUNC00000047,14,+,973,1276,255;0;0,2,149,148,0,155,1122,1128,6,1
23573ref,1712,2015,JUNC00000073,3,+,1712,2015,255;0;0,2,148,149,0,154,1860,1866,6,1
23573ref,7240,7416,JUNC00000235,21,-,7240,7416,255;0;0,2,23,147,0,29,7263,7269,6,1
23573ref,7259,7564,JUNC00000244,11,-,7259,7564,255;0;0,2,150,149,0,156,7409,7415,6,1
23573ref,9804,10107,JUNC00000309,4,-,9804,10107,255;0;0,2,149,148,0,155,9953,9959,6,1
23573ref,439,743,JUNC00000009,21,+,439,743,255;0;0,2,150,149,0,155,589,594,5,1
23573ref,2436,2635,JUNC00000087,7,+,2436,2635,255;0;0,2,45,149,0,50,2481,2486,5,1
23573ref,2417,2719,JUNC00000095,10,-,2417,2719,255;0;0,2,149,148,0,154,2566,2571,5,1
23573ref,2482,2786,JUNC00000102,45,+,2482,2786,255;0;0,2,149,150,0,154,2631,2636,5,1
23573ref,2666,2839,JUNC00000105,4,+,2666,2839,255;0;0,2,19,149,0,24,2685,2690,5,1
23573ref,3801,4105,JUNC00000145,30,-,3801,4105,255;0;0,2,150,149,0,155,3951,3956,5,1
23573ref,4153,4454,JUNC00000158,5,-,4153,4454,255;0;0,2,147,149,0,152,4300,4305,5,1
23573ref,5955,6163,JUNC00000210,29,+,5955,6163,255;0;0,2,150,53,0,155,6105,6110,5,1
23573ref,6920,7119,JUNC00000227,23,+,6920,7119,255;0;0,2,46,148,0,51,6966,6971,5,1
23573ref,6988,7289,JUNC00000232,41,+,6988,7289,255;0;0,2,149,147,0,154,7137,7142,5,1
23573ref,7423,7657,JUNC00000251,12,-,7423,7657,255;0;0,2,150,79,0,155,7573,7578,5,1
23573ref,7725,8027,JUNC00000268,31,-,7725,8027,255;0;0,2,150,147,0,155,7875,7880,5,1
23573ref,8379,8613,JUNC00000292,4,+,8379,8613,255;0;0,2,79,150,0,84,8458,8463,5,1
23573ref,8800,9078,JUNC00000297,2271,+,8800,9078,255;0;0,2,123,150,0,128,8923,8928,5,1
22089ref,1238,10284,JUNC00000026,14,+,1238,10284,255;0;0,2,148,8,0,9038,1386,10276,8890,1
22089ref,1245,10430,JUNC00000027,43,+,1245,10430,255;0;0,2,148,147,0,9038,1393,10283,8890,1
22089ref,963,9271,JUNC00000018,4,+,963,9271,255;0;0,2,146,120,0,8188,1109,9151,8042,1
22089ref,1160,6175,JUNC00000025,2,+,1160,6175,255;0;0,2,110,65,0,4950,1270,6110,4840,1
22089ref,6081,9133,JUNC00000083,1,+,6081,9133,255;0;0,2,90,61,0,2991,6171,9072,2901,1
22089ref,2886,5054,JUNC00000056,1,+,2886,5054,255;0;0,2,38,32,0,2136,2924,5022,2098,1
22089ref,218,1138,JUNC00000001,67,+,218,1138,255;0;0,2,150,150,0,770,368,988,620,1
22089ref,2341,3055,JUNC00000044,5,+,2341,3055,255;0;0,2,150,18,0,696,2491,3037,546,1
22089ref,2358,3174,JUNC00000045,11,+,2358,3174,255;0;0,2,143,127,0,689,2501,3047,546,1
22089ref,8332,8903,JUNC00000117,3,-,8332,8903,255;0;0,2,8,26,0,545,8340,8877,537,1
22089ref,8425,9065,JUNC00000122,1,+,8425,9065,255;0;0,2,63,88,0,552,8488,8977,489,1
22089ref,522,1133,JUNC00000002,10,+,522,1133,255;0;0,2,24,118,0,493,546,1015,469,1
22089ref,8691,9275,JUNC00000124,1,-,8691,9275,255;0;0,2,49,102,0,482,8740,9173,433,1
22089ref,4568,5234,JUNC00000072,3,-,4568,5234,255;0;0,2,123,147,0,519,4691,5087,396,1
22089ref,559,1136,JUNC00000006,20,+,559,1136,255;0;0,2,97,121,0,456,656,1015,359,1
22089ref,9495,10029,JUNC00000140,2,+,9495,10029,255;0;0,2,144,36,0,498,9639,9993,354,1
22089ref,4652,5247,JUNC00000073,19,+,4652,5247,255;0;0,2,113,134,0,461,4765,5113,348,1
22089ref,5277,5823,JUNC00000075,3,+,5277,5823,255;0;0,2,141,75,0,471,5418,5748,330,1
22089ref,2226,2796,JUNC00000042,3,+,2226,2796,255;0;0,2,101,144,0,426,2327,2652,325,1
22089ref,6730,7217,JUNC00000086,2,+,6730,7217,255;0;0,2,146,19,0,468,6876,7198,322,1
22089ref,580,1039,JUNC00000005,10,+,580,1039,255;0;0,2,47,104,0,355,627,935,308,1
22089ref,899,1452,JUNC00000015,28,+,899,1452,255;0;0,2,116,144,0,409,1015,1308,293,1
22089ref,2665,3015,JUNC00000052,1,+,2665,3015,255;0;0,2,41,24,0,326,2706,2991,285,1
22089ref,7390,7817,JUNC00000090,1,-,7390,7817,255;0;0,2,19,132,0,295,7409,7685,276,1
22089ref,1127,1546,JUNC00000024,3,-,1127,1546,255;0;0,2,143,8,0,411,1270,1538,268,1
22089ref,9774,10180,JUNC00000141,2,-,9774,10180,255;0;0,2,52,99,0,307,9826,10081,255,1
22089ref,2772,3143,JUNC00000053,1,+,2772,3143,255;0;0,2,58,64,0,307,2830,3079,249,1
22089ref,1628,2002,JUNC00000034,1,+,1628,2002,255;0;0,2,121,30,0,344,1749,1972,223,1
22089ref,8903,9277,JUNC00000125,70,+,8903,9277,255;0;0,2,12,145,0,229,8915,9132,217,1
22089ref,4327,4685,JUNC00000068,1,+,4327,4685,255;0;0,2,51,100,0,258,4378,4585,207,1
22089ref,624,1099,JUNC00000008,56,-,624,1099,255;0;0,2,146,146,0,329,770,953,183,1
22089ref,6744,7219,JUNC00000087,13,-,6744,7219,255;0;0,2,148,147,0,328,6892,7072,180,1
22089ref,8928,9258,JUNC00000127,2,+,8928,9258,255;0;0,2,23,128,0,202,8951,9130,179,1
22089ref,2201,2590,JUNC00000041,2,+,2201,2590,255;0;0,2,126,89,0,300,2327,2501,174,1
22089ref,7552,8015,JUNC00000102,42,+,7552,8015,255;0;0,2,147,142,0,321,7699,7873,174,1
22089ref,7870,8241,JUNC00000110,150,+,7870,8241,255;0;0,2,52,150,0,221,7922,8091,169,1
22089ref,1504,1822,JUNC00000032,2,+,1504,1822,255;0;0,2,61,90,0,228,1565,1732,167,1
22089ref,7694,8002,JUNC00000106,6,+,7694,8002,255;0;0,2,143,8,0,300,7837,7994,157,1
22089ref,7629,7934,JUNC00000104,1,-,7629,7934,255;0;0,2,123,28,0,277,7752,7906,154,1
22089ref,1263,1606,JUNC00000029,16,+,1263,1606,255;0;0,2,148,58,0,285,1411,1548,137,1
22089ref,8368,8662,JUNC00000123,871,+,8368,8662,255;0;0,2,149,8,0,286,8517,8654,137,1
22089ref,4397,4763,JUNC00000071,16,-,4397,4763,255;0;0,2,142,89,0,277,4539,4674,135,1
22089ref,543,820,JUNC00000003,1,+,543,820,255;0;0,2,19,132,0,145,562,688,126,1
22089ref,6757,7031,JUNC00000085,2,+,6757,7031,255;0;0,2,32,119,0,155,6789,6912,123,1
22089ref,10175,10449,JUNC00000143,2,+,10175,10449,255;0;0,2,79,72,0,202,10254,10377,123,1
22089ref,777,1047,JUNC00000012,2,-,777,1047,255;0;0,2,141,10,0,260,918,1037,119,1
22089ref,3165,3434,JUNC00000061,1,+,3165,3434,255;0;0,2,111,40,0,229,3276,3394,118,1
22089ref,4354,4623,JUNC00000070,1,-,4354,4623,255;0;0,2,83,68,0,201,4437,4555,118,1
22089ref,2435,2703,JUNC00000049,1,+,2435,2703,255;0;0,2,143,8,0,260,2578,2695,117,1
22089ref,3199,3419,JUNC00000062,1,+,3199,3419,255;0;0,2,80,25,0,195,3279,3394,115,1
22089ref,3822,4077,JUNC00000063,1,-,3822,4077,255;0;0,2,32,119,0,136,3854,3958,104,1
22089ref,8129,8387,JUNC00000116,12,+,8129,8387,255;0;0,2,129,26,0,232,8258,8361,103,1
22089ref,8953,9212,JUNC00000132,14,+,8953,9212,255;0;0,2,148,8,0,251,9101,9204,103,1
22089ref,615,1009,JUNC00000007,36,+,615,1009,255;0;0,2,149,145,0,249,764,864,100,1
22089ref,1295,1546,JUNC00000030,2,-,1295,1546,255;0;0,2,143,8,0,243,1438,1538,100,1
22089ref,1361,1619,JUNC00000031,605,-,1361,1619,255;0;0,2,150,8,0,250,1511,1611,100,1
22089ref,2432,2683,JUNC00000047,5,-,2432,2683,255;0;0,2,104,47,0,204,2536,2636,100,1
22089ref,2389,2640,JUNC00000046,16,-,2389,2640,255;0;0,2,147,11,0,240,2536,2629,93,1
22089ref,7405,7686,JUNC00000098,10,+,7405,7686,255;0;0,2,149,39,0,242,7554,7647,93,1
22089ref,2394,2781,JUNC00000048,123,-,2394,2781,255;0;0,2,150,145,0,242,2544,2636,92,1
22089ref,8816,9200,JUNC00000128,12,-,8816,9200,255;0;0,2,149,146,0,238,8965,9054,89,1
22089ref,1676,2053,JUNC00000037,26,-,1676,2053,255;0;0,2,150,141,0,236,1826,1912,86,1
22089ref,7259,7568,JUNC00000089,7,-,7259,7568,255;0;0,2,150,74,0,235,7409,7494,85,1
22089ref,4782,5161,JUNC00000074,3,-,4782,5161,255;0;0,2,148,149,0,230,4930,5012,82,1
22089ref,5826,6083,JUNC00000078,16,-,5826,6083,255;0;0,2,146,31,0,226,5972,6052,80,1
22089ref,8932,9246,JUNC00000129,24,+,8932,9246,255;0;0,2,98,146,0,168,9030,9100,70,1
22089ref,1738,1957,JUNC00000035,1,-,1738,1957,255;0;0,2,31,119,0,100,1769,1838,69,1
22089ref,7259,7556,JUNC00000088,7,-,7259,7556,255;0;0,2,150,78,0,219,7409,7478,69,1
22089ref,1705,1959,JUNC00000038,4,+,1705,1959,255;0;0,2,145,41,0,213,1850,1918,68,1
22089ref,8986,9205,JUNC00000133,1,+,8986,9205,255;0;0,2,134,17,0,202,9120,9188,68,1
22089ref,7362,7718,JUNC00000093,293,-,7362,7718,255;0;0,2,149,140,0,216,7511,7578,67,1
22089ref,7348,7705,JUNC00000092,11,+,7348,7705,255;0;0,2,146,145,0,212,7494,7560,66,1
22089ref,2795,3136,JUNC00000055,4,+,2795,3136,255;0;0,2,129,147,0,194,2924,2989,65,1
22089ref,2905,3169,JUNC00000059,4,-,2905,3169,255;0;0,2,51,148,0,116,2956,3021,65,1
22089ref,8283,8598,JUNC00000118,3,+,8283,8598,255;0;0,2,148,102,0,213,8431,8496,65,1
22089ref,8291,8561,JUNC00000119,109,+,8291,8561,255;0;0,2,147,60,0,210,8438,8501,63,1
22089ref,7819,8171,JUNC00000112,17,-,7819,8171,255;0;0,2,145,148,0,204,7964,8023,59,1
22089ref,8344,8631,JUNC00000121,4,+,8344,8631,255;0;0,2,144,85,0,202,8488,8546,58,1
22089ref,956,1304,JUNC00000017,908,-,956,1304,255;0;0,2,145,146,0,202,1101,1158,57,1
22089ref,2894,3101,JUNC00000058,1,-,2894,3101,255;0;0,2,62,89,0,118,2956,3012,56,1
22089ref,825,1171,JUNC00000014,23,+,825,1171,255;0;0,2,144,149,0,197,969,1022,53,1
22089ref,739,1024,JUNC00000009,2,+,739,1024,255;0;0,2,87,146,0,139,826,878,52,1
22089ref,7627,7830,JUNC00000100,1,-,7627,7830,255;0;0,2,22,129,0,74,7649,7701,52,1
22089ref,2554,2639,JUNC00000050,4,+,2554,2639,255;0;0,2,26,10,0,75,2580,2629,49,1
22089ref,6021,6259,JUNC00000082,9,+,6021,6259,255;0;0,2,150,39,0,199,6171,6220,49,1
22089ref,2822,3020,JUNC00000057,1,+,2822,3020,255;0;0,2,120,31,0,167,2942,2989,47,1
22089ref,8932,9234,JUNC00000130,4,-,8932,9234,255;0;0,2,124,131,0,171,9056,9103,47,1
22089ref,7999,8197,JUNC00000113,12,+,7999,8197,255;0;0,2,8,146,0,52,8007,8051,44,1
22089ref,7740,7995,JUNC00000105,10,-,7740,7995,255;0;0,2,66,146,0,109,7806,7849,43,1
22089ref,7699,8040,JUNC00000108,4,-,7699,8040,255;0;0,2,149,149,0,192,7848,7891,43,1
22089ref,9094,9285,JUNC00000137,3,+,9094,9285,255;0;0,2,103,48,0,143,9197,9237,40,1
22089ref,5715,5922,JUNC00000077,21,+,5715,5922,255;0;0,2,21,147,0,60,5736,5775,39,1
22089ref,9484,9672,JUNC00000139,1,+,9484,9672,255;0;0,2,143,8,0,180,9627,9664,37,1
22089ref,2238,2570,JUNC00000043,12,-,2238,2570,255;0;0,2,150,146,0,186,2388,2424,36,1
22089ref,7515,7803,JUNC00000101,12,+,7515,7803,255;0;0,2,145,107,0,181,7660,7696,36,1
22089ref,9008,9316,JUNC00000135,129,-,9008,9316,255;0;0,2,150,122,0,186,9158,9194,36,1
22089ref,978,1250,JUNC00000021,445,-,978,1250,255;0;0,2,150,87,0,185,1128,1163,35,1
22089ref,1944,2031,JUNC00000040,26,+,1944,2031,255;0;0,2,45,9,0,78,1989,2022,33,1
22089ref,729,1058,JUNC00000011,10,+,729,1058,255;0;0,2,149,148,0,181,878,910,32,1
22089ref,975,1280,JUNC00000016,8,-,975,1280,255;0;0,2,126,147,0,158,1101,1133,32,1
22089ref,7292,7474,JUNC00000091,1,+,7292,7474,255;0;0,2,129,21,0,161,7421,7453,32,1
22089ref,7406,7699,JUNC00000097,6,+,7406,7699,255;0;0,2,148,114,0,179,7554,7585,31,1
22089ref,7651,7850,JUNC00000103,18,+,7651,7850,255;0;0,2,90,78,0,121,7741,7772,31,1
22089ref,4226,4413,JUNC00000067,93,-,4226,4413,255;0;0,2,126,31,0,156,4352,4382,30,1
22089ref,6106,6431,JUNC00000084,2,+,6106,6431,255;0;0,2,149,147,0,178,6255,6284,29,1
22089ref,7870,8053,JUNC00000114,6,+,7870,8053,255;0;0,2,145,9,0,174,8015,8044,29,1
22089ref,10021,10247,JUNC00000142,2,+,10021,10247,255;0;0,2,143,55,0,171,10164,10192,28,1
22089ref,3107,3433,JUNC00000060,61,-,3107,3433,255;0;0,2,150,149,0,177,3257,3284,27,1
22089ref,3717,4043,JUNC00000064,70,+,3717,4043,255;0;0,2,150,149,0,177,3867,3894,27,1
22089ref,7703,7884,JUNC00000107,13,-,7703,7884,255;0;0,2,145,9,0,172,7848,7875,27,1
22089ref,1682,1815,JUNC00000036,1,+,1682,1815,255;0;0,2,98,9,0,124,1780,1806,26,1
22089ref,7403,7702,JUNC00000094,6,-,7403,7702,255;0;0,2,127,146,0,153,7530,7556,26,1
22089ref,8435,8612,JUNC00000120,1,-,8435,8612,255;0;0,2,45,106,0,71,8480,8506,26,1
22089ref,974,1219,JUNC00000020,16,+,974,1219,255;0;0,2,148,72,0,173,1122,1147,25,1
22089ref,4244,4568,JUNC00000069,4,+,4244,4568,255;0;0,2,149,150,0,174,4393,4418,25,1
22089ref,5596,5776,JUNC00000076,414,-,5596,5776,255;0;0,2,8,148,0,32,5604,5628,24,1
22089ref,477,649,JUNC00000004,1,-,477,649,255;0;0,2,121,30,0,142,598,619,21,1
22089ref,7421,7593,JUNC00000095,2,+,7421,7593,255;0;0,2,118,33,0,139,7539,7560,21,1
22089ref,7497,7712,JUNC00000096,7,+,7497,7712,255;0;0,2,45,150,0,65,7542,7562,20,1
22089ref,7866,7971,JUNC00000111,1,-,7866,7971,255;0;0,2,76,9,0,96,7942,7962,20,1
22089ref,770,937,JUNC00000010,1,-,770,937,255;0;0,2,90,59,0,108,860,878,18,1
22089ref,2698,3015,JUNC00000054,3,+,2698,3015,255;0;0,2,150,149,0,168,2848,2866,18,1
22089ref,6089,6258,JUNC00000081,2,-,6089,6258,255;0;0,2,37,114,0,55,6126,6144,18,1
22089ref,2520,2682,JUNC00000051,2,+,2520,2682,255;0;0,2,64,83,0,79,2584,2599,15,1
22089ref,8988,9298,JUNC00000134,8,+,8988,9298,255;0;0,2,148,147,0,163,9136,9151,15,1
22089ref,4133,4418,JUNC00000066,17,+,4133,4418,255;0;0,2,124,147,0,138,4257,4271,14,1
22089ref,8957,9123,JUNC00000131,4,+,8957,9123,255;0;0,2,144,8,0,158,9101,9115,14,1
22089ref,1457,1626,JUNC00000033,68,+,1457,1626,255;0;0,2,148,8,0,161,1605,1618,13,1
22089ref,4107,4271,JUNC00000065,1,+,4107,4271,255;0;0,2,67,84,0,80,4174,4187,13,1
22089ref,7891,8052,JUNC00000115,2,+,7891,8052,255;0;0,2,143,8,0,153,8034,8044,10,1
22089ref,9032,9196,JUNC00000136,2,+,9032,9196,255;0;0,2,147,8,0,156,9179,9188,9,1
22089ref,1003,1276,JUNC00000023,1690,-,1003,1276,255;0;0,2,147,118,0,155,1150,1158,8,1
22089ref,822,1126,JUNC00000013,424,+,822,1126,255;0;0,2,147,150,0,154,969,976,7,1
22089ref,7719,7881,JUNC00000109,5,+,7719,7881,255;0;0,2,147,8,0,154,7866,7873,7,1
22089ref,973,1154,JUNC00000019,18,+,973,1154,255;0;0,2,149,26,0,155,1122,1128,6,1
22089ref,1804,2014,JUNC00000039,4,+,1804,2014,255;0;0,2,56,148,0,62,1860,1866,6,1
22089ref,5919,6222,JUNC00000079,10,-,5919,6222,255;0;0,2,147,150,0,153,6066,6072,6,1
22089ref,10242,10424,JUNC00000144,70,+,10242,10424,255;0;0,2,26,150,0,32,10268,10274,6,1
22089ref,1000,1301,JUNC00000022,4,-,1000,1301,255;0;0,2,150,146,0,155,1150,1155,5,1
22089ref,1262,1424,JUNC00000028,4,+,1262,1424,255;0;0,2,149,8,0,154,1411,1416,5,1
22089ref,5955,6235,JUNC00000080,3,+,5955,6235,255;0;0,2,150,125,0,155,6105,6110,5,1
22089ref,7440,7650,JUNC00000099,6,-,7440,7650,255;0;0,2,133,72,0,138,7573,7578,5,1
22089ref,8775,9078,JUNC00000126,31121,+,8775,9078,255;0;0,2,148,150,0,153,8923,8928,5,1
22089ref,9480,9643,JUNC00000138,2,+,9480,9643,255;0;0,2,147,11,0,152,9627,9632,5,1
22864ref2,686,9551,JUNC00000031,8,-,686,9551,255;0;0,2,147,150,0,8715,833,9401,8568,1
22864ref2,697,9561,JUNC00000032,64,+,697,9561,255;0;0,2,146,150,0,8714,843,9411,8568,1
22864ref2,1062,9300,JUNC00000054,8,+,1062,9300,255;0;0,2,148,146,0,8092,1210,9154,7944,1
22864ref2,925,8878,JUNC00000041,8,+,925,8878,255;0;0,2,44,149,0,7804,969,8729,7760,1
22864ref2,3046,10042,JUNC00000125,443,+,3046,10042,255;0;0,2,150,147,0,6849,3196,9895,6699,1
22864ref2,3926,9362,JUNC00000138,17,+,3926,9362,255;0;0,2,42,125,0,5311,3968,9237,5269,1
22864ref2,3831,9253,JUNC00000139,4,+,3831,9253,255;0;0,2,144,9,0,5413,3975,9244,5269,1
22864ref2,1884,7281,JUNC00000072,97,+,1884,7281,255;0;0,2,150,147,0,5250,2034,7134,5100,1
22864ref2,2794,7971,JUNC00000114,341,+,2794,7971,255;0;0,2,125,49,0,5128,2919,7922,5003,1
22864ref2,1723,6754,JUNC00000070,46,+,1723,6754,255;0;0,2,149,150,0,4881,1872,6604,4732,1
22864ref2,4474,9119,JUNC00000174,14,+,4474,9119,255;0;0,2,92,142,0,4503,4566,8977,4411,1
22864ref2,4572,9147,JUNC00000176,33,+,4572,9147,255;0;0,2,93,150,0,4425,4665,8997,4332,1
22864ref2,5005,8795,JUNC00000192,32,+,5005,8795,255;0;0,2,149,146,0,3644,5154,8649,3495,1
22864ref2,4460,7572,JUNC00000168,34,-,4460,7572,255;0;0,2,26,149,0,2963,4486,7423,2937,1
22864ref2,6099,8970,JUNC00000229,8,+,6099,8970,255;0;0,2,148,150,0,2721,6247,8820,2573,1
22864ref2,7701,10005,JUNC00000296,26,-,7701,10005,255;0;0,2,75,55,0,2249,7776,9950,2174,1
22864ref2,2150,3982,JUNC00000078,24,-,2150,3982,255;0;0,2,146,53,0,1779,2296,3929,1633,1
22864ref2,4531,6351,JUNC00000177,14,+,4531,6351,255;0;0,2,150,148,0,1672,4681,6203,1522,1
22864ref2,4566,6346,JUNC00000178,11,+,4566,6346,255;0;0,2,147,148,0,1632,4713,6198,1485,1
22864ref2,6150,7811,JUNC00000230,7,+,6150,7811,255;0;0,2,99,150,0,1511,6249,7661,1412,1
22864ref2,7053,8507,JUNC00000258,209,+,7053,8507,255;0;0,2,36,146,0,1308,7089,8361,1272,1
22864ref2,2507,4040,JUNC00000103,6,-,2507,4040,255;0;0,2,148,146,0,1387,2655,3894,1239,1
22864ref2,871,2180,JUNC00000045,68,+,871,2180,255;0;0,2,144,146,0,1163,1015,2034,1019,1
22864ref2,620,1748,JUNC00000013,8,-,620,1748,255;0;0,2,44,148,0,980,664,1600,936,1
22864ref2,1463,2633,JUNC00000062,67,+,1463,2633,255;0;0,2,102,145,0,1025,1565,2488,923,1
22864ref2,530,1708,JUNC00000015,320,+,530,1708,255;0;0,2,144,145,0,1033,674,1563,889,1
22864ref2,6809,7762,JUNC00000255,9,+,6809,7762,255;0;0,2,145,63,0,890,6954,7699,745,1
22864ref2,4078,4914,JUNC00000147,226,+,4078,4914,255;0;0,2,104,149,0,687,4182,4765,583,1
22864ref2,6651,7405,JUNC00000247,15,+,6651,7405,255;0;0,2,144,148,0,606,6795,7257,462,1
22864ref2,6956,7700,JUNC00000259,7,-,6956,7700,255;0;0,2,145,149,0,595,7101,7551,450,1
22864ref2,6985,7710,JUNC00000261,18,+,6985,7710,255;0;0,2,125,150,0,575,7110,7560,450,1
22864ref2,6903,7534,JUNC00000257,23,+,6903,7534,255;0;0,2,147,149,0,482,7050,7385,335,1
22864ref2,8479,9111,JUNC00000321,7,+,8479,9111,255;0;0,2,149,150,0,482,8628,8961,333,1
22864ref2,7383,7999,JUNC00000282,2,-,7383,7999,255;0;0,2,147,150,0,466,7530,7849,319,1
22864ref2,7407,8013,JUNC00000283,78,+,7407,8013,255;0;0,2,147,140,0,466,7554,7873,319,1
22864ref2,3947,4561,JUNC00000144,5,-,3947,4561,255;0;0,2,150,149,0,465,4097,4412,315,1
22864ref2,1543,1975,JUNC00000061,1,+,1543,1975,255;0;0,2,22,129,0,303,1565,1846,281,1
22864ref2,7332,7832,JUNC00000273,13,-,7332,7832,255;0;0,2,77,147,0,353,7409,7685,276,1
22864ref2,4184,4606,JUNC00000148,70,+,4184,4606,255;0;0,2,20,150,0,272,4204,4456,252,1
22864ref2,9806,10302,JUNC00000347,5,+,9806,10302,255;0;0,2,97,147,0,349,9903,10155,252,1
22864ref2,2716,3203,JUNC00000111,4,+,2716,3203,255;0;0,2,114,124,0,363,2830,3079,249,1
22864ref2,4715,5236,JUNC00000182,17,-,4715,5236,255;0;0,2,148,149,0,372,4863,5087,224,1
22864ref2,9895,10365,JUNC00000352,92,+,9895,10365,255;0;0,2,98,150,0,320,9993,10215,222,1
22864ref2,6313,6709,JUNC00000233,4,-,6313,6709,255;0;0,2,26,149,0,247,6339,6560,221,1
22864ref2,8905,9277,JUNC00000326,73,+,8905,9277,255;0;0,2,10,145,0,227,8915,9132,217,1
22864ref2,6812,7193,JUNC00000251,27,+,6812,7193,255;0;0,2,19,150,0,231,6831,7043,212,1
22864ref2,7906,8270,JUNC00000309,431,-,7906,8270,255;0;0,2,10,145,0,219,7916,8125,209,1
22864ref2,4228,4730,JUNC00000163,3,+,4228,4730,255;0;0,2,150,145,0,357,4378,4585,207,1
22864ref2,6596,7052,JUNC00000243,22,+,6596,7052,255;0;0,2,106,149,0,307,6702,6903,201,1
22864ref2,6249,6632,JUNC00000231,63,+,6249,6632,255;0;0,2,56,148,0,235,6305,6484,179,1
22864ref2,8560,9033,JUNC00000322,23,+,8560,9033,255;0;0,2,148,148,0,325,8708,8885,177,1
22864ref2,7464,7833,JUNC00000280,10,-,7464,7833,255;0;0,2,47,148,0,221,7511,7685,174,1
22864ref2,7553,8019,JUNC00000291,30,+,7553,8019,255;0;0,2,146,146,0,320,7699,7873,174,1
22864ref2,8430,8704,JUNC00000316,1,+,8430,8704,255;0;0,2,8,98,0,176,8438,8606,168,1
22864ref2,8767,8986,JUNC00000323,1,+,8767,8986,255;0;0,2,8,46,0,173,8775,8940,165,1
22864ref2,2887,3340,JUNC00000117,38,+,2887,3340,255;0;0,2,146,144,0,309,3033,3196,163,1
22864ref2,585,1040,JUNC00000020,32,+,585,1040,255;0;0,2,147,150,0,305,732,890,158,1
22864ref2,5584,6041,JUNC00000204,37,+,5584,6041,255;0;0,2,149,150,0,307,5733,5891,158,1
22864ref2,2253,2647,JUNC00000079,35,+,2253,2647,255;0;0,2,88,150,0,244,2341,2497,156,1
22864ref2,684,1012,JUNC00000018,12,+,684,1012,255;0;0,2,26,148,0,180,710,864,154,1
22864ref2,568,1020,JUNC00000019,149,+,568,1020,255;0;0,2,149,149,0,303,717,871,154,1
22864ref2,7698,8035,JUNC00000292,24,+,7698,8035,255;0;0,2,33,150,0,187,7731,7885,154,1
22864ref2,7700,8056,JUNC00000294,45,-,7700,8056,255;0;0,2,52,150,0,206,7752,7906,154,1
22864ref2,7259,7707,JUNC00000272,69,-,7259,7707,255;0;0,2,150,147,0,301,7409,7560,151,1
22864ref2,8293,8611,JUNC00000317,28,+,8293,8611,255;0;0,2,148,26,0,292,8441,8585,144,1
22864ref2,2578,2988,JUNC00000105,17,+,2578,2988,255;0;0,2,119,148,0,262,2697,2840,143,1
22864ref2,3802,4238,JUNC00000135,143,+,3802,4238,255;0;0,2,144,150,0,286,3946,4088,142,1
22864ref2,8367,8803,JUNC00000319,391,+,8367,8803,255;0;0,2,150,149,0,287,8517,8654,137,1
22864ref2,9643,9972,JUNC00000339,32,-,9643,9972,255;0;0,2,45,148,0,181,9688,9824,136,1
22864ref2,4407,4815,JUNC00000172,17,-,4407,4815,255;0;0,2,132,141,0,267,4539,4674,135,1
22864ref2,4395,4763,JUNC00000173,22,-,4395,4763,255;0;0,2,149,84,0,284,4544,4679,135,1
22864ref2,7287,7717,JUNC00000276,5,+,7287,7717,255;0;0,2,149,149,0,281,7436,7568,132,1
22864ref2,7280,7710,JUNC00000275,5,-,7280,7710,255;0;0,2,149,150,0,280,7429,7560,131,1
22864ref2,420,848,JUNC00000004,90,+,420,848,255;0;0,2,149,150,0,278,569,698,129,1
22864ref2,588,898,JUNC00000010,50,+,588,898,255;0;0,2,39,146,0,164,627,752,125,1
22864ref2,597,1016,JUNC00000023,3,-,597,1016,255;0;0,2,147,150,0,269,744,866,122,1
22864ref2,621,1041,JUNC00000026,16,+,621,1041,255;0;0,2,149,149,0,271,770,892,122,1
22864ref2,2343,2763,JUNC00000088,17,+,2343,2763,255;0;0,2,150,150,0,270,2493,2613,120,1
22864ref2,9859,10146,JUNC00000346,82,-,9859,10146,255;0;0,2,23,145,0,142,9882,10001,119,1
22864ref2,4407,4702,JUNC00000167,28,-,4407,4702,255;0;0,2,30,147,0,148,4437,4555,118,1
22864ref2,2343,2755,JUNC00000087,7,+,2343,2755,255;0;0,2,150,149,0,263,2493,2606,113,1
22864ref2,4150,4562,JUNC00000156,13,-,4150,4562,255;0;0,2,150,150,0,262,4300,4412,112,1
22864ref2,4182,4570,JUNC00000158,54,+,4182,4570,255;0;0,2,141,135,0,253,4323,4435,112,1
22864ref2,5226,5589,JUNC00000195,23,+,5226,5589,255;0;0,2,150,101,0,262,5376,5488,112,1
22864ref2,610,1016,JUNC00000024,3,-,610,1016,255;0;0,2,147,150,0,256,757,866,109,1
22864ref2,652,915,JUNC00000027,3,+,652,915,255;0;0,2,131,23,0,240,783,892,109,1
22864ref2,2539,2842,JUNC00000095,32,+,2539,2842,255;0;0,2,45,150,0,153,2584,2692,108,1
22864ref2,2441,2844,JUNC00000097,21,+,2441,2844,255;0;0,2,148,147,0,256,2589,2697,108,1
22864ref2,7709,8109,JUNC00000304,53,-,7709,8109,255;0;0,2,148,147,0,253,7857,7962,105,1
22864ref2,7896,8293,JUNC00000312,25,+,7896,8293,255;0;0,2,144,150,0,247,8040,8143,103,1
22864ref2,7800,8189,JUNC00000310,12,+,7800,8189,255;0;0,2,142,145,0,244,7942,8044,102,1
22864ref2,5782,6034,JUNC00000217,1,+,5782,6034,255;0;0,2,129,22,0,230,5911,6012,101,1
22864ref2,1433,1611,JUNC00000060,38,+,1433,1611,255;0;0,2,32,46,0,132,1465,1565,100,1
22864ref2,5609,6006,JUNC00000206,7,+,5609,6006,255;0;0,2,148,149,0,248,5757,5857,100,1
22864ref2,6578,6972,JUNC00000244,11,-,6578,6972,255;0;0,2,147,148,0,246,6725,6824,99,1
22864ref2,7466,7716,JUNC00000277,1,-,7466,7716,255;0;0,2,41,110,0,140,7507,7606,99,1
22864ref2,2478,2776,JUNC00000089,7,+,2478,2776,255;0;0,2,53,147,0,151,2531,2629,98,1
22864ref2,2631,2892,JUNC00000102,21,-,2631,2892,255;0;0,2,24,149,0,112,2655,2743,88,1
22864ref2,389,771,JUNC00000003,14,+,389,771,255;0;0,2,147,149,0,233,536,622,86,1
22864ref2,1729,2058,JUNC00000068,73,-,1729,2058,255;0;0,2,97,146,0,183,1826,1912,86,1
22864ref2,544,823,JUNC00000007,164,+,544,823,255;0;0,2,45,149,0,130,589,674,85,1
22864ref2,7779,8035,JUNC00000297,16,+,7779,8035,255;0;0,2,21,150,0,106,7800,7885,85,1
22864ref2,7741,8036,JUNC00000299,102,-,7741,8036,255;0;0,2,65,145,0,150,7806,7891,85,1
22864ref2,6479,6861,JUNC00000241,4,+,6479,6861,255;0;0,2,150,150,0,232,6629,6711,82,1
22864ref2,6599,6951,JUNC00000245,4,+,6599,6951,255;0;0,2,150,120,0,232,6749,6831,82,1
22864ref2,8790,9144,JUNC00000325,2,+,8790,9144,255;0;0,2,125,147,0,207,8915,8997,82,1
22864ref2,2612,2895,JUNC00000104,177,+,2612,2895,255;0;0,2,58,144,0,139,2670,2751,81,1
22864ref2,4848,5127,JUNC00000183,81,-,4848,5127,255;0;0,2,48,150,0,129,4896,4977,81,1
22864ref2,5633,6006,JUNC00000208,11,-,5633,6006,255;0;0,2,143,149,0,224,5776,5857,81,1
22864ref2,6345,6671,JUNC00000234,10,+,6345,6671,255;0;0,2,99,146,0,180,6444,6525,81,1
22864ref2,6357,6685,JUNC00000235,13,-,6357,6685,255;0;0,2,98,149,0,179,6455,6536,81,1
22864ref2,5653,6028,JUNC00000209,4,+,5653,6028,255;0;0,2,147,149,0,226,5800,5879,79,1
22864ref2,6745,7119,JUNC00000253,107,-,6745,7119,255;0;0,2,147,148,0,226,6892,6971,79,1
22864ref2,867,1237,JUNC00000044,70,+,867,1237,255;0;0,2,148,145,0,225,1015,1092,77,1
22864ref2,5001,5376,JUNC00000191,10,+,5001,5376,255;0;0,2,150,148,0,227,5151,5228,77,1
22864ref2,4885,5143,JUNC00000188,4,+,4885,5143,255;0;0,2,147,36,0,222,5032,5107,75,1
22864ref2,9792,10036,JUNC00000344,7,+,9792,10036,255;0;0,2,20,149,0,95,9812,9887,75,1
22864ref2,4635,5008,JUNC00000180,34,+,4635,5008,255;0;0,2,149,150,0,223,4784,4858,74,1
22864ref2,8832,9055,JUNC00000324,1,+,8832,9055,255;0;0,2,9,142,0,81,8841,8913,72,1
22864ref2,9080,9303,JUNC00000333,3,+,9080,9303,255;0;0,2,142,9,0,214,9222,9294,72,1
22864ref2,4531,4753,JUNC00000171,7,-,4531,4753,255;0;0,2,8,143,0,79,4539,4610,71,1
22864ref2,437,805,JUNC00000006,8,-,437,805,255;0;0,2,149,149,0,219,586,656,70,1
22864ref2,7259,7626,JUNC00000271,37,-,7259,7626,255;0;0,2,150,148,0,219,7409,7478,69,1
22864ref2,7361,7728,JUNC00000279,165,-,7361,7728,255;0;0,2,150,150,0,217,7511,7578,67,1
22864ref2,2891,3251,JUNC00000119,75,+,2891,3251,255;0;0,2,149,145,0,215,3040,3106,66,1
22864ref2,6812,7041,JUNC00000250,6,+,6812,7041,255;0;0,2,14,149,0,80,6826,6892,66,1
22864ref2,2801,3160,JUNC00000115,105,-,2801,3160,255;0;0,2,148,146,0,213,2949,3014,65,1
22864ref2,4079,4387,JUNC00000146,137,+,4079,4387,255;0;0,2,95,150,0,158,4174,4237,63,1
22864ref2,6968,7331,JUNC00000263,70,-,6968,7331,255;0;0,2,150,150,0,213,7118,7181,63,1
22864ref2,5263,5475,JUNC00000194,1,+,5263,5475,255;0;0,2,80,71,0,141,5343,5404,61,1
22864ref2,4407,4647,JUNC00000166,37,-,4407,4647,255;0;0,2,30,150,0,90,4437,4497,60,1
22864ref2,3085,3318,JUNC00000121,11,-,3085,3318,255;0;0,2,26,149,0,84,3111,3169,58,1
22864ref2,4200,4558,JUNC00000159,8,-,4200,4558,255;0;0,2,150,150,0,208,4350,4408,58,1
22864ref2,4210,4564,JUNC00000161,18,+,4210,4564,255;0;0,2,146,150,0,204,4356,4414,58,1
22864ref2,4356,4698,JUNC00000169,30,-,4356,4698,255;0;0,2,141,143,0,199,4497,4555,58,1
22864ref2,7552,7785,JUNC00000290,43,+,7552,7785,255;0;0,2,147,28,0,205,7699,7757,58,1
22864ref2,9033,9245,JUNC00000332,12,+,9033,9245,255;0;0,2,146,8,0,204,9179,9237,58,1
22864ref2,955,1307,JUNC00000047,998,-,955,1307,255;0;0,2,146,149,0,203,1101,1158,57,1
22864ref2,3879,4111,JUNC00000132,35,+,3879,4111,255;0;0,2,25,150,0,82,3904,3961,57,1
22864ref2,618,878,JUNC00000014,41,+,618,878,255;0;0,2,56,148,0,112,674,730,56,1
22864ref2,9745,9833,JUNC00000341,3,-,9745,9833,255;0;0,2,23,9,0,79,9768,9824,56,1
22864ref2,9759,10113,JUNC00000348,4,-,9759,10113,255;0;0,2,149,150,0,204,9908,9963,55,1
22864ref2,7700,7956,JUNC00000293,44,-,7700,7956,255;0;0,2,52,150,0,106,7752,7806,54,1
22864ref2,826,1171,JUNC00000040,27,+,826,1171,255;0;0,2,143,149,0,196,969,1022,53,1
22864ref2,1680,2030,JUNC00000069,13,+,1680,2030,255;0;0,2,149,148,0,202,1829,1882,53,1
22864ref2,4249,4460,JUNC00000154,37,+,4249,4460,255;0;0,2,8,150,0,61,4257,4310,53,1
22864ref2,5336,5563,JUNC00000197,2,+,5336,5563,255;0;0,2,82,92,0,135,5418,5471,53,1
22864ref2,5549,5893,JUNC00000202,7,-,5549,5893,255;0;0,2,146,145,0,199,5695,5748,53,1
22864ref2,5613,5963,JUNC00000207,13,+,5613,5963,255;0;0,2,150,148,0,202,5763,5815,52,1
22864ref2,5654,6002,JUNC00000210,8,+,5654,6002,255;0;0,2,149,148,0,200,5803,5854,51,1
22864ref2,9669,9895,JUNC00000340,92,+,9669,9895,255;0;0,2,25,150,0,76,9694,9745,51,1
22864ref2,9962,10302,JUNC00000353,6,-,9962,10302,255;0;0,2,144,145,0,195,10106,10157,51,1
22864ref2,3925,4271,JUNC00000142,876,+,3925,4271,255;0;0,2,150,146,0,200,4075,4125,50,1
22864ref2,6187,6531,JUNC00000232,5,-,6187,6531,255;0;0,2,146,148,0,196,6333,6383,50,1
22864ref2,7723,8065,JUNC00000306,42,-,7723,8065,255;0;0,2,143,149,0,193,7866,7916,50,1
22864ref2,2433,2776,JUNC00000094,10,+,2433,2776,255;0;0,2,147,147,0,196,2580,2629,49,1
22864ref2,6357,6700,JUNC00000237,11,+,6357,6700,255;0;0,2,145,149,0,194,6502,6551,49,1
22864ref2,656,957,JUNC00000025,64,+,656,957,255;0;0,2,108,145,0,156,764,812,48,1
22864ref2,6649,6887,JUNC00000242,28,-,6649,6887,255;0;0,2,45,145,0,93,6694,6742,48,1
22864ref2,9932,10138,JUNC00000349,3,+,9932,10138,255;0;0,2,8,150,0,56,9940,9988,48,1
22864ref2,2505,2753,JUNC00000092,5,+,2505,2753,255;0;0,2,51,150,0,98,2556,2603,47,1
22864ref2,9151,9340,JUNC00000334,2,+,9151,9340,255;0;0,2,116,26,0,163,9267,9314,47,1
22864ref2,9512,9850,JUNC00000337,50,-,9512,9850,255;0;0,2,143,148,0,190,9655,9702,47,1
22864ref2,3735,3980,JUNC00000129,156,+,3735,3980,255;0;0,2,51,149,0,96,3786,3831,45,1
22864ref2,5657,5895,JUNC00000203,34,+,5657,5895,255;0;0,2,46,147,0,91,5703,5748,45,1
22864ref2,6381,6717,JUNC00000238,4,-,6381,6717,255;0;0,2,147,144,0,192,6528,6573,45,1
22864ref2,7385,7581,JUNC00000278,1,-,7385,7581,255;0;0,2,126,25,0,171,7511,7556,45,1
22864ref2,795,1135,JUNC00000037,4,+,795,1135,255;0;0,2,148,150,0,190,943,985,42,1
22864ref2,599,935,JUNC00000022,20,-,599,935,255;0;0,2,145,150,0,186,744,785,41,1
22864ref2,7151,7384,JUNC00000270,30,-,7151,7384,255;0;0,2,150,42,0,191,7301,7342,41,1
22864ref2,7614,7949,JUNC00000295,85,+,7614,7949,255;0;0,2,146,148,0,187,7760,7801,41,1
22864ref2,871,1200,JUNC00000043,30,+,871,1200,255;0;0,2,144,145,0,184,1015,1055,40,1
22864ref2,2566,2776,JUNC00000096,7,+,2566,2776,255;0;0,2,23,147,0,63,2589,2629,40,1
22864ref2,3923,4134,JUNC00000134,2,+,3923,4134,255;0;0,2,23,148,0,63,3946,3986,40,1
22864ref2,5805,6141,JUNC00000220,8,-,5805,6141,255;0;0,2,148,148,0,188,5953,5993,40,1
22864ref2,5824,6161,JUNC00000221,179,-,5824,6161,255;0;0,2,150,147,0,190,5974,6014,40,1
22864ref2,3785,4121,JUNC00000133,11,+,3785,4121,255;0;0,2,150,147,0,189,3935,3974,39,1
22864ref2,5589,5924,JUNC00000205,26,+,5589,5924,255;0;0,2,147,149,0,186,5736,5775,39,1
22864ref2,5797,6130,JUNC00000219,19,+,5797,6130,255;0;0,2,146,148,0,185,5943,5982,39,1
22864ref2,674,982,JUNC00000028,107,+,674,982,255;0;0,2,121,150,0,158,795,832,37,1
22864ref2,2147,2466,JUNC00000077,18,+,2147,2466,255;0;0,2,134,149,0,170,2281,2317,36,1
22864ref2,7515,7820,JUNC00000286,8,+,7515,7820,255;0;0,2,145,124,0,181,7660,7696,36,1
22864ref2,2449,2781,JUNC00000100,281,-,2449,2781,255;0;0,2,149,148,0,184,2598,2633,35,1
22864ref2,4027,4241,JUNC00000141,62,-,4027,4241,255;0;0,2,29,150,0,64,4056,4091,35,1
22864ref2,2658,2989,JUNC00000108,46,+,2658,2989,255;0;0,2,148,149,0,182,2806,2840,34,1
22864ref2,5956,6174,JUNC00000223,21,+,5956,6174,255;0;0,2,149,35,0,183,6105,6139,34,1
22864ref2,437,769,JUNC00000005,35,-,437,769,255;0;0,2,149,150,0,182,586,619,33,1
22864ref2,949,1277,JUNC00000046,135,+,949,1277,255;0;0,2,146,149,0,179,1095,1128,33,1
22864ref2,2808,3139,JUNC00000116,11,+,2808,3139,255;0;0,2,148,150,0,181,2956,2989,33,1
22864ref2,4103,4430,JUNC00000152,9,-,4103,4430,255;0;0,2,145,149,0,178,4248,4281,33,1
22864ref2,5502,5782,JUNC00000199,42,-,5502,5782,255;0;0,2,98,149,0,131,5600,5633,33,1
22864ref2,8403,8590,JUNC00000320,2,+,8403,8590,255;0;0,2,119,35,0,152,8522,8555,33,1
22864ref2,465,667,JUNC00000009,3,+,465,667,255;0;0,2,148,22,0,180,613,645,32,1
22864ref2,728,1058,JUNC00000034,26,+,728,1058,255;0;0,2,150,148,0,182,878,910,32,1
22864ref2,2287,2611,JUNC00000084,5,-,2287,2611,255;0;0,2,146,147,0,177,2433,2464,31,1
22864ref2,2521,2727,JUNC00000091,112,+,2521,2727,255;0;0,2,26,149,0,57,2547,2578,31,1
22864ref2,3101,3328,JUNC00000123,13,+,3101,3328,255;0;0,2,46,150,0,77,3147,3178,31,1
22864ref2,4816,5142,JUNC00000186,16,+,4816,5142,255;0;0,2,147,148,0,178,4963,4994,31,1
22864ref2,4309,4531,JUNC00000160,53,-,4309,4531,255;0;0,2,43,149,0,73,4352,4382,30,1
22864ref2,4225,4430,JUNC00000162,42,+,4225,4430,255;0;0,2,150,25,0,180,4375,4405,30,1
22864ref2,5696,6023,JUNC00000211,4,+,5696,6023,255;0;0,2,148,149,0,178,5844,5874,30,1
22864ref2,9717,10045,JUNC00000345,3,-,9717,10045,255;0;0,2,149,149,0,179,9866,9896,30,1
22864ref2,8282,8607,JUNC00000315,13,+,8282,8607,255;0;0,2,147,149,0,176,8429,8458,29,1
22864ref2,3841,4167,JUNC00000140,12,-,3841,4167,255;0;0,2,149,149,0,177,3990,4018,28,1
22864ref2,4232,4557,JUNC00000164,25,+,4232,4557,255;0;0,2,148,149,0,176,4380,4408,28,1
22864ref2,5182,5507,JUNC00000193,11,+,5182,5507,255;0;0,2,148,149,0,176,5330,5358,28,1
22864ref2,685,1009,JUNC00000030,5,-,685,1009,255;0;0,2,148,149,0,175,833,860,27,1
22864ref2,1236,1557,JUNC00000056,2,+,1236,1557,255;0;0,2,145,149,0,172,1381,1408,27,1
22864ref2,2624,2946,JUNC00000106,47,+,2624,2946,255;0;0,2,147,148,0,174,2771,2798,27,1
22864ref2,3205,3434,JUNC00000126,80,-,3205,3434,255;0;0,2,52,150,0,79,3257,3284,27,1
22864ref2,3842,4043,JUNC00000131,59,+,3842,4043,255;0;0,2,25,149,0,52,3867,3894,27,1
22864ref2,7702,7902,JUNC00000301,27,-,7702,7902,255;0;0,2,146,27,0,173,7848,7875,27,1
22864ref2,2341,2561,JUNC00000081,14,-,2341,2561,255;0;0,2,44,150,0,70,2385,2411,26,1
22864ref2,4091,4313,JUNC00000151,18,-,4091,4313,255;0;0,2,148,48,0,174,4239,4265,26,1
22864ref2,4380,4705,JUNC00000170,6,+,4380,4705,255;0;0,2,149,150,0,175,4529,4555,26,1
22864ref2,7169,7436,JUNC00000265,43,-,7169,7436,255;0;0,2,92,149,0,118,7261,7287,26,1
22864ref2,7383,7577,JUNC00000281,3,-,7383,7577,255;0;0,2,147,21,0,173,7530,7556,26,1
22864ref2,530,851,JUNC00000016,344,+,530,851,255;0;0,2,146,150,0,171,676,701,25,1
22864ref2,697,1020,JUNC00000033,33,+,697,1020,255;0;0,2,149,149,0,174,846,871,25,1
22864ref2,1978,2299,JUNC00000075,24,-,1978,2299,255;0;0,2,147,149,0,172,2125,2150,25,1
22864ref2,3022,3224,JUNC00000124,134,+,3022,3224,255;0;0,2,149,28,0,174,3171,3196,25,1
22864ref2,6069,6394,JUNC00000228,9,+,6069,6394,255;0;0,2,150,150,0,175,6219,6244,25,1
22864ref2,7526,7847,JUNC00000287,22,+,7526,7847,255;0;0,2,148,148,0,173,7674,7699,25,1
22864ref2,9663,9981,JUNC00000343,10,+,9663,9981,255;0;0,2,149,144,0,174,9812,9837,25,1
22864ref2,3749,3983,JUNC00000130,258,-,3749,3983,255;0;0,2,60,150,0,84,3809,3833,24,1
22864ref2,5596,5776,JUNC00000200,140,-,5596,5776,255;0;0,2,8,148,0,32,5604,5628,24,1
22864ref2,7089,7284,JUNC00000260,13,+,7089,7284,255;0;0,2,21,150,0,45,7110,7134,24,1
22864ref2,6966,7148,JUNC00000262,33,-,6966,7148,255;0;0,2,149,9,0,173,7115,7139,24,1
22864ref2,9823,10137,JUNC00000351,67,+,9823,10137,255;0;0,2,147,144,0,170,9970,9993,23,1
22864ref2,759,976,JUNC00000029,45,+,759,976,255;0;0,2,45,150,0,67,804,826,22,1
22864ref2,2525,2714,JUNC00000090,5,+,2525,2714,255;0;0,2,18,149,0,40,2543,2565,22,1
22864ref2,4091,4411,JUNC00000150,7,-,4091,4411,255;0;0,2,148,150,0,170,4239,4261,22,1
22864ref2,6038,6360,JUNC00000224,5,-,6038,6360,255;0;0,2,150,150,0,172,6188,6210,22,1
22864ref2,992,1282,JUNC00000050,2,+,992,1282,255;0;0,2,124,145,0,145,1116,1137,21,1
22864ref2,1159,1456,JUNC00000055,78,-,1159,1456,255;0;0,2,130,146,0,151,1289,1310,21,1
22864ref2,7797,7973,JUNC00000298,104,-,7797,7973,255;0;0,2,9,146,0,30,7806,7827,21,1
22864ref2,2444,2763,JUNC00000098,15,+,2444,2763,255;0;0,2,149,150,0,169,2593,2613,20,1
22864ref2,5001,5320,JUNC00000190,12,+,5001,5320,255;0;0,2,150,149,0,170,5151,5171,20,1
22864ref2,5574,5633,JUNC00000198,3,-,5574,5633,255;0;0,2,19,20,0,39,5593,5613,20,1
22864ref2,7156,7358,JUNC00000264,30,+,7156,7358,255;0;0,2,34,148,0,54,7190,7210,20,1
22864ref2,7132,7448,JUNC00000267,13,-,7132,7448,255;0;0,2,146,150,0,166,7278,7298,20,1
22864ref2,2240,2556,JUNC00000082,38,+,2240,2556,255;0;0,2,148,149,0,167,2388,2407,19,1
22864ref2,6061,6378,JUNC00000226,8,-,6061,6378,255;0;0,2,148,150,0,167,6209,6228,19,1
22864ref2,7424,7740,JUNC00000285,17,-,7424,7740,255;0;0,2,149,148,0,168,7573,7592,19,1
22864ref2,1913,2226,JUNC00000073,18,+,1913,2226,255;0;0,2,149,146,0,167,2062,2080,18,1
22864ref2,2382,2601,JUNC00000086,6,+,2382,2601,255;0;0,2,54,147,0,72,2436,2454,18,1
22864ref2,2698,3016,JUNC00000112,14,+,2698,3016,255;0;0,2,150,150,0,168,2848,2866,18,1
22864ref2,3847,4133,JUNC00000137,47,+,3847,4133,255;0;0,2,121,147,0,139,3968,3986,18,1
22864ref2,4636,4926,JUNC00000179,103,+,4636,4926,255;0;0,2,129,143,0,147,4765,4783,18,1
22864ref2,966,1281,JUNC00000049,13,+,966,1281,255;0;0,2,150,148,0,167,1116,1133,17,1
22864ref2,2211,2506,JUNC00000080,2,-,2211,2506,255;0;0,2,149,129,0,166,2360,2377,17,1
22864ref2,5244,5561,JUNC00000196,3,+,5244,5561,255;0;0,2,150,150,0,167,5394,5411,17,1
22864ref2,6648,6840,JUNC00000248,60,-,6648,6840,255;0;0,2,150,25,0,167,6798,6815,17,1
22864ref2,6781,6971,JUNC00000249,6,-,6781,6971,255;0;0,2,23,150,0,40,6804,6821,17,1
22864ref2,7684,7870,JUNC00000300,6,+,7684,7870,255;0;0,2,148,21,0,165,7832,7849,17,1
22864ref2,7873,8157,JUNC00000311,113,+,7873,8157,255;0;0,2,117,150,0,134,7990,8007,17,1
22864ref2,7963,8278,JUNC00000314,144,-,7963,8278,255;0;0,2,149,149,0,166,8112,8129,17,1
22864ref2,9520,9829,JUNC00000338,6,+,9520,9829,255;0;0,2,145,147,0,162,9665,9682,17,1
22864ref2,634,825,JUNC00000011,3,-,634,825,255;0;0,2,26,149,0,42,660,676,16,1
22864ref2,620,829,JUNC00000012,8,-,620,829,255;0;0,2,44,149,0,60,664,680,16,1
22864ref2,925,1135,JUNC00000039,10,+,925,1135,255;0;0,2,44,150,0,60,969,985,16,1
22864ref2,1534,1846,JUNC00000064,4,-,1534,1846,255;0;0,2,149,147,0,165,1683,1699,16,1
22864ref2,2449,2763,JUNC00000099,27,+,2449,2763,255;0;0,2,149,150,0,164,2598,2613,15,1
22864ref2,3959,4265,JUNC00000145,118,-,3959,4265,255;0;0,2,148,143,0,163,4107,4122,15,1
22864ref2,9989,10202,JUNC00000354,7,+,9989,10202,255;0;0,2,148,50,0,163,10137,10152,15,1
22864ref2,596,907,JUNC00000021,108,-,596,907,255;0;0,2,148,149,0,162,744,758,14,1
22864ref2,1604,1916,JUNC00000067,41,+,1604,1916,255;0;0,2,150,148,0,164,1754,1768,14,1
22864ref2,2123,2293,JUNC00000076,40,+,2123,2293,255;0;0,2,8,148,0,22,2131,2145,14,1
22864ref2,2942,3177,JUNC00000120,2,+,2942,3177,255;0;0,2,146,75,0,160,3088,3102,14,1
22864ref2,4110,4418,JUNC00000153,68,+,4110,4418,255;0;0,2,147,147,0,161,4257,4271,14,1
22864ref2,4139,4451,JUNC00000155,15,-,4139,4451,255;0;0,2,148,150,0,162,4287,4301,14,1
22864ref2,329,639,JUNC00000002,7,+,329,639,255;0;0,2,148,149,0,161,477,490,13,1
22864ref2,773,1084,JUNC00000035,6,-,773,1084,255;0;0,2,149,149,0,162,922,935,13,1
22864ref2,2805,2990,JUNC00000110,12,+,2805,2990,255;0;0,2,22,150,0,35,2827,2840,13,1
22864ref2,4302,4482,JUNC00000157,22,+,4302,4482,255;0;0,2,21,146,0,34,4323,4336,13,1
22864ref2,7139,7448,JUNC00000269,171,-,7139,7448,255;0;0,2,148,148,0,161,7287,7300,13,1
22864ref2,451,757,JUNC00000008,4,-,451,757,255;0;0,2,147,147,0,159,598,610,12,1
22864ref2,2383,2566,JUNC00000083,12,+,2383,2566,255;0;0,2,23,148,0,35,2406,2418,12,1
22864ref2,2658,2964,JUNC00000107,5,-,2658,2964,255;0;0,2,144,150,0,156,2802,2814,12,1
22864ref2,2676,2981,JUNC00000109,5,-,2676,2981,255;0;0,2,144,149,0,156,2820,2832,12,1
22864ref2,3609,3828,JUNC00000128,104,+,3609,3828,255;0;0,2,57,150,0,69,3666,3678,12,1
22864ref2,4908,5120,JUNC00000185,52,-,4908,5120,255;0;0,2,51,149,0,63,4959,4971,12,1
22864ref2,8987,9295,JUNC00000329,9,+,8987,9295,255;0;0,2,149,147,0,161,9136,9148,12,1
22864ref2,684,871,JUNC00000017,330,+,684,871,255;0;0,2,26,150,0,37,710,721,11,1
22864ref2,1273,1579,JUNC00000058,4,+,1273,1579,255;0;0,2,146,149,0,157,1419,1430,11,1
22864ref2,2062,2268,JUNC00000074,11,+,2062,2268,255;0;0,2,46,149,0,57,2108,2119,11,1
22864ref2,3589,3756,JUNC00000127,5,-,3589,3756,255;0;0,2,8,148,0,19,3597,3608,11,1
22864ref2,4473,4650,JUNC00000175,2,+,4473,4650,255;0;0,2,149,17,0,160,4622,4633,11,1
22864ref2,9457,9765,JUNC00000335,21,-,9457,9765,255;0;0,2,150,147,0,161,9607,9618,11,1
22864ref2,9665,9972,JUNC00000342,36,+,9665,9972,255;0;0,2,147,149,0,158,9812,9823,11,1
22864ref2,831,1041,JUNC00000042,9,+,831,1041,255;0;0,2,147,53,0,157,978,988,10,1
22864ref2,2557,2721,JUNC00000093,37,+,2557,2721,255;0;0,2,8,146,0,18,2565,2575,10,1
22864ref2,4835,4996,JUNC00000181,2,-,4835,4996,255;0;0,2,8,143,0,18,4843,4853,10,1
22864ref2,6905,7097,JUNC00000254,12,-,6905,7097,255;0;0,2,35,147,0,45,6940,6950,10,1
22864ref2,6813,7119,JUNC00000256,6,-,6813,7119,255;0;0,2,148,148,0,158,6961,6971,10,1
22864ref2,7242,7427,JUNC00000266,15,+,7242,7427,255;0;0,2,25,150,0,35,7267,7277,10,1
22864ref2,7711,8017,JUNC00000303,6,+,7711,8017,255;0;0,2,146,150,0,156,7857,7867,10,1
22864ref2,9011,9190,JUNC00000330,5,-,9011,9190,255;0;0,2,147,22,0,157,9158,9168,10,1
22864ref2,304,612,JUNC00000001,72,+,304,612,255;0;0,2,150,149,0,159,454,463,9,1
22864ref2,1241,1543,JUNC00000057,8,-,1241,1543,255;0;0,2,145,148,0,154,1386,1395,9,1
22864ref2,1476,1781,JUNC00000063,67,+,1476,1781,255;0;0,2,148,148,0,157,1624,1633,9,1
22864ref2,4790,5092,JUNC00000184,54,+,4790,5092,255;0;0,2,145,148,0,154,4935,4944,9,1
22864ref2,5847,6032,JUNC00000213,4,-,5847,6032,255;0;0,2,26,150,0,35,5873,5882,9,1
22864ref2,9030,9204,JUNC00000331,17,+,9030,9204,255;0;0,2,149,16,0,158,9179,9188,9,1
22864ref2,1001,1307,JUNC00000053,148,-,1001,1307,255;0;0,2,149,149,0,157,1150,1158,8,1
22864ref2,1603,1909,JUNC00000066,15,+,1603,1909,255;0;0,2,148,150,0,156,1751,1759,8,1
22864ref2,5751,5930,JUNC00000216,59,+,5751,5930,255;0;0,2,150,21,0,158,5901,5909,8,1
22864ref2,5783,6090,JUNC00000218,68,-,5783,6090,255;0;0,2,150,149,0,158,5933,5941,8,1
22864ref2,5864,6166,JUNC00000222,143,+,5864,6166,255;0;0,2,148,146,0,156,6012,6020,8,1
22864ref2,6043,6349,JUNC00000225,22,+,6043,6349,255;0;0,2,149,149,0,157,6192,6200,8,1
22864ref2,6528,6708,JUNC00000239,11,-,6528,6708,255;0;0,2,24,148,0,32,6552,6560,8,1
22864ref2,7875,8071,JUNC00000308,42,+,7875,8071,255;0;0,2,39,149,0,47,7914,7922,8,1
22864ref2,7955,8261,JUNC00000313,42,+,7955,8261,255;0;0,2,149,149,0,157,8104,8112,8,1
22864ref2,823,1126,JUNC00000038,79,+,823,1126,255;0;0,2,146,150,0,153,969,976,7,1
22864ref2,1857,2164,JUNC00000071,40,+,1857,2164,255;0;0,2,150,150,0,157,2007,2014,7,1
22864ref2,2916,3196,JUNC00000118,74,+,2916,3196,255;0;0,2,124,149,0,131,3040,3047,7,1
22864ref2,3127,3162,JUNC00000122,1,-,3127,3162,255;0;0,2,9,19,0,16,3136,3143,7,1
22864ref2,4186,4386,JUNC00000149,21,+,4186,4386,255;0;0,2,44,149,0,51,4230,4237,7,1
22864ref2,5494,5797,JUNC00000201,8,+,5494,5797,255;0;0,2,147,149,0,154,5641,5648,7,1
22864ref2,5725,6032,JUNC00000214,3,-,5725,6032,255;0;0,2,150,150,0,157,5875,5882,7,1
22864ref2,6453,6637,JUNC00000236,20,+,6453,6637,255;0;0,2,31,146,0,38,6484,6491,7,1
22864ref2,7539,7845,JUNC00000289,18,+,7539,7845,255;0;0,2,150,149,0,157,7689,7696,7,1
22864ref2,7710,8013,JUNC00000302,7,+,7710,8013,255;0;0,2,147,149,0,154,7857,7864,7,1
22864ref2,7717,8023,JUNC00000305,17,+,7717,8023,255;0;0,2,149,150,0,156,7866,7873,7,1
22864ref2,795,1097,JUNC00000036,18,+,795,1097,255;0;0,2,148,148,0,154,943,949,6,1
22864ref2,965,1266,JUNC00000048,3,+,965,1266,255;0;0,2,149,146,0,155,1114,1120,6,1
22864ref2,976,1275,JUNC00000051,5,+,976,1275,255;0;0,2,146,147,0,152,1122,1128,6,1
22864ref2,2865,3062,JUNC00000113,5,+,2865,3062,255;0;0,2,41,150,0,47,2906,2912,6,1
22864ref2,3947,4253,JUNC00000143,10,-,3947,4253,255;0;0,2,150,150,0,156,4097,4103,6,1
22864ref2,4236,4414,JUNC00000165,366,-,4236,4414,255;0;0,2,146,26,0,152,4382,4388,6,1
22864ref2,5729,6033,JUNC00000215,24,+,5729,6033,255;0;0,2,149,149,0,155,5878,5884,6,1
22864ref2,6069,6375,JUNC00000227,14,+,6069,6375,255;0;0,2,150,150,0,156,6219,6225,6,1
22864ref2,6405,6710,JUNC00000240,12,-,6405,6710,255;0;0,2,149,150,0,155,6554,6560,6,1
22864ref2,6751,6929,JUNC00000246,6,+,6751,6929,255;0;0,2,22,150,0,28,6773,6779,6,1
22864ref2,7131,7437,JUNC00000268,23,+,7131,7437,255;0;0,2,150,150,0,156,7281,7287,6,1
22864ref2,7281,7585,JUNC00000274,6,-,7281,7585,255;0;0,2,148,150,0,154,7429,7435,6,1
22864ref2,7541,7840,JUNC00000288,12,-,7541,7840,255;0;0,2,144,149,0,150,7685,7691,6,1
22864ref2,8932,9237,JUNC00000328,9,+,8932,9237,255;0;0,2,150,149,0,156,9082,9088,6,1
22864ref2,9936,10108,JUNC00000350,5,-,9936,10108,255;0;0,2,17,149,0,23,9953,9959,6,1
22864ref2,979,1141,JUNC00000052,72,-,979,1141,255;0;0,2,149,8,0,154,1128,1133,5,1
22864ref2,1422,1595,JUNC00000059,25,+,1422,1595,255;0;0,2,21,147,0,26,1443,1448,5,1
22864ref2,1575,1879,JUNC00000065,3,-,1575,1879,255;0;0,2,150,149,0,155,1725,1730,5,1
22864ref2,2286,2589,JUNC00000085,3,+,2286,2589,255;0;0,2,150,148,0,155,2436,2441,5,1
22864ref2,2482,2662,JUNC00000101,70,+,2482,2662,255;0;0,2,149,26,0,154,2631,2636,5,1
22864ref2,3809,4111,JUNC00000136,138,+,3809,4111,255;0;0,2,147,150,0,152,3956,3961,5,1
22864ref2,4854,5159,JUNC00000187,40,+,4854,5159,255;0;0,2,150,150,0,155,5004,5009,5,1
22864ref2,4992,5295,JUNC00000189,2,+,4992,5295,255;0;0,2,150,148,0,155,5142,5147,5,1
22864ref2,5712,6013,JUNC00000212,3,+,5712,6013,255;0;0,2,149,147,0,154,5861,5866,5,1
22864ref2,6830,7030,JUNC00000252,99,+,6830,7030,255;0;0,2,46,149,0,51,6876,6881,5,1
22864ref2,7423,7728,JUNC00000284,23,-,7423,7728,255;0;0,2,150,150,0,155,7573,7578,5,1
22864ref2,7725,8028,JUNC00000307,23,-,7725,8028,255;0;0,2,150,148,0,155,7875,7880,5,1
22864ref2,8299,8604,JUNC00000318,14,+,8299,8604,255;0;0,2,150,150,0,155,8449,8454,5,1
22864ref2,8782,9078,JUNC00000327,3352,+,8782,9078,255;0;0,2,141,150,0,146,8923,8928,5,1
22864ref2,9480,9779,JUNC00000336,27,+,9480,9779,255;0;0,2,147,147,0,152,9627,9632,5,1
20063ref,1858,9598,JUNC00000035,50,+,1858,9598,255;0;0,2,149,150,0,7590,2007,9448,7441,1
20063ref,4948,8878,JUNC00000115,2,+,4948,8878,255;0;0,2,84,142,0,3788,5032,8736,3704,1
20063ref,6237,9798,JUNC00000132,155,-,6237,9798,255;0;0,2,147,143,0,3418,6384,9655,3271,1
20063ref,2875,6187,JUNC00000069,2,+,2875,6187,255;0;0,2,131,36,0,3276,3006,6151,3145,1
20063ref,3925,6482,JUNC00000086,173,+,3925,6482,255;0;0,2,150,136,0,2421,4075,6346,2271,1
20063ref,4996,7047,JUNC00000116,90,+,4996,7047,255;0;0,2,92,144,0,1907,5088,6903,1815,1
20063ref,2657,4662,JUNC00000058,98,+,2657,4662,255;0;0,2,114,143,0,1862,2771,4519,1748,1
20063ref,5790,7431,JUNC00000127,2,+,5790,7431,255;0;0,2,147,49,0,1592,5937,7382,1445,1
20063ref,7189,8037,JUNC00000149,6,+,7189,8037,255;0;0,2,50,149,0,699,7239,7888,649,1
20063ref,7186,8046,JUNC00000150,28,+,7186,8046,255;0;0,2,62,149,0,711,7248,7897,649,1
20063ref,1932,2694,JUNC00000036,3,+,1932,2694,255;0;0,2,147,150,0,612,2079,2544,465,1
20063ref,4103,4815,JUNC00000094,9,-,4103,4815,255;0;0,2,147,148,0,564,4250,4667,417,1
20063ref,6800,7434,JUNC00000141,210,-,6800,7434,255;0;0,2,92,147,0,487,6892,7287,395,1
20063ref,6873,7544,JUNC00000144,396,-,6873,7544,255;0;0,2,132,148,0,523,7005,7396,391,1
20063ref,4531,5199,JUNC00000109,7,+,4531,5199,255;0;0,2,150,149,0,519,4681,5050,369,1
20063ref,4547,5214,JUNC00000110,7,+,4547,5214,255;0;0,2,148,150,0,517,4695,5064,369,1
20063ref,540,1099,JUNC00000006,78,+,540,1099,255;0;0,2,116,84,0,475,656,1015,359,1
20063ref,1197,1790,JUNC00000025,9,+,1197,1790,255;0;0,2,87,149,0,444,1284,1641,357,1
20063ref,3921,4343,JUNC00000081,21,+,3921,4343,255;0;0,2,45,20,0,402,3966,4323,357,1
20063ref,3418,3977,JUNC00000074,156,+,3418,3977,255;0;0,2,150,83,0,476,3568,3894,326,1
20063ref,2177,2797,JUNC00000043,3065,+,2177,2797,255;0;0,2,150,145,0,475,2327,2652,325,1
20063ref,2158,2651,JUNC00000041,17,-,2158,2651,255;0;0,2,33,150,0,343,2191,2501,310,1
20063ref,8698,9142,JUNC00000183,1,-,8698,9142,255;0;0,2,49,102,0,342,8747,9040,293,1
20063ref,6758,7330,JUNC00000142,28,-,6758,7330,255;0;0,2,148,149,0,423,6906,7181,275,1
20063ref,4098,4636,JUNC00000092,11,-,4098,4636,255;0;0,2,148,149,0,389,4246,4487,241,1
20063ref,4715,5235,JUNC00000112,66,-,4715,5235,255;0;0,2,148,148,0,372,4863,5087,224,1
20063ref,2268,2771,JUNC00000046,23,-,2268,2771,255;0;0,2,144,150,0,353,2412,2621,209,1
20063ref,1537,2034,JUNC00000028,4,-,1537,2034,255;0;0,2,149,147,0,350,1686,1887,201,1
20063ref,8895,9231,JUNC00000185,54,+,8895,9231,255;0;0,2,26,148,0,188,8921,9083,162,1
20063ref,962,1414,JUNC00000019,18,+,962,1414,255;0;0,2,147,144,0,308,1109,1270,161,1
20063ref,7699,8038,JUNC00000170,20,+,7699,8038,255;0;0,2,34,150,0,189,7733,7888,155,1
20063ref,4151,4603,JUNC00000097,36,+,4151,4603,255;0;0,2,148,150,0,302,4299,4453,154,1
20063ref,7696,8035,JUNC00000169,26,+,7696,8035,255;0;0,2,35,150,0,189,7731,7885,154,1
20063ref,7726,8056,JUNC00000171,17,-,7726,8056,255;0;0,2,26,150,0,180,7752,7906,154,1
20063ref,2647,2988,JUNC00000056,36,+,2647,2988,255;0;0,2,50,148,0,193,2697,2840,143,1
20063ref,6378,6815,JUNC00000135,3,-,6378,6815,255;0;0,2,150,147,0,290,6528,6668,140,1
20063ref,6486,6822,JUNC00000136,112,+,6486,6822,255;0;0,2,50,146,0,190,6536,6676,140,1
20063ref,4413,4814,JUNC00000107,54,-,4413,4814,255;0;0,2,126,140,0,261,4539,4674,135,1
20063ref,2344,2641,JUNC00000049,22,-,2344,2641,255;0;0,2,149,25,0,272,2493,2616,123,1
20063ref,7084,7270,JUNC00000146,82,-,7084,7270,255;0;0,2,44,20,0,166,7128,7250,122,1
20063ref,596,1013,JUNC00000009,7,-,596,1013,255;0;0,2,148,149,0,268,744,864,120,1
20063ref,231,505,JUNC00000001,30,+,231,505,255;0;0,2,9,150,0,124,240,355,115,1
20063ref,4106,4470,JUNC00000089,14,+,4106,4470,255;0;0,2,100,149,0,215,4206,4321,115,1
20063ref,5957,6369,JUNC00000130,30,+,5957,6369,255;0;0,2,148,149,0,263,6105,6220,115,1
20063ref,7364,7775,JUNC00000155,7,-,7364,7775,255;0;0,2,147,150,0,261,7511,7625,114,1
20063ref,2480,2779,JUNC00000050,16,+,2480,2779,255;0;0,2,51,150,0,149,2531,2629,98,1
20063ref,2914,3144,JUNC00000066,8,+,2914,3144,255;0;0,2,28,112,0,118,2942,3032,90,1
20063ref,1694,2056,JUNC00000032,10,-,1694,2056,255;0;0,2,132,144,0,218,1826,1912,86,1
20063ref,5919,6156,JUNC00000128,9,-,5919,6156,255;0;0,2,53,98,0,139,5972,6058,86,1
20063ref,1602,1880,JUNC00000030,39,-,1602,1880,255;0;0,2,149,47,0,231,1751,1833,82,1
20063ref,3759,4139,JUNC00000078,13,-,3759,4139,255;0;0,2,150,150,0,230,3909,3989,80,1
20063ref,5005,5383,JUNC00000119,370,+,5005,5383,255;0;0,2,149,150,0,228,5154,5233,79,1
20063ref,3979,4246,JUNC00000084,1268,+,3979,4246,255;0;0,2,46,143,0,124,4025,4103,78,1
20063ref,1607,1973,JUNC00000029,104,-,1607,1973,255;0;0,2,144,147,0,219,1751,1826,75,1
20063ref,7920,8293,JUNC00000178,5,+,7920,8293,255;0;0,2,150,148,0,225,8070,8145,75,1
20063ref,3958,4203,JUNC00000083,10,-,3958,4203,255;0;0,2,22,149,0,96,3980,4054,74,1
20063ref,7362,7727,JUNC00000154,106,-,7362,7727,255;0;0,2,149,149,0,216,7511,7578,67,1
20063ref,9829,10133,JUNC00000191,117,+,9829,10133,255;0;0,2,91,147,0,157,9920,9986,66,1
20063ref,4186,4460,JUNC00000093,2,-,4186,4460,255;0;0,2,62,148,0,126,4248,4312,64,1
20063ref,6483,6718,JUNC00000134,3,-,6483,6718,255;0;0,2,22,149,0,86,6505,6569,64,1
20063ref,7491,7728,JUNC00000160,56,+,7491,7728,255;0;0,2,145,29,0,208,7636,7699,63,1
20063ref,1803,2065,JUNC00000033,17,+,1803,2065,255;0;0,2,54,147,0,115,1857,1918,61,1
20063ref,4430,4666,JUNC00000106,299,-,4430,4666,255;0;0,2,67,111,0,125,4497,4555,58,1
20063ref,8364,8571,JUNC00000182,1,+,8364,8571,255;0;0,2,124,25,0,182,8488,8546,58,1
20063ref,9753,10109,JUNC00000190,2691,+,9753,10109,255;0;0,2,150,148,0,208,9903,9961,58,1
20063ref,955,1225,JUNC00000018,1148,-,955,1225,255;0;0,2,146,67,0,203,1101,1158,57,1
20063ref,3741,3982,JUNC00000076,2,+,3741,3982,255;0;0,2,42,144,0,97,3783,3838,55,1
20063ref,825,1172,JUNC00000016,16,+,825,1172,255;0;0,2,144,150,0,197,969,1022,53,1
20063ref,5575,5896,JUNC00000123,26,-,5575,5896,255;0;0,2,120,148,0,173,5695,5748,53,1
20063ref,3617,3963,JUNC00000075,23,-,3617,3963,255;0;0,2,150,144,0,202,3767,3819,52,1
20063ref,9955,10303,JUNC00000192,134,+,9955,10303,255;0;0,2,148,148,0,200,10103,10155,52,1
20063ref,5760,6019,JUNC00000124,19,-,5760,6019,255;0;0,2,60,149,0,110,5820,5870,50,1
20063ref,2545,2777,JUNC00000052,30,+,2545,2777,255;0;0,2,35,148,0,84,2580,2629,49,1
20063ref,4529,4780,JUNC00000108,2,+,4529,4780,255;0;0,2,55,147,0,104,4584,4633,49,1
20063ref,5680,6026,JUNC00000125,3,+,5680,6026,255;0;0,2,150,147,0,199,5830,5879,49,1
20063ref,1105,1443,JUNC00000024,65,+,1105,1443,255;0;0,2,142,148,0,190,1247,1295,48,1
20063ref,2921,3142,JUNC00000067,2,+,2921,3142,255;0;0,2,26,148,0,73,2947,2994,47,1
20063ref,2506,2778,JUNC00000055,85,+,2506,2778,255;0;0,2,146,81,0,191,2652,2697,45,1
20063ref,3734,3980,JUNC00000077,115,+,3734,3980,255;0;0,2,52,149,0,97,3786,3831,45,1
20063ref,1919,2144,JUNC00000034,12,+,1919,2144,255;0;0,2,31,150,0,75,1950,1994,44,1
20063ref,7681,7995,JUNC00000172,33,-,7681,7995,255;0;0,2,125,146,0,168,7806,7849,43,1
20063ref,2417,2758,JUNC00000051,2,-,2417,2758,255;0;0,2,149,150,0,191,2566,2608,42,1
20063ref,7115,7452,JUNC00000151,117,-,7115,7452,255;0;0,2,148,147,0,190,7263,7305,42,1
20063ref,644,850,JUNC00000007,226,+,644,850,255;0;0,2,16,149,0,57,660,701,41,1
20063ref,10018,10358,JUNC00000195,10,+,10018,10358,255;0;0,2,149,150,0,190,10167,10208,41,1
20063ref,2553,2779,JUNC00000053,19,+,2553,2779,255;0;0,2,36,150,0,76,2589,2629,40,1
20063ref,5825,6161,JUNC00000129,157,-,5825,6161,255;0;0,2,149,147,0,189,5974,6014,40,1
20063ref,7515,7816,JUNC00000165,14,+,7515,7816,255;0;0,2,145,117,0,184,7660,7699,39,1
20063ref,10018,10356,JUNC00000194,17,+,10018,10356,255;0;0,2,149,150,0,188,10167,10206,39,1
20063ref,7497,7835,JUNC00000161,9,+,7497,7835,255;0;0,2,150,150,0,188,7647,7685,38,1
20063ref,97,433,JUNC00000002,480,+,97,433,255;0;0,2,149,150,0,186,246,283,37,1
20063ref,1518,1854,JUNC00000027,17,+,1518,1854,255;0;0,2,150,149,0,187,1668,1705,37,1
20063ref,728,942,JUNC00000010,8,-,728,942,255;0;0,2,29,149,0,65,757,793,36,1
20063ref,7518,7747,JUNC00000164,9,+,7518,7747,255;0;0,2,142,51,0,178,7660,7696,36,1
20063ref,2802,3129,JUNC00000068,25,-,2802,3129,255;0;0,2,147,145,0,182,2949,2984,35,1
20063ref,3879,4118,JUNC00000080,10,-,3879,4118,255;0;0,2,56,148,0,91,3935,3970,35,1
20063ref,2659,2939,JUNC00000057,62,-,2659,2939,255;0;0,2,97,150,0,130,2756,2789,33,1
20063ref,952,1283,JUNC00000017,47,-,952,1283,255;0;0,2,149,150,0,181,1101,1133,32,1
20063ref,2290,2620,JUNC00000047,8,+,2290,2620,255;0;0,2,150,149,0,181,2440,2471,31,1
20063ref,4183,4511,JUNC00000098,9,+,4183,4511,255;0;0,2,148,150,0,178,4331,4361,30,1
20063ref,4239,4531,JUNC00000099,69,-,4239,4531,255;0;0,2,113,149,0,143,4352,4382,30,1
20063ref,4225,4456,JUNC00000102,68,+,4225,4456,255;0;0,2,150,51,0,180,4375,4405,30,1
20063ref,7516,7840,JUNC00000163,13,+,7516,7840,255;0;0,2,144,150,0,174,7660,7690,30,1
20063ref,642,844,JUNC00000008,32,+,642,844,255;0;0,2,25,148,0,54,667,696,29,1
20063ref,680,937,JUNC00000011,163,+,680,937,255;0;0,2,84,144,0,113,764,793,29,1
20063ref,2151,2477,JUNC00000042,495,+,2151,2477,255;0;0,2,147,150,0,176,2298,2327,29,1
20063ref,7870,8193,JUNC00000177,95,+,7870,8193,255;0;0,2,145,149,0,174,8015,8044,29,1
20063ref,8176,8354,JUNC00000180,1,+,8176,8354,255;0;0,2,104,46,0,132,8280,8308,28,1
20063ref,449,684,JUNC00000003,209,-,449,684,255;0;0,2,60,148,0,87,509,536,27,1
20063ref,3181,3434,JUNC00000073,38,-,3181,3434,255;0;0,2,76,150,0,103,3257,3284,27,1
20063ref,4225,4549,JUNC00000101,23,+,4225,4549,255;0;0,2,150,147,0,177,4375,4402,27,1
20063ref,4229,4555,JUNC00000104,63,+,4229,4555,255;0;0,2,149,150,0,176,4378,4405,27,1
20063ref,9526,9849,JUNC00000189,45,+,9526,9849,255;0;0,2,147,149,0,174,9673,9700,27,1
20063ref,1728,1948,JUNC00000031,28,+,1728,1948,255;0;0,2,52,142,0,78,1780,1806,26,1
20063ref,3032,3333,JUNC00000070,3,+,3032,3333,255;0;0,2,125,150,0,151,3157,3183,26,1
20063ref,7382,7702,JUNC00000156,10,-,7382,7702,255;0;0,2,148,146,0,174,7530,7556,26,1
20063ref,1977,2299,JUNC00000037,14,-,1977,2299,255;0;0,2,148,149,0,173,2125,2150,25,1
20063ref,3022,3346,JUNC00000071,136,+,3022,3346,255;0;0,2,149,150,0,174,3171,3196,25,1
20063ref,6569,6892,JUNC00000138,219,-,6569,6892,255;0;0,2,148,150,0,173,6717,6742,25,1
20063ref,506,827,JUNC00000005,191,+,506,827,255;0;0,2,150,147,0,174,656,680,24,1
20063ref,2667,2988,JUNC00000061,6,-,2667,2988,255;0;0,2,149,148,0,173,2816,2840,24,1
20063ref,4151,4428,JUNC00000096,37,+,4151,4428,255;0;0,2,148,105,0,172,4299,4323,24,1
20063ref,4225,4547,JUNC00000100,12,+,4225,4547,255;0;0,2,150,148,0,174,4375,4399,24,1
20063ref,4229,4552,JUNC00000103,5,+,4229,4552,255;0;0,2,149,150,0,173,4378,4402,24,1
20063ref,8936,9180,JUNC00000187,10,+,8936,9180,255;0;0,2,77,143,0,101,9013,9037,24,1
20063ref,1978,2298,JUNC00000038,45,+,1978,2298,255;0;0,2,149,148,0,172,2127,2150,23,1
20063ref,4093,4411,JUNC00000091,3,-,4093,4411,255;0;0,2,146,150,0,168,4239,4261,22,1
20063ref,4910,5151,JUNC00000114,20,-,4910,5151,255;0;0,2,70,149,0,92,4980,5002,22,1
20063ref,6676,6886,JUNC00000139,30,+,6676,6886,255;0;0,2,44,144,0,66,6720,6742,22,1
20063ref,4934,5125,JUNC00000113,2,-,4934,5125,255;0;0,2,22,148,0,43,4956,4977,21,1
20063ref,978,1293,JUNC00000022,29,+,978,1293,255;0;0,2,149,146,0,169,1127,1147,20,1
20063ref,4028,4238,JUNC00000085,229,+,4028,4238,255;0;0,2,40,150,0,60,4068,4088,20,1
20063ref,5001,5321,JUNC00000118,21,+,5001,5321,255;0;0,2,150,150,0,170,5151,5171,20,1
20063ref,795,1111,JUNC00000014,9,+,795,1111,255;0;0,2,148,149,0,167,943,962,19,1
20063ref,2240,2556,JUNC00000044,40,+,2240,2556,255;0;0,2,148,149,0,167,2388,2407,19,1
20063ref,3782,4100,JUNC00000079,94,-,3782,4100,255;0;0,2,150,150,0,168,3932,3950,18,1
20063ref,3944,4134,JUNC00000082,12,+,3944,4134,255;0;0,2,24,148,0,42,3968,3986,18,1
20063ref,4210,4406,JUNC00000090,11,-,4210,4406,255;0;0,2,29,149,0,47,4239,4257,18,1
20063ref,967,1283,JUNC00000020,12,+,967,1283,255;0;0,2,149,150,0,166,1116,1133,17,1
20063ref,5389,5706,JUNC00000120,1676,-,5389,5706,255;0;0,2,150,150,0,167,5539,5556,17,1
20063ref,7963,8279,JUNC00000179,581,-,7963,8279,255;0;0,2,149,150,0,166,8112,8129,17,1
20063ref,465,703,JUNC00000004,82,-,465,703,255;0;0,2,73,149,0,89,538,554,16,1
20063ref,2667,2841,JUNC00000060,19,-,2667,2841,255;0;0,2,149,9,0,165,2816,2832,16,1
20063ref,2697,3009,JUNC00000064,16,+,2697,3009,255;0;0,2,149,147,0,165,2846,2862,16,1
20063ref,2715,3030,JUNC00000065,53,+,2715,3030,255;0;0,2,150,149,0,166,2865,2881,16,1
20063ref,7728,8038,JUNC00000175,21,-,7728,8038,255;0;0,2,147,147,0,163,7875,7891,16,1
20063ref,8772,9079,JUNC00000184,68,-,8772,9079,255;0;0,2,145,146,0,161,8917,8933,16,1
20063ref,2327,2639,JUNC00000048,5,+,2327,2639,255;0;0,2,148,149,0,163,2475,2490,15,1
20063ref,2449,2763,JUNC00000054,11,+,2449,2763,255;0;0,2,149,150,0,164,2598,2613,15,1
20063ref,2685,2994,JUNC00000063,33,+,2685,2994,255;0;0,2,145,149,0,160,2830,2845,15,1
20063ref,5450,5764,JUNC00000122,19,-,5450,5764,255;0;0,2,150,149,0,165,5600,5615,15,1
20063ref,9989,10160,JUNC00000193,3,+,9989,10160,255;0;0,2,148,8,0,163,10137,10152,15,1
20063ref,2128,2293,JUNC00000040,1,+,2128,2293,255;0;0,2,8,143,0,22,2136,2150,14,1
20063ref,2656,2966,JUNC00000059,49,-,2656,2966,255;0;0,2,146,150,0,160,2802,2816,14,1
20063ref,4132,4420,JUNC00000095,20,+,4132,4420,255;0;0,2,125,149,0,139,4257,4271,14,1
20063ref,710,1020,JUNC00000013,150,+,710,1020,255;0;0,2,148,149,0,161,858,871,13,1
20063ref,2805,2989,JUNC00000062,6,+,2805,2989,255;0;0,2,22,149,0,35,2827,2840,13,1
20063ref,2362,2566,JUNC00000045,8,+,2362,2566,255;0;0,2,44,148,0,56,2406,2418,12,1
20063ref,5083,5250,JUNC00000117,65,+,5083,5250,255;0;0,2,8,147,0,20,5091,5103,12,1
20063ref,6968,7139,JUNC00000145,20,+,6968,7139,255;0;0,2,149,10,0,161,7117,7129,12,1
20063ref,1994,2296,JUNC00000039,13,+,1994,2296,255;0;0,2,142,149,0,153,2136,2147,11,1
20063ref,5972,6280,JUNC00000131,34,-,5972,6280,255;0;0,2,148,149,0,159,6120,6131,11,1
20063ref,9184,9494,JUNC00000188,13,-,9184,9494,255;0;0,2,149,150,0,160,9333,9344,11,1
20063ref,3974,4280,JUNC00000088,89,+,3974,4280,255;0;0,2,146,150,0,156,4120,4130,10,1
20063ref,4834,4995,JUNC00000111,1,-,4834,4995,255;0;0,2,9,142,0,19,4843,4853,10,1
20063ref,7241,7427,JUNC00000152,45,+,7241,7427,255;0;0,2,26,150,0,36,7267,7277,10,1
20063ref,7647,7808,JUNC00000168,6,+,7647,7808,255;0;0,2,42,109,0,52,7689,7699,10,1
20063ref,711,1013,JUNC00000012,72,-,711,1013,255;0;0,2,144,149,0,153,855,864,9,1
20063ref,1002,1210,JUNC00000023,60,-,1002,1210,255;0;0,2,148,52,0,156,1150,1158,8,1
20063ref,6820,7100,JUNC00000143,40,-,6820,7100,255;0;0,2,122,150,0,130,6942,6950,8,1
20063ref,7423,7729,JUNC00000158,14,-,7423,7729,255;0;0,2,150,148,0,158,7573,7581,8,1
20063ref,7444,7648,JUNC00000159,363,+,7444,7648,255;0;0,2,148,48,0,156,7592,7600,8,1
20063ref,7864,8071,JUNC00000176,171,+,7864,8071,255;0;0,2,50,149,0,58,7914,7922,8,1
20063ref,10118,10426,JUNC00000196,50,+,10118,10426,255;0;0,2,150,150,0,158,10268,10276,8,1
20063ref,822,1125,JUNC00000015,78,+,822,1125,255;0;0,2,147,149,0,154,969,976,7,1
20063ref,6367,6636,JUNC00000133,110,+,6367,6636,255;0;0,2,117,145,0,124,6484,6491,7,1
20063ref,7514,7817,JUNC00000162,5,-,7514,7817,255;0;0,2,146,150,0,153,7660,7667,7,1
20063ref,7531,7835,JUNC00000166,9,+,7531,7835,255;0;0,2,147,150,0,154,7678,7685,7,1
20063ref,7540,7845,JUNC00000167,18,+,7540,7845,255;0;0,2,149,149,0,156,7689,7696,7,1
20063ref,7729,8013,JUNC00000173,4,+,7729,8013,255;0;0,2,128,149,0,135,7857,7864,7,1
20063ref,8283,8588,JUNC00000181,862,+,8283,8588,255;0;0,2,148,150,0,155,8431,8438,7,1
20063ref,974,1247,JUNC00000021,3,+,974,1247,255;0;0,2,148,119,0,154,1122,1128,6,1
20063ref,3948,4252,JUNC00000087,7,-,3948,4252,255;0;0,2,149,149,0,155,4097,4103,6,1
20063ref,4235,4414,JUNC00000105,135,-,4235,4414,255;0;0,2,147,26,0,153,4382,4388,6,1
20063ref,5407,5713,JUNC00000121,284,-,5407,5713,255;0;0,2,150,150,0,156,5557,5563,6,1
20063ref,5729,6031,JUNC00000126,14,+,5729,6031,255;0;0,2,149,147,0,155,5878,5884,6,1
20063ref,6515,6819,JUNC00000137,4,+,6515,6819,255;0;0,2,149,149,0,155,6664,6670,6,1
20063ref,6602,6903,JUNC00000140,7,+,6602,6903,255;0;0,2,147,148,0,153,6749,6755,6,1
20063ref,1262,1555,JUNC00000026,4,+,1262,1555,255;0;0,2,149,139,0,154,1411,1416,5,1
20063ref,3050,3354,JUNC00000072,14,+,3050,3354,255;0;0,2,149,150,0,154,3199,3204,5,1
20063ref,6987,7291,JUNC00000147,90,+,6987,7291,255;0;0,2,150,149,0,155,7137,7142,5,1
20063ref,7127,7341,JUNC00000148,73,+,7127,7341,255;0;0,2,63,146,0,68,7190,7195,5,1
20063ref,7248,7426,JUNC00000153,6,+,7248,7426,255;0;0,2,24,149,0,29,7272,7277,5,1
20063ref,7423,7727,JUNC00000157,19,-,7423,7727,255;0;0,2,150,149,0,155,7573,7578,5,1
20063ref,7725,8027,JUNC00000174,19,-,7725,8027,255;0;0,2,150,147,0,155,7875,7880,5,1
20063ref,8813,9078,JUNC00000186,1817,+,8813,9078,255;0;0,2,110,150,0,115,8923,8928,5,1
23492ref2,819,1126,JUNC00000001,303,+,819,1126,255;0;0,2,150,150,0,157,969,976,7,1
23492ref2,819,1171,JUNC00000002,15,+,819,1171,255;0;0,2,150,149,0,203,969,1022,53,1
23492ref2,951,1166,JUNC00000003,5,-,951,1166,255;0;0,2,148,8,0,207,1099,1158,59,1
23492ref2,951,1236,JUNC00000004,265,-,951,1236,255;0;0,2,150,78,0,207,1101,1158,57,1
23492ref2,979,1167,JUNC00000005,18,-,979,1167,255;0;0,2,149,9,0,179,1128,1158,30,1
23492ref2,1003,1211,JUNC00000006,133,-,1003,1211,255;0;0,2,147,53,0,155,1150,1158,8,1
23492ref2,2615,2847,JUNC00000007,1,+,2615,2847,255;0;0,2,55,96,0,136,2670,2751,81,1
23492ref2,9478,9750,JUNC00000008,1,+,9478,9750,255;0;0,2,28,123,0,149,9506,9627,121,1
19622ref4,1161,9300,JUNC00000024,2,+,1161,9300,255;0;0,2,121,149,0,7990,1282,9151,7869,1
19622ref4,1265,8830,JUNC00000025,2,+,1265,8830,255;0;0,2,43,108,0,7457,1308,8722,7414,1
19622ref4,2839,9193,JUNC00000043,1,+,2839,9193,255;0;0,2,103,48,0,6306,2942,9145,6203,1
19622ref4,974,6219,JUNC00000018,467,+,974,6219,255;0;0,2,148,119,0,5126,1122,6100,4978,1
19622ref4,1278,6255,JUNC00000026,2,+,1278,6255,255;0;0,2,105,149,0,4828,1383,6106,4723,1
19622ref4,3654,7573,JUNC00000051,1,+,3654,7573,255;0;0,2,129,22,0,3897,3783,7551,3768,1
19622ref4,2653,6110,JUNC00000042,4,-,2653,6110,255;0;0,2,93,58,0,3399,2746,6052,3306,1
19622ref4,3953,7248,JUNC00000053,1,-,3953,7248,255;0;0,2,37,114,0,3181,3990,7134,3144,1
19622ref4,3126,6255,JUNC00000047,3,+,3126,6255,255;0;0,2,10,149,0,2980,3136,6106,2970,1
19622ref4,4707,7726,JUNC00000064,16,-,4707,7726,255;0;0,2,39,112,0,2907,4746,7614,2868,1
19622ref4,7293,10201,JUNC00000086,1,+,7293,10201,255;0;0,2,92,59,0,2849,7385,10142,2757,1
19622ref4,1071,3614,JUNC00000020,3,+,1071,3614,255;0;0,2,77,116,0,2427,1148,3498,2350,1
19622ref4,7692,10017,JUNC00000099,1,-,7692,10017,255;0;0,2,84,67,0,2258,7776,9950,2174,1
19622ref4,6108,8053,JUNC00000083,40,+,6108,8053,255;0;0,2,147,9,0,1936,6255,8044,1789,1
19622ref4,7999,9140,JUNC00000105,292,+,7999,9140,255;0;0,2,35,116,0,1025,8034,9024,990,1
19622ref4,7663,8789,JUNC00000094,1,+,7663,8789,255;0;0,2,36,115,0,1011,7699,8674,975,1
19622ref4,7911,8504,JUNC00000102,2,+,7911,8504,255;0;0,2,11,143,0,450,7922,8361,439,1
19622ref4,9490,10118,JUNC00000121,19,+,9490,10118,255;0;0,2,149,71,0,557,9639,10047,408,1
19622ref4,532,1060,JUNC00000006,2,+,532,1060,255;0;0,2,76,75,0,453,608,985,377,1
19622ref4,4617,5142,JUNC00000063,2,-,4617,5142,255;0;0,2,129,22,0,503,4746,5120,374,1
19622ref4,619,1141,JUNC00000007,13,+,619,1141,255;0;0,2,37,126,0,396,656,1015,359,1
19622ref4,6103,6728,JUNC00000081,3,+,6103,6728,255;0;0,2,146,124,0,501,6249,6604,355,1
19622ref4,8952,9455,JUNC00000115,3,+,8952,9455,255;0;0,2,135,20,0,483,9087,9435,348,1
19622ref4,543,1041,JUNC00000005,1,-,543,1041,255;0;0,2,24,127,0,371,567,914,347,1
19622ref4,5525,6089,JUNC00000075,7,-,5525,6089,255;0;0,2,148,71,0,493,5673,6018,345,1
19622ref4,550,1133,JUNC00000009,11,+,550,1133,255;0;0,2,124,118,0,465,674,1015,341,1
19622ref4,2394,3001,JUNC00000039,98,-,2394,3001,255;0;0,2,150,145,0,462,2544,2856,312,1
19622ref4,874,1452,JUNC00000015,29,+,874,1452,255;0;0,2,141,144,0,434,1015,1308,293,1
19622ref4,4237,4682,JUNC00000056,8,-,4237,4682,255;0;0,2,138,15,0,430,4375,4667,292,1
19622ref4,7378,7704,JUNC00000087,1,-,7378,7704,255;0;0,2,31,19,0,307,7409,7685,276,1
19622ref4,619,1133,JUNC00000010,28,+,619,1133,255;0;0,2,145,118,0,396,764,1015,251,1
19622ref4,9634,10029,JUNC00000122,1,+,9634,10029,255;0;0,2,115,36,0,359,9749,9993,244,1
19622ref4,4461,4846,JUNC00000060,1,+,4461,4846,255;0;0,2,45,106,0,279,4506,4740,234,1
19622ref4,4715,5235,JUNC00000067,4,-,4715,5235,255;0;0,2,148,148,0,372,4863,5087,224,1
19622ref4,1743,2050,JUNC00000030,4,-,1743,2050,255;0;0,2,8,76,0,231,1751,1974,223,1
19622ref4,1003,1394,JUNC00000019,6,+,1003,1394,255;0;0,2,145,33,0,358,1148,1361,213,1
19622ref4,8803,9282,JUNC00000112,6430,+,8803,9282,255;0;0,2,120,150,0,329,8923,9132,209,1
19622ref4,621,976,JUNC00000008,1,+,621,976,255;0;0,2,53,98,0,257,674,878,204,1
19622ref4,426,773,JUNC00000004,1,+,426,773,255;0;0,2,108,43,0,304,534,730,196,1
19622ref4,1330,1666,JUNC00000027,1,-,1330,1666,255;0;0,2,128,23,0,313,1458,1643,185,1
19622ref4,625,1096,JUNC00000011,124,-,625,1096,255;0;0,2,145,143,0,328,770,953,183,1
19622ref4,1709,2046,JUNC00000032,10,+,1709,2046,255;0;0,2,122,34,0,303,1831,2012,181,1
19622ref4,7939,8259,JUNC00000103,1,+,7939,8259,255;0;0,2,46,94,0,226,7985,8165,180,1
19622ref4,7582,8015,JUNC00000093,12,+,7582,8015,255;0;0,2,117,142,0,291,7699,7873,174,1
19622ref4,9094,9493,JUNC00000119,103,+,9094,9493,255;0;0,2,143,82,0,317,9237,9411,174,1
19622ref4,4066,4382,JUNC00000054,3,+,4066,4382,255;0;0,2,92,59,0,257,4158,4323,165,1
19622ref4,4581,4941,JUNC00000062,24,+,4581,4941,255;0;0,2,147,50,0,310,4728,4891,163,1
19622ref4,8869,9233,JUNC00000110,1756,+,8869,9233,255;0;0,2,52,150,0,214,8921,9083,162,1
19622ref4,5016,5474,JUNC00000071,54,+,5016,5474,255;0;0,2,148,150,0,308,5164,5324,160,1
19622ref4,7698,8035,JUNC00000095,6,+,7698,8035,255;0;0,2,33,150,0,187,7731,7885,154,1
19622ref4,7714,8019,JUNC00000096,1,-,7714,8019,255;0;0,2,38,113,0,192,7752,7906,154,1
19622ref4,8348,8634,JUNC00000107,1,+,8348,8634,255;0;0,2,98,34,0,252,8446,8600,154,1
19622ref4,8368,8663,JUNC00000108,818,+,8368,8663,255;0;0,2,149,9,0,286,8517,8654,137,1
19622ref4,4399,4730,JUNC00000061,7,-,4399,4730,255;0;0,2,133,63,0,268,4532,4667,135,1
19622ref4,1126,1527,JUNC00000023,10,+,1126,1527,255;0;0,2,144,125,0,276,1270,1402,132,1
19622ref4,3766,4006,JUNC00000052,2,-,3766,4006,255;0;0,2,93,22,0,218,3859,3984,125,1
19622ref4,481,754,JUNC00000003,1,+,481,754,255;0;0,2,53,98,0,175,534,656,122,1
19622ref4,7686,8016,JUNC00000098,4,-,7686,8016,255;0;0,2,90,125,0,205,7776,7891,115,1
19622ref4,1397,1648,JUNC00000028,1,+,1397,1648,255;0;0,2,68,83,0,168,1465,1565,100,1
19622ref4,7649,7896,JUNC00000097,1,-,7649,7896,255;0;0,2,111,39,0,208,7760,7857,97,1
19622ref4,9007,9315,JUNC00000117,52,+,9007,9315,255;0;0,2,149,63,0,245,9156,9252,96,1
19622ref4,2394,2781,JUNC00000038,89,-,2394,2781,255;0;0,2,150,145,0,242,2544,2636,92,1
19622ref4,8817,9200,JUNC00000113,5,-,8817,9200,255;0;0,2,148,146,0,237,8965,9054,89,1
19622ref4,1797,2034,JUNC00000031,2,-,1797,2034,255;0;0,2,29,122,0,115,1826,1912,86,1
19622ref4,463,699,JUNC00000002,1,+,463,699,255;0;0,2,71,80,0,156,534,619,85,1
19622ref4,4763,5078,JUNC00000066,4,-,4763,5078,255;0;0,2,82,148,0,167,4845,4930,85,1
19622ref4,1638,1872,JUNC00000029,1,+,1638,1872,255;0;0,2,59,92,0,142,1697,1780,83,1
19622ref4,8906,9022,JUNC00000109,1,+,8906,9022,255;0;0,2,9,25,0,91,8915,8997,82,1
19622ref4,5825,6200,JUNC00000077,20,-,5825,6200,255;0;0,2,147,148,0,227,5972,6052,80,1
19622ref4,4883,5131,JUNC00000070,3,+,4883,5131,255;0;0,2,149,24,0,224,5032,5107,75,1
19622ref4,1785,2009,JUNC00000033,1,+,1785,2009,255;0;0,2,114,37,0,187,1899,1972,73,1
19622ref4,2858,3079,JUNC00000045,1,-,2858,3079,255;0;0,2,114,37,0,184,2972,3042,70,1
19622ref4,9000,9244,JUNC00000114,59,+,9000,9244,255;0;0,2,30,144,0,100,9030,9100,70,1
19622ref4,7362,7727,JUNC00000088,178,-,7362,7727,255;0;0,2,149,149,0,216,7511,7578,67,1
19622ref4,4857,4987,JUNC00000068,2,-,4857,4987,255;0;0,2,22,43,0,87,4879,4944,65,1
19622ref4,2526,2628,JUNC00000037,1,+,2526,2628,255;0;0,2,17,22,0,80,2543,2606,63,1
19622ref4,4785,4909,JUNC00000065,2,-,4785,4909,255;0;0,2,40,23,0,101,4825,4886,61,1
19622ref4,4322,4533,JUNC00000058,2,-,4322,4533,255;0;0,2,115,36,0,175,4437,4497,60,1
19622ref4,4444,4695,JUNC00000059,35,-,4444,4695,255;0;0,2,53,140,0,111,4497,4555,58,1
19622ref4,955,1214,JUNC00000016,1096,-,955,1214,255;0;0,2,146,56,0,203,1101,1158,57,1
19622ref4,5844,6052,JUNC00000076,2,+,5844,6052,255;0;0,2,121,30,0,178,5965,6022,57,1
19622ref4,9264,9472,JUNC00000120,1,+,9264,9472,255;0;0,2,114,37,0,171,9378,9435,57,1
19622ref4,825,1169,JUNC00000014,32,+,825,1169,255;0;0,2,144,147,0,197,969,1022,53,1
19622ref4,4957,5155,JUNC00000069,1,-,4957,5155,255;0;0,2,8,143,0,55,4965,5012,47,1
19622ref4,2567,2638,JUNC00000040,1,+,2567,2638,255;0;0,2,22,9,0,62,2589,2629,40,1
19622ref4,7510,7777,JUNC00000091,6,+,7510,7777,255;0;0,2,150,81,0,186,7660,7696,36,1
19622ref4,2948,3136,JUNC00000044,8,+,2948,3136,255;0;0,2,8,147,0,41,2956,2989,33,1
19622ref4,5511,5779,JUNC00000073,119,-,5511,5779,255;0;0,2,89,146,0,122,5600,5633,33,1
19622ref4,729,944,JUNC00000012,6,+,729,944,255;0;0,2,149,34,0,181,878,910,32,1
19622ref4,2425,2608,JUNC00000036,2,-,2425,2608,255;0;0,2,8,144,0,39,2433,2464,31,1
19622ref4,7468,7699,JUNC00000090,7,+,7468,7699,255;0;0,2,148,52,0,179,7616,7647,31,1
19622ref4,5594,5652,JUNC00000074,1,-,5594,5652,255;0;0,2,10,19,0,39,5604,5633,29,1
19622ref4,6106,6432,JUNC00000082,6,+,6106,6432,255;0;0,2,149,148,0,178,6255,6284,29,1
19622ref4,7871,8053,JUNC00000104,11,+,7871,8053,255;0;0,2,144,9,0,173,8015,8044,29,1
19622ref4,3024,3351,JUNC00000049,322,-,3024,3351,255;0;0,2,149,150,0,177,3173,3201,28,1
19622ref4,3154,3433,JUNC00000050,749,-,3154,3433,255;0;0,2,103,149,0,130,3257,3284,27,1
19622ref4,7383,7565,JUNC00000089,5,-,7383,7565,255;0;0,2,147,9,0,173,7530,7556,26,1
19622ref4,3023,3211,JUNC00000048,67,+,3023,3211,255;0;0,2,148,15,0,173,3171,3196,25,1
19622ref4,2916,3159,JUNC00000046,2,-,2916,3159,255;0;0,2,149,72,0,171,3065,3087,22,1
19622ref4,7820,7990,JUNC00000101,1,-,7820,7990,255;0;0,2,96,55,0,115,7916,7935,19,1
19622ref4,1042,1211,JUNC00000022,1,-,1042,1211,255;0;0,2,132,19,0,150,1174,1192,18,1
19622ref4,6042,6212,JUNC00000078,344,+,6042,6212,255;0;0,2,8,146,0,24,6050,6066,16,1
19622ref4,7541,7848,JUNC00000092,3,-,7541,7848,255;0;0,2,144,147,0,160,7685,7701,16,1
19622ref4,2475,2641,JUNC00000041,1,+,2475,2641,255;0;0,2,139,12,0,154,2614,2629,15,1
19622ref4,1983,2292,JUNC00000034,2,+,1983,2292,255;0;0,2,148,147,0,162,2131,2145,14,1
19622ref4,4183,4418,JUNC00000055,39,+,4183,4418,255;0;0,2,74,147,0,88,4257,4271,14,1
19622ref4,6023,6329,JUNC00000079,5,+,6023,6329,255;0;0,2,145,148,0,158,6168,6181,13,1
19622ref4,8988,9295,JUNC00000116,2,+,8988,9295,255;0;0,2,148,147,0,160,9136,9148,12,1
19622ref4,2112,2166,JUNC00000035,2,+,2112,2166,255;0;0,2,24,19,0,35,2136,2147,11,1
19622ref4,6256,6417,JUNC00000084,2,-,6256,6417,255;0;0,2,64,87,0,74,6320,6330,10,1
19622ref4,9031,9196,JUNC00000118,5,+,9031,9196,255;0;0,2,148,8,0,157,9179,9188,9,1
19622ref4,1002,1231,JUNC00000021,1022,-,1002,1231,255;0;0,2,148,73,0,156,1150,1158,8,1
19622ref4,824,1126,JUNC00000013,1008,+,824,1126,255;0;0,2,145,150,0,152,969,976,7,1
19622ref4,8284,8586,JUNC00000106,3,+,8284,8586,255;0;0,2,147,148,0,154,8431,8438,7,1
19622ref4,304,424,JUNC00000001,2,+,304,424,255;0;0,2,40,74,0,46,344,350,6,1
19622ref4,976,1270,JUNC00000017,13,+,976,1270,255;0;0,2,146,142,0,152,1122,1128,6,1
19622ref4,4235,4432,JUNC00000057,283,-,4235,4432,255;0;0,2,147,44,0,153,4382,4388,6,1
19622ref4,5115,5344,JUNC00000072,251,+,5115,5344,255;0;0,2,150,73,0,156,5265,5271,6,1
19622ref4,6071,6233,JUNC00000080,8,+,6071,6233,255;0;0,2,148,8,0,154,6219,6225,6,1
19622ref4,6987,7246,JUNC00000085,6,+,6987,7246,255;0;0,2,150,104,0,155,7137,7142,5,1
19622ref4,7726,7905,JUNC00000100,8,-,7726,7905,255;0;0,2,149,25,0,154,7875,7880,5,1
19622ref4,8802,9078,JUNC00000111,36672,+,8802,9078,255;0;0,2,121,150,0,126,8923,8928,5,1
21321ref,1233,9307,JUNC00000037,4,-,1233,9307,255;0;0,2,90,91,0,7983,1323,9216,7893,1
21321ref,323,8052,JUNC00000003,3,+,323,8052,255;0;0,2,148,45,0,7684,471,8007,7536,1
21321ref,717,7565,JUNC00000019,5,-,717,7565,255;0;0,2,143,9,0,6839,860,7556,6696,1
21321ref,2659,9343,JUNC00000074,6,+,2659,9343,255;0;0,2,147,113,0,6571,2806,9230,6424,1
21321ref,3674,9663,JUNC00000084,9,+,3674,9663,255;0;0,2,8,148,0,5841,3682,9515,5833,1
21321ref,2168,8017,JUNC00000063,10,+,2168,8017,255;0;0,2,142,10,0,5839,2310,8007,5697,1
21321ref,933,6514,JUNC00000028,52,+,933,6514,255;0;0,2,150,150,0,5431,1083,6364,5281,1
21321ref,2738,8140,JUNC00000076,3,+,2738,8140,255;0;0,2,85,146,0,5256,2823,7994,5171,1
21321ref,2689,7538,JUNC00000072,1,+,2689,7538,255;0;0,2,82,69,0,4780,2771,7469,4698,1
21321ref,4578,9075,JUNC00000099,16,+,4578,9075,255;0;0,2,146,147,0,4350,4724,8928,4204,1
21321ref,2660,6785,JUNC00000073,60,+,2660,6785,255;0;0,2,146,115,0,4010,2806,6670,3864,1
21321ref,6602,10441,JUNC00000127,13,+,6602,10441,255;0;0,2,147,150,0,3689,6749,10291,3542,1
21321ref,2530,6018,JUNC00000071,2,-,2530,6018,255;0;0,2,145,19,0,3469,2675,5999,3324,1
21321ref,2857,6241,JUNC00000079,20106,-,2857,6241,255;0;0,2,103,148,0,3236,2960,6093,3133,1
21321ref,5907,9179,JUNC00000115,7,-,5907,9179,255;0;0,2,65,147,0,3125,5972,9032,3060,1
21321ref,4230,6193,JUNC00000093,3,-,4230,6193,255;0;0,2,145,149,0,1814,4375,6044,1669,1
21321ref,1836,2861,JUNC00000057,1,-,1836,2861,255;0;0,2,138,13,0,1012,1974,2848,874,1
21321ref,9519,10164,JUNC00000182,7,+,9519,10164,255;0;0,2,146,9,0,636,9665,10155,490,1
21321ref,2239,2991,JUNC00000065,9,+,2239,2991,255;0;0,2,149,149,0,603,2388,2842,454,1
21321ref,523,1169,JUNC00000006,11,+,523,1169,255;0;0,2,46,147,0,499,569,1022,453,1
21321ref,7347,7937,JUNC00000138,4,-,7347,7937,255;0;0,2,142,62,0,528,7489,7875,386,1
21321ref,9568,10138,JUNC00000180,19,+,9568,10138,255;0;0,2,50,145,0,425,9618,9993,375,1
21321ref,4619,5121,JUNC00000102,2,+,4619,5121,255;0;0,2,146,8,0,494,4765,5113,348,1
21321ref,7278,7770,JUNC00000134,126,-,7278,7770,255;0;0,2,9,145,0,347,7287,7625,338,1
21321ref,3854,4477,JUNC00000086,2,+,3854,4477,255;0;0,2,145,148,0,475,3999,4329,330,1
21321ref,5728,6215,JUNC00000110,134,+,5728,6215,255;0;0,2,8,149,0,338,5736,6066,330,1
21321ref,871,1453,JUNC00000026,19,+,871,1453,255;0;0,2,144,145,0,437,1015,1308,293,1
21321ref,7549,8012,JUNC00000148,71,+,7549,8012,255;0;0,2,150,26,0,437,7699,7986,287,1
21321ref,1660,2001,JUNC00000048,1,-,1660,2001,255;0;0,2,29,27,0,314,1689,1974,285,1
21321ref,2044,2617,JUNC00000060,4,-,2044,2617,255;0;0,2,147,148,0,425,2191,2469,278,1
21321ref,626,1054,JUNC00000011,1,+,626,1054,255;0;0,2,112,39,0,389,738,1015,277,1
21321ref,7312,7734,JUNC00000136,2,+,7312,7734,255;0;0,2,10,144,0,278,7322,7590,268,1
21321ref,7101,7505,JUNC00000132,2,+,7101,7505,255;0;0,2,73,72,0,332,7174,7433,259,1
21321ref,9732,10138,JUNC00000184,1,-,9732,10138,255;0;0,2,94,57,0,349,9826,10081,255,1
21321ref,2702,3110,JUNC00000078,44,+,2702,3110,255;0;0,2,146,8,0,400,2848,3102,254,1
21321ref,703,1133,JUNC00000014,20,+,703,1133,255;0;0,2,61,118,0,312,764,1015,251,1
21321ref,7313,7710,JUNC00000135,2,+,7313,7710,255;0;0,2,9,142,0,255,7322,7568,246,1
21321ref,9225,9645,JUNC00000179,18,+,9225,9645,255;0;0,2,117,60,0,360,9342,9585,243,1
21321ref,5299,5681,JUNC00000107,1,+,5299,5681,255;0;0,2,101,50,0,332,5400,5631,231,1
21321ref,7112,7627,JUNC00000133,16,-,7112,7627,255;0;0,2,149,149,0,366,7261,7478,217,1
21321ref,2434,2946,JUNC00000069,6,+,2434,2946,255;0;0,2,150,146,0,366,2584,2800,216,1
21321ref,6604,6939,JUNC00000125,2,+,6604,6939,255;0;0,2,98,36,0,299,6702,6903,201,1
21321ref,748,1104,JUNC00000015,12,+,748,1104,255;0;0,2,20,138,0,218,768,966,198,1
21321ref,6576,6935,JUNC00000126,2,+,6576,6935,255;0;0,2,144,23,0,336,6720,6912,192,1
21321ref,9810,10153,JUNC00000186,1,-,9810,10153,255;0;0,2,140,11,0,332,9950,10142,192,1
21321ref,8733,9074,JUNC00000164,1,+,8733,9074,255;0;0,2,54,97,0,244,8787,8977,190,1
21321ref,7647,8128,JUNC00000151,2,+,7647,8128,255;0;0,2,150,147,0,334,7797,7981,184,1
21321ref,609,1088,JUNC00000013,19,-,609,1088,255;0;0,2,148,148,0,331,757,940,183,1
21321ref,625,982,JUNC00000016,109,-,625,982,255;0;0,2,145,29,0,328,770,953,183,1
21321ref,6902,7294,JUNC00000131,2,+,6902,7294,255;0;0,2,64,146,0,246,6966,7148,182,1
21321ref,1290,1626,JUNC00000043,20,+,1290,1626,255;0;0,2,148,8,0,328,1438,1618,180,1
21321ref,2995,3398,JUNC00000080,77,+,2995,3398,255;0;0,2,77,149,0,254,3072,3249,177,1
21321ref,7573,8015,JUNC00000147,6,+,7573,8015,255;0;0,2,126,142,0,300,7699,7873,174,1
21321ref,1027,1401,JUNC00000035,2,-,1027,1401,255;0;0,2,147,54,0,320,1174,1347,173,1
21321ref,701,1065,JUNC00000018,10,+,701,1065,255;0;0,2,142,50,0,314,843,1015,172,1
21321ref,8430,8749,JUNC00000161,2,+,8430,8749,255;0;0,2,8,143,0,176,8438,8606,168,1
21321ref,7320,7699,JUNC00000137,5,+,7320,7699,255;0;0,2,65,148,0,231,7385,7551,166,1
21321ref,8844,9233,JUNC00000167,5894,+,8844,9233,255;0;0,2,77,150,0,239,8921,9083,162,1
21321ref,526,837,JUNC00000005,7,+,526,837,255;0;0,2,8,143,0,168,534,694,160,1
21321ref,5016,5474,JUNC00000105,64,+,5016,5474,255;0;0,2,148,150,0,308,5164,5324,160,1
21321ref,118,512,JUNC00000001,3,+,118,512,255;0;0,2,88,147,0,247,206,365,159,1
21321ref,605,913,JUNC00000010,1,+,605,913,255;0;0,2,127,23,0,285,732,890,158,1
21321ref,685,1018,JUNC00000009,10,+,685,1018,255;0;0,2,32,147,0,186,717,871,154,1
21321ref,1265,1606,JUNC00000041,9,+,1265,1606,255;0;0,2,146,41,0,300,1411,1565,154,1
21321ref,1001,1438,JUNC00000033,14,+,1001,1438,255;0;0,2,147,143,0,294,1148,1295,147,1
21321ref,6028,6375,JUNC00000120,15,+,6028,6375,255;0;0,2,146,58,0,289,6174,6317,143,1
21321ref,526,817,JUNC00000004,1,+,526,817,255;0;0,2,8,143,0,148,534,674,140,1
21321ref,2351,2640,JUNC00000066,1,+,2351,2640,255;0;0,2,140,11,0,278,2491,2629,138,1
21321ref,4572,5003,JUNC00000098,3,+,4572,5003,255;0;0,2,149,145,0,286,4721,4858,137,1
21321ref,8367,8803,JUNC00000163,1586,+,8367,8803,255;0;0,2,150,149,0,287,8517,8654,137,1
21321ref,4412,4742,JUNC00000097,22,-,4412,4742,255;0;0,2,127,68,0,262,4539,4674,135,1
21321ref,3960,4384,JUNC00000087,9,-,3960,4384,255;0;0,2,147,144,0,280,4107,4240,133,1
21321ref,7714,7970,JUNC00000153,2,-,7714,7970,255;0;0,2,115,8,0,248,7829,7962,133,1
21321ref,3960,4388,JUNC00000088,4,-,3960,4388,255;0;0,2,149,148,0,280,4109,4240,131,1
21321ref,2209,2633,JUNC00000064,3,-,2209,2633,255;0;0,2,149,147,0,277,2358,2486,128,1
21321ref,6829,7168,JUNC00000130,2,+,6829,7168,255;0;0,2,74,146,0,193,6903,7022,119,1
21321ref,1909,2294,JUNC00000058,649,+,1909,2294,255;0;0,2,125,144,0,241,2034,2150,116,1
21321ref,7629,7993,JUNC00000149,2,-,7629,7993,255;0;0,2,147,102,0,262,7776,7891,115,1
21321ref,7637,8036,JUNC00000150,4,+,7637,8036,255;0;0,2,142,142,0,257,7779,7894,115,1
21321ref,4740,5028,JUNC00000103,2,+,4740,5028,255;0;0,2,75,101,0,187,4815,4927,112,1
21321ref,720,980,JUNC00000017,7,+,720,980,255;0;0,2,63,88,0,172,783,892,109,1
21321ref,2943,3210,JUNC00000081,3,+,2943,3210,255;0;0,2,145,14,0,253,3088,3196,108,1
21321ref,1295,1546,JUNC00000042,2,-,1295,1546,255;0;0,2,143,8,0,243,1438,1538,100,1
21321ref,1382,1692,JUNC00000044,2,+,1382,1692,255;0;0,2,83,127,0,183,1465,1565,100,1
21321ref,2679,3067,JUNC00000075,9,+,2679,3067,255;0;0,2,144,148,0,240,2823,2919,96,1
21321ref,2390,2637,JUNC00000067,16,-,2390,2637,255;0;0,2,146,8,0,239,2536,2629,93,1
21321ref,5740,5984,JUNC00000112,1,+,5740,5984,255;0;0,2,101,50,0,194,5841,5934,93,1
21321ref,1478,1701,JUNC00000046,3,+,1478,1701,255;0;0,2,70,63,0,160,1548,1638,90,1
21321ref,852,1092,JUNC00000025,12,+,852,1092,255;0;0,2,144,8,0,232,996,1084,88,1
21321ref,1722,1960,JUNC00000050,2,-,1722,1960,255;0;0,2,29,122,0,116,1751,1838,87,1
21321ref,7346,7699,JUNC00000139,6,+,7346,7699,255;0;0,2,148,118,0,235,7494,7581,87,1
21321ref,1749,2048,JUNC00000054,20,-,1749,2048,255;0;0,2,77,136,0,163,1826,1912,86,1
21321ref,8765,9121,JUNC00000165,62,+,8765,9121,255;0;0,2,150,124,0,232,8915,8997,82,1
21321ref,2581,2806,JUNC00000070,1,+,2581,2806,255;0;0,2,89,55,0,170,2670,2751,81,1
21321ref,484,734,JUNC00000007,5,+,484,734,255;0;0,2,124,46,0,204,608,688,80,1
21321ref,2264,2375,JUNC00000061,1,-,2264,2375,255;0;0,2,8,26,0,85,2272,2349,77,1
21321ref,5958,6189,JUNC00000117,12,+,5958,6189,255;0;0,2,147,8,0,223,6105,6181,76,1
21321ref,1647,1973,JUNC00000049,15,-,1647,1973,255;0;0,2,104,147,0,179,1751,1826,75,1
21321ref,2701,2963,JUNC00000077,14,-,2701,2963,255;0;0,2,147,40,0,222,2848,2923,75,1
21321ref,1785,1944,JUNC00000055,2,-,1785,1944,255;0;0,2,55,30,0,129,1840,1914,74,1
21321ref,1685,2008,JUNC00000052,2,+,1685,2008,255;0;0,2,108,142,0,181,1793,1866,73,1
21321ref,2437,2764,JUNC00000068,11,+,2437,2764,255;0;0,2,143,112,0,215,2580,2652,72,1
21321ref,4249,4474,JUNC00000091,2,+,4249,4474,255;0;0,2,8,145,0,80,4257,4329,72,1
21321ref,9831,10117,JUNC00000185,10,+,9831,10117,255;0;0,2,67,147,0,139,9898,9970,72,1
21321ref,6746,7108,JUNC00000129,5,-,6746,7108,255;0;0,2,146,146,0,216,6892,6962,70,1
21321ref,8928,9245,JUNC00000170,51,+,8928,9245,255;0;0,2,102,145,0,172,9030,9100,70,1
21321ref,1693,1913,JUNC00000051,1,-,1693,1913,255;0;0,2,76,75,0,145,1769,1838,69,1
21321ref,5101,5321,JUNC00000106,2,+,5101,5321,255;0;0,2,101,50,0,170,5202,5271,69,1
21321ref,1780,1990,JUNC00000053,4,+,1780,1990,255;0;0,2,44,98,0,112,1824,1892,68,1
21321ref,4292,4652,JUNC00000095,4,+,4292,4652,255;0;0,2,147,145,0,215,4439,4507,68,1
21321ref,8989,9316,JUNC00000173,6,+,8989,9316,255;0;0,2,131,128,0,199,9120,9188,68,1
21321ref,7362,7728,JUNC00000140,454,-,7362,7728,255;0;0,2,149,150,0,216,7511,7578,67,1
21321ref,8810,9174,JUNC00000169,2,+,8810,9174,255;0;0,2,150,150,0,214,8960,9024,64,1
21321ref,605,850,JUNC00000008,29,+,605,850,255;0;0,2,33,149,0,96,638,701,63,1
21321ref,954,1166,JUNC00000030,11,-,954,1166,255;0;0,2,145,8,0,204,1099,1158,59,1
21321ref,4428,4698,JUNC00000096,39,-,4428,4698,255;0;0,2,69,143,0,127,4497,4555,58,1
21321ref,819,1083,JUNC00000020,28,+,819,1083,255;0;0,2,59,148,0,116,878,935,57,1
21321ref,956,1288,JUNC00000031,2017,-,956,1288,255;0;0,2,145,130,0,202,1101,1158,57,1
21321ref,5948,6036,JUNC00000113,1,+,5948,6036,255;0;0,2,17,14,0,74,5965,6022,57,1
21321ref,6010,6261,JUNC00000119,4,-,6010,6261,255;0;0,2,134,63,0,188,6144,6198,54,1
21321ref,825,1171,JUNC00000024,52,+,825,1171,255;0;0,2,144,149,0,197,969,1022,53,1
21321ref,1761,1989,JUNC00000056,3,-,1761,1989,255;0;0,2,99,77,0,151,1860,1912,52,1
21321ref,6793,6996,JUNC00000128,1,-,6793,6996,255;0;0,2,47,104,0,99,6840,6892,52,1
21321ref,9958,10164,JUNC00000187,9,+,9958,10164,255;0;0,2,145,9,0,197,10103,10155,52,1
21321ref,5826,6030,JUNC00000114,6,-,5826,6030,255;0;0,2,146,8,0,196,5972,6022,50,1
21321ref,4919,5159,JUNC00000104,4,-,4919,5159,255;0;0,2,46,147,0,93,4965,5012,47,1
21321ref,8304,8515,JUNC00000162,20,+,8304,8515,255;0;0,2,145,19,0,192,8449,8496,47,1
21321ref,8909,9251,JUNC00000171,4,-,8909,9251,255;0;0,2,147,148,0,194,9056,9103,47,1
21321ref,5687,5890,JUNC00000109,672,-,5687,5890,255;0;0,2,8,149,0,54,5695,5741,46,1
21321ref,3733,4043,JUNC00000085,2,+,3733,4043,255;0;0,2,117,149,0,161,3850,3894,44,1
21321ref,7724,7917,JUNC00000152,9,-,7724,7917,255;0;0,2,82,68,0,125,7806,7849,43,1
21321ref,7502,7839,JUNC00000142,5,-,7502,7839,255;0;0,2,147,148,0,189,7649,7691,42,1
21321ref,599,877,JUNC00000012,6,-,599,877,255;0;0,2,145,92,0,186,744,785,41,1
21321ref,4618,4820,JUNC00000101,2,+,4618,4820,255;0;0,2,147,16,0,186,4765,4804,39,1
21321ref,7513,7717,JUNC00000144,3,+,7513,7717,255;0;0,2,147,18,0,186,7660,7699,39,1
21321ref,4249,4444,JUNC00000090,13,+,4249,4444,255;0;0,2,8,149,0,46,4257,4295,38,1
21321ref,2150,2389,JUNC00000062,4,+,2150,2389,255;0;0,2,141,62,0,177,2291,2327,36,1
21321ref,7514,7841,JUNC00000143,14,+,7514,7841,255;0;0,2,146,145,0,182,7660,7696,36,1
21321ref,9008,9215,JUNC00000175,238,-,9008,9215,255;0;0,2,150,21,0,186,9158,9194,36,1
21321ref,946,1274,JUNC00000029,3,+,946,1274,255;0;0,2,149,146,0,182,1095,1128,33,1
21321ref,1236,1564,JUNC00000038,6,+,1236,1564,255;0;0,2,147,148,0,180,1383,1416,33,1
21321ref,1384,1587,JUNC00000045,2,-,1384,1587,255;0;0,2,146,24,0,179,1530,1563,33,1
21321ref,6086,6415,JUNC00000122,121,-,6086,6415,255;0;0,2,150,146,0,183,6236,6269,33,1
21321ref,8987,9315,JUNC00000174,29,-,8987,9315,255;0;0,2,149,147,0,181,9136,9168,32,1
21321ref,4237,4426,JUNC00000092,84,-,4237,4426,255;0;0,2,115,44,0,145,4352,4382,30,1
21321ref,6106,6430,JUNC00000124,5,+,6106,6430,255;0;0,2,149,146,0,178,6255,6284,29,1
21321ref,7872,8053,JUNC00000158,11,+,7872,8053,255;0;0,2,143,9,0,172,8015,8044,29,1
21321ref,6241,6420,JUNC00000123,1,+,6241,6420,255;0;0,2,8,143,0,36,6249,6277,28,1
21321ref,7848,8043,JUNC00000155,2,+,7848,8043,255;0;0,2,18,149,0,46,7866,7894,28,1
21321ref,10021,10211,JUNC00000189,2,+,10021,10211,255;0;0,2,143,19,0,171,10164,10192,28,1
21321ref,10026,10255,JUNC00000190,1788,-,10026,10255,255;0;0,2,150,51,0,178,10176,10204,28,1
21321ref,3132,3433,JUNC00000083,92,-,3132,3433,255;0;0,2,125,149,0,152,3257,3284,27,1
21321ref,3023,3238,JUNC00000082,104,+,3023,3238,255;0;0,2,148,42,0,173,3171,3196,25,1
21321ref,7600,7776,JUNC00000145,1,+,7600,7776,255;0;0,2,74,77,0,99,7674,7699,25,1
21321ref,899,1150,JUNC00000027,4,-,899,1150,255;0;0,2,127,103,0,148,1026,1047,21,1
21321ref,9585,9901,JUNC00000183,2,-,9585,9901,255;0;0,2,145,150,0,166,9730,9751,21,1
21321ref,5569,5764,JUNC00000108,2,-,5569,5764,255;0;0,2,26,149,0,46,5595,5615,20,1
21321ref,7797,7967,JUNC00000157,1,-,7797,7967,255;0;0,2,119,32,0,138,7916,7935,19,1
21321ref,1272,1441,JUNC00000036,2,+,1272,1441,255;0;0,2,48,103,0,66,1320,1338,18,1
21321ref,4742,4827,JUNC00000100,1,+,4742,4827,255;0;0,2,23,44,0,41,4765,4783,18,1
21321ref,9031,9205,JUNC00000177,6,+,9031,9205,255;0;0,2,148,8,0,166,9179,9197,18,1
21321ref,7963,8242,JUNC00000159,27,-,7963,8242,255;0;0,2,149,113,0,166,8112,8129,17,1
21321ref,8771,9079,JUNC00000166,19,-,8771,9079,255;0;0,2,146,146,0,162,8917,8933,16,1
21321ref,9078,9275,JUNC00000178,28,+,9078,9275,255;0;0,2,144,38,0,159,9222,9237,15,1
21321ref,9992,10172,JUNC00000188,4,+,9992,10172,255;0;0,2,145,20,0,160,10137,10152,15,1
21321ref,861,1078,JUNC00000021,3,-,861,1078,255;0;0,2,57,146,0,71,918,932,14,1
21321ref,4159,4418,JUNC00000089,28,+,4159,4418,255;0;0,2,98,147,0,112,4257,4271,14,1
21321ref,1457,1727,JUNC00000047,100,+,1457,1727,255;0;0,2,148,109,0,161,1605,1618,13,1
21321ref,5709,5896,JUNC00000111,3,+,5709,5896,255;0;0,2,132,42,0,145,5841,5854,13,1
21321ref,2112,2297,JUNC00000059,3,+,2112,2297,255;0;0,2,24,150,0,35,2136,2147,11,1
21321ref,6015,6276,JUNC00000118,49,-,6015,6276,255;0;0,2,100,150,0,111,6115,6126,11,1
21321ref,800,1075,JUNC00000022,6,-,800,1075,255;0;0,2,143,122,0,153,943,953,10,1
21321ref,7709,8017,JUNC00000154,6,+,7709,8017,255;0;0,2,148,150,0,158,7857,7867,10,1
21321ref,305,484,JUNC00000002,12,+,305,484,255;0;0,2,149,21,0,158,454,463,9,1
21321ref,1239,1544,JUNC00000039,21,-,1239,1544,255;0;0,2,147,149,0,156,1386,1395,9,1
21321ref,9031,9196,JUNC00000176,3,+,9031,9196,255;0;0,2,148,8,0,157,9179,9188,9,1
21321ref,1001,1209,JUNC00000034,1191,-,1001,1209,255;0;0,2,149,51,0,157,1150,1158,8,1
21321ref,824,1126,JUNC00000023,1140,+,824,1126,255;0;0,2,145,150,0,152,969,976,7,1
21321ref,8283,8552,JUNC00000160,3,+,8283,8552,255;0;0,2,148,114,0,155,8431,8438,7,1
21321ref,973,1275,JUNC00000032,19,+,973,1275,255;0;0,2,149,147,0,155,1122,1128,6,1
21321ref,4237,4422,JUNC00000094,556,-,4237,4422,255;0;0,2,145,34,0,151,4382,4388,6,1
21321ref,6069,6233,JUNC00000121,7,+,6069,6233,255;0;0,2,150,8,0,156,6219,6225,6,1
21321ref,7539,7835,JUNC00000146,6,-,7539,7835,255;0;0,2,146,144,0,152,7685,7691,6,1
21321ref,8952,9156,JUNC00000172,4,-,8952,9156,255;0;0,2,150,48,0,156,9102,9108,6,1
21321ref,1244,1548,JUNC00000040,25,+,1244,1548,255;0;0,2,149,150,0,154,1393,1398,5,1
21321ref,5990,6200,JUNC00000116,28,+,5990,6200,255;0;0,2,60,145,0,65,6050,6055,5,1
21321ref,7425,7728,JUNC00000141,7,-,7425,7728,255;0;0,2,148,150,0,153,7573,7578,5,1
21321ref,7727,8027,JUNC00000156,8,-,7727,8027,255;0;0,2,148,147,0,153,7875,7880,5,1
21321ref,8825,9078,JUNC00000168,36024,+,8825,9078,255;0;0,2,98,150,0,103,8923,8928,5,1
21321ref,9478,9644,JUNC00000181,2,+,9478,9644,255;0;0,2,149,12,0,154,9627,9632,5,1
21890ref,952,9355,JUNC00000029,25,-,952,9355,255;0;0,2,149,67,0,8336,1101,9288,8187,1
21890ref,1112,9279,JUNC00000039,1,+,1112,9279,255;0;0,2,109,42,0,8125,1221,9237,8016,1
21890ref,871,9083,JUNC00000025,8,+,871,9083,255;0;0,2,144,86,0,8126,1015,8997,7982,1
21890ref,1285,9251,JUNC00000042,1,-,1285,9251,255;0;0,2,58,93,0,7873,1343,9158,7815,1
21890ref,976,9078,JUNC00000031,14585,+,976,9078,255;0;0,2,140,150,0,7952,1116,8928,7812,1
21890ref,997,8923,JUNC00000035,9,+,997,8923,255;0;0,2,149,38,0,7888,1146,8885,7739,1
21890ref,1234,8313,JUNC00000044,11,+,1234,8313,255;0;0,2,119,148,0,6931,1353,8165,6812,1
21890ref,1005,7700,JUNC00000038,17,-,1005,7700,255;0;0,2,149,149,0,6546,1154,7551,6397,1
21890ref,2239,8421,JUNC00000070,5887,+,2239,8421,255;0;0,2,149,8,0,6174,2388,8413,6025,1
21890ref,1899,8192,JUNC00000065,7,-,1899,8192,255;0;0,2,148,145,0,6148,2047,8047,6000,1
21890ref,2418,8438,JUNC00000077,18,+,2418,8438,255;0;0,2,147,122,0,5898,2565,8316,5751,1
21890ref,974,6256,JUNC00000033,801,+,974,6256,255;0;0,2,148,117,0,5165,1122,6139,5017,1
21890ref,1324,6237,JUNC00000045,3,-,1324,6237,255;0;0,2,43,147,0,4766,1367,6090,4723,1
21890ref,1235,6176,JUNC00000046,4,+,1235,6176,255;0;0,2,148,70,0,4871,1383,6106,4723,1
21890ref,4537,9061,JUNC00000113,3,+,4537,9061,255;0;0,2,147,148,0,4376,4684,8913,4229,1
21890ref,4624,9077,JUNC00000114,12,+,4624,9077,255;0;0,2,75,149,0,4304,4699,8928,4229,1
21890ref,246,4625,JUNC00000003,3,+,246,4625,255;0;0,2,145,59,0,4320,391,4566,4175,1
21890ref,2403,6193,JUNC00000072,4,-,2403,6193,255;0;0,2,25,149,0,3641,2428,6044,3616,1
21890ref,2770,6230,JUNC00000082,2,-,2770,6230,255;0;0,2,113,149,0,3311,2883,6081,3198,1
21890ref,1906,5129,JUNC00000064,17,-,1906,5129,255;0;0,2,141,32,0,3191,2047,5097,3050,1
21890ref,1264,4362,JUNC00000048,18,+,1264,4362,255;0;0,2,147,39,0,3059,1411,4323,2912,1
21890ref,4739,7762,JUNC00000119,1,+,4739,7762,255;0;0,2,26,125,0,2898,4765,7637,2872,1
21890ref,4579,7534,JUNC00000115,17,+,4579,7534,255;0;0,2,145,149,0,2806,4724,7385,2661,1
21890ref,6480,9175,JUNC00000140,1,+,6480,9175,255;0;0,2,96,55,0,2640,6576,9120,2544,1
21890ref,4331,6248,JUNC00000108,8,+,4331,6248,255;0;0,2,47,148,0,1769,4378,6100,1722,1
21890ref,6105,7992,JUNC00000139,2,+,6105,7992,255;0;0,2,150,35,0,1852,6255,7957,1702,1
21890ref,6229,7792,JUNC00000137,1,+,6229,7792,255;0;0,2,20,131,0,1432,6249,7661,1412,1
21890ref,4174,5668,JUNC00000102,1,-,4174,5668,255;0;0,2,126,25,0,1469,4300,5643,1343,1
21890ref,979,2566,JUNC00000034,63,+,979,2566,255;0;0,2,148,148,0,1439,1127,2418,1291,1
21890ref,1004,2445,JUNC00000037,27,-,1004,2445,255;0;0,2,146,91,0,1350,1150,2354,1204,1
21890ref,4988,6153,JUNC00000122,1,-,4988,6153,255;0;0,2,142,9,0,1156,5130,6144,1014,1
21890ref,1727,2850,JUNC00000058,2,-,1727,2850,255;0;0,2,99,142,0,981,1826,2708,882,1
21890ref,8280,9158,JUNC00000167,3,+,8280,9158,255;0;0,2,149,148,0,730,8429,9010,581,1
21890ref,2356,3172,JUNC00000074,11,+,2356,3172,255;0;0,2,145,125,0,691,2501,3047,546,1
21890ref,6063,6678,JUNC00000134,4,-,6063,6678,255;0;0,2,143,49,0,566,6206,6629,423,1
21890ref,8562,9281,JUNC00000174,7,-,8562,9281,255;0;0,2,147,149,0,570,8709,9132,423,1
21890ref,3645,4187,JUNC00000094,2,-,3645,4187,255;0;0,2,102,49,0,493,3747,4138,391,1
21890ref,9078,9606,JUNC00000183,6,+,9078,9606,255;0;0,2,147,26,0,502,9225,9580,355,1
21890ref,4682,5181,JUNC00000118,1,+,4682,5181,255;0;0,2,83,68,0,431,4765,5113,348,1
21890ref,615,1235,JUNC00000014,43,+,615,1235,255;0;0,2,149,145,0,475,764,1090,326,1
21890ref,7407,8015,JUNC00000150,16,+,7407,8015,255;0;0,2,147,142,0,466,7554,7873,319,1
21890ref,871,1452,JUNC00000024,36,+,871,1452,255;0;0,2,144,144,0,437,1015,1308,293,1
21890ref,2389,2963,JUNC00000076,2,-,2389,2963,255;0;0,2,147,147,0,427,2536,2816,280,1
21890ref,2112,2617,JUNC00000067,5,-,2112,2617,255;0;0,2,79,148,0,357,2191,2469,278,1
21890ref,2661,3088,JUNC00000079,1,+,2661,3088,255;0;0,2,110,41,0,386,2771,3047,276,1
21890ref,4665,5073,JUNC00000117,1,+,4665,5073,255;0;0,2,100,51,0,357,4765,5022,257,1
21890ref,622,1133,JUNC00000013,33,+,622,1133,255;0;0,2,142,118,0,393,764,1015,251,1
21890ref,1639,2000,JUNC00000053,1,+,1639,2000,255;0;0,2,74,77,0,284,1713,1923,210,1
21890ref,4279,4639,JUNC00000106,3,+,4279,4639,255;0;0,2,85,66,0,294,4364,4573,209,1
21890ref,4238,4731,JUNC00000107,3,-,4238,4731,255;0;0,2,137,150,0,343,4375,4581,206,1
21890ref,5752,6256,JUNC00000127,2,+,5752,6256,255;0;0,2,149,150,0,354,5901,6106,205,1
21890ref,9179,9567,JUNC00000186,19,+,9179,9567,255;0;0,2,149,37,0,351,9328,9530,202,1
21890ref,6601,6953,JUNC00000141,1,+,6601,6953,255;0;0,2,101,50,0,302,6702,6903,201,1
21890ref,7999,8342,JUNC00000162,11,+,7999,8342,255;0;0,2,8,145,0,198,8007,8197,190,1
21890ref,701,1088,JUNC00000012,5,-,701,1088,255;0;0,2,56,148,0,239,757,940,183,1
21890ref,7610,8015,JUNC00000155,5,+,7610,8015,255;0;0,2,89,142,0,263,7699,7873,174,1
21890ref,7553,7905,JUNC00000154,5,+,7553,7905,255;0;0,2,146,38,0,314,7699,7867,168,1
21890ref,3886,4203,JUNC00000097,6,+,3886,4203,255;0;0,2,8,146,0,171,3894,4057,163,1
21890ref,7694,8002,JUNC00000159,1,+,7694,8002,255;0;0,2,143,8,0,300,7837,7994,157,1
21890ref,618,1018,JUNC00000008,17,+,618,1018,255;0;0,2,99,147,0,253,717,871,154,1
21890ref,2791,3195,JUNC00000083,2,+,2791,3195,255;0;0,2,102,148,0,256,2893,3047,154,1
21890ref,120,532,JUNC00000001,5,-,120,532,255;0;0,2,111,148,0,264,231,384,153,1
21890ref,3203,3402,JUNC00000091,3,-,3203,3402,255;0;0,2,25,23,0,176,3228,3379,151,1
21890ref,7259,7696,JUNC00000144,102,-,7259,7696,255;0;0,2,150,136,0,301,7409,7560,151,1
21890ref,781,1136,JUNC00000017,6,+,781,1136,255;0;0,2,65,148,0,207,846,988,142,1
21890ref,2817,3209,JUNC00000086,14,-,2817,3209,255;0;0,2,150,101,0,291,2967,3108,141,1
21890ref,689,980,JUNC00000009,1,+,689,980,255;0;0,2,49,102,0,189,738,878,140,1
21890ref,3772,4063,JUNC00000098,1,+,3772,4063,255;0;0,2,130,21,0,270,3902,4042,140,1
21890ref,3794,4082,JUNC00000096,1,-,3794,4082,255;0;0,2,53,98,0,190,3847,3984,137,1
21890ref,8367,8804,JUNC00000172,755,+,8367,8804,255;0;0,2,150,150,0,287,8517,8654,137,1
21890ref,4408,4720,JUNC00000112,15,-,4408,4720,255;0;0,2,131,46,0,266,4539,4674,135,1
21890ref,4032,4318,JUNC00000099,6,-,4032,4318,255;0;0,2,75,78,0,208,4107,4240,133,1
21890ref,8681,8965,JUNC00000173,1,+,8681,8965,255;0;0,2,27,124,0,160,8708,8841,133,1
21890ref,2887,3190,JUNC00000084,7,+,2887,3190,255;0;0,2,32,145,0,158,2919,3045,126,1
21890ref,841,1133,JUNC00000019,12,+,841,1133,255;0;0,2,37,131,0,161,878,1002,124,1
21890ref,448,721,JUNC00000006,5,+,448,721,255;0;0,2,86,65,0,208,534,656,122,1
21890ref,353,765,JUNC00000005,13,+,353,765,255;0;0,2,149,143,0,269,502,622,120,1
21890ref,3178,3421,JUNC00000093,1,+,3178,3421,255;0;0,2,98,27,0,216,3276,3394,118,1
21890ref,710,978,JUNC00000016,1,+,710,978,255;0;0,2,122,29,0,239,832,949,117,1
21890ref,5955,6230,JUNC00000130,12,+,5955,6230,255;0;0,2,150,10,0,265,6105,6220,115,1
21890ref,7620,7884,JUNC00000157,1,+,7620,7884,255;0;0,2,121,30,0,234,7741,7854,113,1
21890ref,2856,3110,JUNC00000087,30,+,2856,3110,255;0;0,2,144,8,0,246,3000,3102,102,1
21890ref,1291,1546,JUNC00000049,3,-,1291,1546,255;0;0,2,147,8,0,247,1438,1538,100,1
21890ref,1361,1758,JUNC00000052,1188,-,1361,1758,255;0;0,2,150,147,0,250,1511,1611,100,1
21890ref,2387,2685,JUNC00000075,3,-,2387,2685,255;0;0,2,149,49,0,249,2536,2636,100,1
21890ref,7079,7362,JUNC00000143,6,-,7079,7362,255;0;0,2,39,148,0,135,7118,7214,96,1
21890ref,608,998,JUNC00000011,8,-,608,998,255;0;0,2,149,147,0,243,757,851,94,1
21890ref,720,1026,JUNC00000015,3,-,720,1026,255;0;0,2,65,148,0,158,785,878,93,1
21890ref,9217,9459,JUNC00000187,1,+,9217,9459,255;0;0,2,125,26,0,216,9342,9433,91,1
21890ref,1722,2056,JUNC00000057,20,-,1722,2056,255;0;0,2,104,144,0,190,1826,1912,86,1
21890ref,1386,1622,JUNC00000051,2,-,1386,1622,255;0;0,2,120,31,0,205,1506,1591,85,1
21890ref,1077,1344,JUNC00000041,11,+,1077,1344,255;0;0,2,147,39,0,228,1224,1305,81,1
21890ref,10084,10285,JUNC00000191,2,+,10084,10285,255;0;0,2,27,93,0,108,10111,10192,81,1
21890ref,7557,7812,JUNC00000152,25,+,7557,7812,255;0;0,2,79,101,0,154,7636,7711,75,1
21890ref,1754,1943,JUNC00000055,1,+,1754,1943,255;0;0,2,39,77,0,112,1793,1866,73,1
21890ref,1721,1986,JUNC00000054,2,-,1721,1986,255;0;0,2,48,148,0,117,1769,1838,69,1
21890ref,8783,9088,JUNC00000177,3,+,8783,9088,255;0;0,2,145,91,0,214,8928,8997,69,1
21890ref,7362,7624,JUNC00000147,260,-,7362,7624,255;0;0,2,149,46,0,216,7511,7578,67,1
21890ref,7347,7702,JUNC00000146,4,+,7347,7702,255;0;0,2,147,142,0,213,7494,7560,66,1
21890ref,1663,2023,JUNC00000056,2,-,1663,2023,255;0;0,2,146,149,0,211,1809,1874,65,1
21890ref,4942,5157,JUNC00000121,1,-,4942,5157,255;0;0,2,124,27,0,188,5066,5130,64,1
21890ref,5698,5994,JUNC00000125,2,+,5698,5994,255;0;0,2,143,89,0,207,5841,5905,64,1
21890ref,8291,8644,JUNC00000170,117,+,8291,8644,255;0;0,2,147,143,0,210,8438,8501,63,1
21890ref,1763,1934,JUNC00000059,2,-,1763,1934,255;0;0,2,87,22,0,149,1850,1912,62,1
21890ref,2220,2477,JUNC00000068,4,+,2220,2477,255;0;0,2,46,150,0,107,2266,2327,61,1
21890ref,2917,3148,JUNC00000088,2,+,2917,3148,255;0;0,2,130,40,0,191,3047,3108,61,1
21890ref,4317,4529,JUNC00000105,2,+,4317,4529,255;0;0,2,45,106,0,106,4362,4423,61,1
21890ref,7599,7846,JUNC00000156,2,+,7599,7846,255;0;0,2,129,57,0,190,7728,7789,61,1
21890ref,6835,7046,JUNC00000142,1,-,6835,7046,255;0;0,2,90,61,0,150,6925,6985,60,1
21890ref,950,1167,JUNC00000027,7,-,950,1167,255;0;0,2,149,9,0,208,1099,1158,59,1
21890ref,4206,4539,JUNC00000103,2,-,4206,4539,255;0;0,2,144,131,0,202,4350,4408,58,1
21890ref,4480,4694,JUNC00000111,4,-,4480,4694,255;0;0,2,17,139,0,75,4497,4555,58,1
21890ref,8463,8644,JUNC00000171,1,+,8463,8644,255;0;0,2,25,98,0,83,8488,8546,58,1
21890ref,9034,9245,JUNC00000181,5,+,9034,9245,255;0;0,2,145,8,0,203,9179,9237,58,1
21890ref,956,1259,JUNC00000028,1212,-,956,1259,255;0;0,2,145,101,0,202,1101,1158,57,1
21890ref,1309,1661,JUNC00000050,6,-,1309,1661,255;0;0,2,149,149,0,203,1458,1512,54,1
21890ref,1717,2060,JUNC00000062,5,-,1717,2060,255;0;0,2,143,146,0,197,1860,1914,54,1
21890ref,826,1171,JUNC00000022,47,+,826,1171,255;0;0,2,143,149,0,196,969,1022,53,1
21890ref,8282,8630,JUNC00000169,2,+,8282,8630,255;0;0,2,149,146,0,202,8431,8484,53,1
21890ref,1798,2041,JUNC00000061,9,-,1798,2041,255;0;0,2,62,129,0,114,1860,1912,52,1
21890ref,5656,5848,JUNC00000123,2,+,5656,5848,255;0;0,2,92,48,0,144,5748,5800,52,1
21890ref,8232,8435,JUNC00000166,2,-,8232,8435,255;0;0,2,50,101,0,102,8282,8334,52,1
21890ref,7389,7591,JUNC00000145,1,-,7389,7591,255;0;0,2,38,113,0,89,7427,7478,51,1
21890ref,6073,6366,JUNC00000133,5,+,6073,6366,255;0;0,2,98,146,0,147,6171,6220,49,1
21890ref,4957,5155,JUNC00000120,1,-,4957,5155,255;0;0,2,8,143,0,55,4965,5012,47,1
21890ref,8909,9111,JUNC00000178,13,-,8909,9111,255;0;0,2,147,8,0,194,9056,9103,47,1
21890ref,2654,2810,JUNC00000078,2,+,2654,2810,255;0;0,2,43,67,0,89,2697,2743,46,1
21890ref,8144,8237,JUNC00000165,1,+,8144,8237,255;0;0,2,24,24,0,69,8168,8213,45,1
21890ref,9880,10076,JUNC00000190,1,+,9880,10076,255;0;0,2,45,106,0,90,9925,9970,45,1
21890ref,7664,7995,JUNC00000158,3,-,7664,7995,255;0;0,2,142,146,0,185,7806,7849,43,1
21890ref,450,792,JUNC00000007,4,-,450,792,255;0;0,2,150,150,0,192,600,642,42,1
21890ref,720,912,JUNC00000010,2,-,720,912,255;0;0,2,24,127,0,65,744,785,41,1
21890ref,871,1085,JUNC00000023,13,+,871,1085,255;0;0,2,144,30,0,184,1015,1055,40,1
21890ref,9073,9264,JUNC00000182,1,+,9073,9264,255;0;0,2,124,27,0,164,9197,9237,40,1
21890ref,2238,2572,JUNC00000069,6,-,2238,2572,255;0;0,2,150,148,0,186,2388,2424,36,1
21890ref,7518,7747,JUNC00000153,7,+,7518,7747,255;0;0,2,142,51,0,178,7660,7696,36,1
21890ref,1848,2169,JUNC00000063,44,+,1848,2169,255;0;0,2,141,147,0,174,1989,2022,33,1
21890ref,2948,3136,JUNC00000085,8,+,2948,3136,255;0;0,2,8,147,0,41,2956,2989,33,1
21890ref,729,1055,JUNC00000018,4,+,729,1055,255;0;0,2,149,145,0,181,878,910,32,1
21890ref,174,502,JUNC00000002,375,+,174,502,255;0;0,2,150,147,0,181,324,355,31,1
21890ref,2425,2486,JUNC00000073,1,-,2425,2486,255;0;0,2,8,22,0,39,2433,2464,31,1
21890ref,5924,6252,JUNC00000129,3,+,5924,6252,255;0;0,2,148,149,0,179,6072,6103,31,1
21890ref,7710,8036,JUNC00000160,10,+,7710,8036,255;0;0,2,147,148,0,178,7857,7888,31,1
21890ref,3636,3964,JUNC00000095,29,+,3636,3964,255;0;0,2,150,148,0,180,3786,3816,30,1
21890ref,4332,4513,JUNC00000104,1,-,4332,4513,255;0;0,2,20,131,0,50,4352,4382,30,1
21890ref,6105,6404,JUNC00000138,4,+,6105,6404,255;0;0,2,150,120,0,179,6255,6284,29,1
21890ref,7872,8053,JUNC00000163,9,+,7872,8053,255;0;0,2,143,9,0,172,8015,8044,29,1
21890ref,3023,3221,JUNC00000090,470,-,3023,3221,255;0;0,2,150,20,0,178,3173,3201,28,1
21890ref,3134,3433,JUNC00000092,56,-,3134,3433,255;0;0,2,123,149,0,150,3257,3284,27,1
21890ref,7383,7580,JUNC00000148,8,-,7383,7580,255;0;0,2,147,24,0,173,7530,7556,26,1
21890ref,9160,9337,JUNC00000184,1,-,9160,9337,255;0;0,2,102,49,0,128,9262,9288,26,1
21890ref,973,1215,JUNC00000032,45,+,973,1215,255;0;0,2,149,68,0,174,1122,1147,25,1
21890ref,3023,3346,JUNC00000089,137,+,3023,3346,255;0;0,2,148,150,0,173,3171,3196,25,1
21890ref,7389,7710,JUNC00000149,16,-,7389,7710,255;0;0,2,148,148,0,173,7537,7562,25,1
21890ref,1234,1525,JUNC00000043,22,+,1234,1525,255;0;0,2,119,148,0,143,1353,1377,24,1
21890ref,898,1122,JUNC00000026,3,-,898,1122,255;0;0,2,128,75,0,149,1026,1047,21,1
21890ref,4244,4484,JUNC00000110,3,+,4244,4484,255;0;0,2,149,72,0,168,4393,4412,19,1
21890ref,4220,4406,JUNC00000100,3,-,4220,4406,255;0;0,2,19,149,0,37,4239,4257,18,1
21890ref,4671,4923,JUNC00000116,4,+,4671,4923,255;0;0,2,94,140,0,112,4765,4783,18,1
21890ref,6000,6212,JUNC00000132,5,-,6000,6212,255;0;0,2,126,68,0,144,6126,6144,18,1
21890ref,7963,8242,JUNC00000164,30,-,7963,8242,255;0;0,2,149,113,0,166,8112,8129,17,1
21890ref,824,1134,JUNC00000021,80,+,824,1134,255;0;0,2,145,149,0,161,969,985,16,1
21890ref,5903,6212,JUNC00000128,236,+,5903,6212,255;0;0,2,147,146,0,163,6050,6066,16,1
21890ref,8906,9079,JUNC00000175,17,-,8906,9079,255;0;0,2,11,146,0,27,8917,8933,16,1
21890ref,8989,9299,JUNC00000179,6,+,8989,9299,255;0;0,2,147,148,0,162,9136,9151,15,1
21890ref,9197,9507,JUNC00000188,9,+,9197,9507,255;0;0,2,148,147,0,163,9345,9360,15,1
21890ref,1070,1278,JUNC00000030,2,+,1070,1278,255;0;0,2,44,150,0,58,1114,1128,14,1
21890ref,4128,4418,JUNC00000101,16,+,4128,4418,255;0;0,2,129,147,0,143,4257,4271,14,1
21890ref,5699,5881,JUNC00000124,2,+,5699,5881,255;0;0,2,142,27,0,155,5841,5854,13,1
21890ref,9543,9730,JUNC00000189,6,+,9543,9730,255;0;0,2,24,150,0,37,9567,9580,13,1
21890ref,6066,6230,JUNC00000135,3,+,6066,6230,255;0;0,2,142,10,0,154,6208,6220,12,1
21890ref,2110,2296,JUNC00000066,3,+,2110,2296,255;0;0,2,26,149,0,37,2136,2147,11,1
21890ref,6070,6279,JUNC00000131,49,-,6070,6279,255;0;0,2,50,148,0,61,6120,6131,11,1
21890ref,1076,1383,JUNC00000040,126,+,1076,1383,255;0;0,2,148,149,0,158,1224,1234,10,1
21890ref,2697,2864,JUNC00000081,99,+,2697,2864,255;0;0,2,149,8,0,159,2846,2856,10,1
21890ref,305,610,JUNC00000004,11,+,305,610,255;0;0,2,149,147,0,158,454,463,9,1
21890ref,5728,5927,JUNC00000126,4,-,5728,5927,255;0;0,2,145,45,0,154,5873,5882,9,1
21890ref,9034,9197,JUNC00000180,6,+,9034,9197,255;0;0,2,145,9,0,154,9179,9188,9,1
21890ref,1001,1259,JUNC00000036,953,-,1001,1259,255;0;0,2,149,101,0,157,1150,1158,8,1
21890ref,2666,2959,JUNC00000080,6,+,2666,2959,255;0;0,2,140,145,0,148,2806,2814,8,1
21890ref,824,1126,JUNC00000020,1768,+,824,1126,255;0;0,2,145,150,0,152,969,976,7,1
21890ref,7721,7884,JUNC00000161,7,+,7721,7884,255;0;0,2,145,11,0,152,7866,7873,7,1
21890ref,8284,8586,JUNC00000168,5,+,8284,8586,255;0;0,2,147,148,0,154,8431,8438,7,1
21890ref,1747,2015,JUNC00000060,6,+,1747,2015,255;0;0,2,113,149,0,119,1860,1866,6,1
21890ref,4232,4432,JUNC00000109,167,-,4232,4432,255;0;0,2,150,44,0,156,4382,4388,6,1
21890ref,6069,6233,JUNC00000136,7,+,6069,6233,255;0;0,2,150,8,0,156,6219,6225,6,1
21890ref,9131,9303,JUNC00000185,3,+,9131,9303,255;0;0,2,147,19,0,153,9278,9284,6,1
21890ref,1262,1425,JUNC00000047,15,+,1262,1425,255;0;0,2,149,9,0,154,1411,1416,5,1
21890ref,2257,2558,JUNC00000071,3,-,2257,2558,255;0;0,2,149,147,0,154,2406,2411,5,1
21890ref,7447,7603,JUNC00000151,4,-,7447,7603,255;0;0,2,126,25,0,131,7573,7578,5,1
21890ref,8800,9078,JUNC00000176,30336,+,8800,9078,255;0;0,2,123,150,0,128,8923,8928,5,1
21389ref,973,10358,JUNC00000038,83,+,973,10358,255;0;0,2,149,67,0,9318,1122,10291,9169,1
21389ref,1106,9685,JUNC00000040,1,-,1106,9685,255;0;0,2,73,77,0,8502,1179,9608,8429,1
21389ref,973,9273,JUNC00000037,63,+,973,9273,255;0;0,2,149,143,0,8157,1122,9130,8008,1
21389ref,1216,9377,JUNC00000044,15,-,1216,9377,255;0;0,2,147,147,0,8014,1363,9230,7867,1
21389ref,2538,10201,JUNC00000086,50,+,2538,10201,255;0;0,2,147,71,0,7592,2685,10130,7445,1
21389ref,1271,8836,JUNC00000042,1,+,1271,8836,255;0;0,2,37,114,0,7451,1308,8722,7414,1
21389ref,1879,9234,JUNC00000065,7,+,1879,9234,255;0;0,2,102,119,0,7236,1981,9115,7134,1
21389ref,1913,9157,JUNC00000070,13,+,1913,9157,255;0;0,2,149,147,0,7097,2062,9010,6948,1
21389ref,526,7511,JUNC00000006,1,-,526,7511,255;0;0,2,36,115,0,6870,562,7396,6834,1
21389ref,2471,9238,JUNC00000085,7,-,2471,9238,255;0;0,2,145,8,0,6759,2616,9230,6614,1
21389ref,995,7580,JUNC00000029,3,+,995,7580,255;0;0,2,65,86,0,6499,1060,7494,6434,1
21389ref,3749,10256,JUNC00000107,2,+,3749,10256,255;0;0,2,101,50,0,6457,3850,10206,6356,1
21389ref,2770,9179,JUNC00000091,6,+,2770,9179,255;0;0,2,60,148,0,6261,2830,9031,6201,1
21389ref,2894,9062,JUNC00000093,3,+,2894,9062,255;0;0,2,10,149,0,6019,2904,8913,6009,1
21389ref,2837,8997,JUNC00000094,1,+,2837,8997,255;0;0,2,82,69,0,6091,2919,8928,6009,1
21389ref,3079,8336,JUNC00000101,1,-,3079,8336,255;0;0,2,22,128,0,5129,3101,8208,5107,1
21389ref,1878,7107,JUNC00000067,5,-,1878,7107,255;0;0,2,150,79,0,5150,2028,7028,5000,1
21389ref,974,6149,JUNC00000036,21,+,974,6149,255;0;0,2,148,98,0,5077,1122,6051,4929,1
21389ref,1276,6374,JUNC00000047,79,+,1276,6374,255;0;0,2,149,149,0,4949,1425,6225,4800,1
21389ref,1858,6252,JUNC00000066,3,+,1858,6252,255;0;0,2,149,149,0,4245,2007,6103,4096,1
21389ref,1660,5793,JUNC00000057,2,+,1660,5793,255;0;0,2,133,18,0,4115,1793,5775,3982,1
21389ref,2547,6203,JUNC00000087,6,+,2547,6203,255;0;0,2,150,59,0,3597,2697,6144,3447,1
21389ref,5764,9237,JUNC00000141,15,+,5764,9237,255;0;0,2,66,143,0,3330,5830,9094,3264,1
21389ref,2767,6124,JUNC00000089,1,+,2767,6124,255;0;0,2,39,112,0,3245,2806,6012,3206,1
21389ref,973,3996,JUNC00000035,42,+,973,3996,255;0;0,2,149,22,0,3001,1122,3974,2852,1
21389ref,4578,7699,JUNC00000123,8,+,4578,7699,255;0;0,2,146,148,0,2973,4724,7551,2827,1
21389ref,6109,9146,JUNC00000154,10,-,6109,9146,255;0;0,2,146,147,0,2890,6255,8999,2744,1
21389ref,4582,7492,JUNC00000122,13,+,4582,7492,255;0;0,2,142,107,0,2803,4724,7385,2661,1
21389ref,973,3454,JUNC00000034,1309,+,973,3454,255;0;0,2,149,150,0,2331,1122,3304,2182,1
21389ref,5293,7658,JUNC00000135,2,+,5293,7658,255;0;0,2,74,146,0,2219,5367,7512,2145,1
21389ref,2422,4596,JUNC00000080,14,+,2422,4596,255;0;0,2,143,30,0,2144,2565,4566,2001,1
21389ref,8350,10160,JUNC00000194,2,-,8350,10160,255;0;0,2,130,21,0,1789,8480,10139,1659,1
21389ref,4062,5869,JUNC00000111,1,+,4062,5869,255;0;0,2,30,121,0,1686,4092,5748,1656,1
21389ref,7385,9234,JUNC00000164,6,+,7385,9234,255;0;0,2,103,119,0,1730,7488,9115,1627,1
21389ref,5869,7649,JUNC00000145,5,-,5869,7649,255;0;0,2,84,75,0,1705,5953,7574,1621,1
21389ref,7527,9331,JUNC00000172,10,-,7527,9331,255;0;0,2,147,150,0,1654,7674,9181,1507,1
21389ref,7550,9288,JUNC00000176,10,+,7550,9288,255;0;0,2,149,140,0,1598,7699,9148,1449,1
21389ref,7867,9327,JUNC00000182,1,-,7867,9327,255;0;0,2,61,90,0,1370,7928,9237,1309,1
21389ref,3327,4815,JUNC00000106,36,+,3327,4815,255;0;0,2,147,50,0,1438,3474,4765,1291,1
21389ref,8364,9763,JUNC00000189,4,+,8364,9763,255;0;0,2,30,145,0,1254,8394,9618,1224,1
21389ref,1238,2615,JUNC00000045,4,+,1238,2615,255;0;0,2,145,37,0,1340,1383,2578,1195,1
21389ref,1001,2234,JUNC00000028,10,+,1001,2234,255;0;0,2,54,84,0,1149,1055,2150,1095,1
21389ref,4960,6204,JUNC00000132,7,+,4960,6204,255;0;0,2,149,147,0,1097,5109,6057,948,1
21389ref,7870,9089,JUNC00000187,28,+,7870,9089,255;0;0,2,148,149,0,1070,8018,8940,922,1
21389ref,9092,10100,JUNC00000209,54,+,9092,10100,255;0;0,2,145,89,0,919,9237,10011,774,1
21389ref,2244,3129,JUNC00000074,2,+,2244,3129,255;0;0,2,131,84,0,801,2375,3045,670,1
21389ref,6087,6968,JUNC00000150,5,-,6087,6968,255;0;0,2,149,150,0,731,6236,6818,582,1
21389ref,8479,9331,JUNC00000196,7,-,8479,9331,255;0;0,2,149,145,0,707,8628,9186,558,1
21389ref,6986,7554,JUNC00000158,2,+,6986,7554,255;0;0,2,81,42,0,526,7067,7512,445,1
21389ref,6928,7640,JUNC00000159,13,+,6928,7640,255;0;0,2,145,146,0,566,7073,7494,421,1
21389ref,4580,5288,JUNC00000124,7,+,4580,5288,255;0;0,2,148,145,0,563,4728,5143,415,1
21389ref,635,1162,JUNC00000013,5,+,635,1162,255;0;0,2,21,147,0,380,656,1015,359,1
21389ref,9813,10303,JUNC00000213,1,-,9813,10303,255;0;0,2,38,113,0,377,9851,10190,339,1
21389ref,5722,6207,JUNC00000143,1,+,5722,6207,255;0;0,2,119,32,0,453,5841,6175,334,1
21389ref,5615,6002,JUNC00000139,1,+,5615,6002,255;0;0,2,49,10,0,377,5664,5992,328,1
21389ref,7177,7637,JUNC00000160,1,+,7177,7637,255;0;0,2,8,143,0,317,7185,7494,309,1
21389ref,1590,2047,JUNC00000053,2,+,1590,2047,255;0;0,2,76,75,0,382,1666,1972,306,1
21389ref,976,1452,JUNC00000026,26,+,976,1452,255;0;0,2,39,144,0,332,1015,1308,293,1
21389ref,2721,3148,JUNC00000088,2,+,2721,3148,255;0;0,2,50,101,0,326,2771,3047,276,1
21389ref,4703,5132,JUNC00000128,16,+,4703,5132,255;0;0,2,142,19,0,410,4845,5113,268,1
21389ref,1421,1839,JUNC00000051,4,+,1421,1839,255;0;0,2,44,107,0,311,1465,1732,267,1
21389ref,438,993,JUNC00000009,18,-,438,993,255;0;0,2,148,145,0,410,586,848,262,1
21389ref,562,975,JUNC00000010,3,-,562,975,255;0;0,2,36,115,0,298,598,860,262,1
21389ref,620,1138,JUNC00000018,16,+,620,1138,255;0;0,2,144,123,0,395,764,1015,251,1
21389ref,7894,8288,JUNC00000186,1,+,7894,8288,255;0;0,2,113,38,0,356,8007,8250,243,1
21389ref,3931,4402,JUNC00000108,7,+,3931,4402,255;0;0,2,94,145,0,326,4025,4257,232,1
21389ref,5011,5393,JUNC00000131,1,+,5011,5393,255;0;0,2,70,81,0,301,5081,5312,231,1
21389ref,1727,2101,JUNC00000054,1,+,1727,2101,255;0;0,2,22,129,0,245,1749,1972,223,1
21389ref,6797,7165,JUNC00000156,1,+,6797,7165,255;0;0,2,25,126,0,242,6822,7039,217,1
21389ref,1380,1745,JUNC00000050,1,+,1380,1745,255;0;0,2,85,65,0,300,1465,1680,215,1
21389ref,418,763,JUNC00000005,1,+,418,763,255;0;0,2,116,33,0,312,534,730,196,1
21389ref,787,1163,JUNC00000020,8,+,787,1163,255;0;0,2,39,148,0,228,826,1015,189,1
21389ref,7724,8063,JUNC00000178,2,-,7724,8063,255;0;0,2,82,69,0,270,7806,7994,188,1
21389ref,7292,7602,JUNC00000161,1,+,7292,7602,255;0;0,2,30,94,0,216,7322,7508,186,1
21389ref,634,1089,JUNC00000017,5,-,634,1089,255;0;0,2,123,149,0,306,757,940,183,1
21389ref,624,1101,JUNC00000019,100,-,624,1101,255;0;0,2,146,148,0,329,770,953,183,1
21389ref,89,422,JUNC00000001,1,+,89,422,255;0;0,2,28,123,0,210,117,299,182,1
21389ref,1216,1691,JUNC00000043,36,-,1216,1691,255;0;0,2,147,146,0,329,1363,1545,182,1
21389ref,983,1334,JUNC00000025,2,+,983,1334,255;0;0,2,32,142,0,209,1015,1192,177,1
21389ref,7551,8018,JUNC00000175,20,+,7551,8018,255;0;0,2,148,145,0,322,7699,7873,174,1
21389ref,7893,8218,JUNC00000183,1,+,7893,8218,255;0;0,2,45,106,0,219,7938,8112,174,1
21389ref,698,1148,JUNC00000021,5,+,698,1148,255;0;0,2,145,133,0,317,843,1015,172,1
21389ref,2772,3194,JUNC00000092,6,-,2772,3194,255;0;0,2,105,147,0,275,2877,3047,170,1
21389ref,7554,8006,JUNC00000174,9,+,7554,8006,255;0;0,2,145,139,0,313,7699,7867,168,1
21389ref,492,806,JUNC00000007,2,-,492,806,255;0;0,2,77,74,0,240,569,732,163,1
21389ref,5017,5392,JUNC00000134,4,+,5017,5392,255;0;0,2,147,68,0,307,5164,5324,160,1
21389ref,7692,8144,JUNC00000179,10,+,7692,8144,255;0;0,2,145,150,0,302,7837,7994,157,1
21389ref,8283,8611,JUNC00000191,3,+,8283,8611,255;0;0,2,148,24,0,304,8431,8587,156,1
21389ref,2319,2753,JUNC00000076,12,+,2319,2753,255;0;0,2,148,147,0,287,2467,2606,139,1
21389ref,1263,1612,JUNC00000046,45,+,1263,1612,255;0;0,2,148,64,0,285,1411,1548,137,1
21389ref,4399,4715,JUNC00000120,10,-,4399,4715,255;0;0,2,140,41,0,275,4539,4674,135,1
21389ref,3912,4331,JUNC00000110,15,+,3912,4331,255;0;0,2,147,148,0,271,4059,4183,124,1
21389ref,507,780,JUNC00000004,1,+,507,780,255;0;0,2,27,124,0,149,534,656,122,1
21389ref,2172,2379,JUNC00000072,7,+,2172,2379,255;0;0,2,53,32,0,175,2225,2347,122,1
21389ref,3207,3395,JUNC00000103,1,+,3207,3395,255;0;0,2,47,19,0,169,3254,3376,122,1
21389ref,3163,3432,JUNC00000105,1,+,3163,3432,255;0;0,2,113,38,0,231,3276,3394,118,1
21389ref,4283,4551,JUNC00000118,2,+,4283,4551,255;0;0,2,97,54,0,214,4380,4497,117,1
21389ref,1994,2295,JUNC00000068,399,+,1994,2295,255;0;0,2,40,145,0,156,2034,2150,116,1
21389ref,2437,2704,JUNC00000078,1,-,2437,2704,255;0;0,2,99,52,0,215,2536,2652,116,1
21389ref,1444,1688,JUNC00000052,7,+,1444,1688,255;0;0,2,80,50,0,194,1524,1638,114,1
21389ref,8339,8614,JUNC00000195,3,+,8339,8614,255;0;0,2,149,12,0,263,8488,8602,114,1
21389ref,4218,4488,JUNC00000115,2,+,4218,4488,255;0;0,2,105,53,0,217,4323,4435,112,1
21389ref,5346,5609,JUNC00000136,1,+,5346,5609,255;0;0,2,30,121,0,142,5376,5488,112,1
21389ref,7268,7528,JUNC00000162,1,+,7268,7528,255;0;0,2,67,84,0,176,7335,7444,109,1
21389ref,639,898,JUNC00000012,2,+,639,898,255;0;0,2,17,134,0,125,656,764,108,1
21389ref,1240,1498,JUNC00000041,2,+,1240,1498,255;0;0,2,30,121,0,137,1270,1377,107,1
21389ref,2854,3110,JUNC00000097,3,+,2854,3110,255;0;0,2,143,8,0,248,2997,3102,105,1
21389ref,1361,1612,JUNC00000049,2,+,1361,1612,255;0;0,2,104,47,0,204,1465,1565,100,1
21389ref,2389,2776,JUNC00000077,14,-,2389,2776,255;0;0,2,147,147,0,240,2536,2629,93,1
21389ref,9122,9508,JUNC00000211,3,+,9122,9508,255;0;0,2,145,150,0,236,9267,9358,91,1
21389ref,977,1236,JUNC00000024,14,+,977,1236,255;0;0,2,25,146,0,113,1002,1090,88,1
21389ref,611,848,JUNC00000014,2,+,611,848,255;0;0,2,106,45,0,192,717,803,86,1
21389ref,1728,2030,JUNC00000060,16,-,1728,2030,255;0;0,2,98,118,0,184,1826,1912,86,1
21389ref,1012,1247,JUNC00000027,2,+,1012,1247,255;0;0,2,26,125,0,110,1038,1122,84,1
21389ref,7471,7830,JUNC00000169,8,+,7471,7830,255;0;0,2,145,131,0,228,7616,7699,83,1
21389ref,8907,9138,JUNC00000198,1,+,8907,9138,255;0;0,2,8,141,0,90,8915,8997,82,1
21389ref,8978,9335,JUNC00000202,13,+,8978,9335,255;0;0,2,142,138,0,219,9120,9197,77,1
21389ref,1630,1973,JUNC00000055,20,-,1630,1973,255;0;0,2,121,147,0,196,1751,1826,75,1
21389ref,8340,8574,JUNC00000188,6,+,8340,8574,255;0;0,2,54,105,0,129,8394,8469,75,1
21389ref,720,945,JUNC00000015,1,+,720,945,255;0;0,2,18,133,0,92,738,812,74,1
21389ref,10324,10549,JUNC00000216,1,-,10324,10549,255;0;0,2,21,130,0,95,10345,10419,74,1
21389ref,1799,2031,JUNC00000058,3,-,1799,2031,255;0;0,2,16,146,0,86,1815,1885,70,1
21389ref,1758,2026,JUNC00000059,6,-,1758,2026,255;0;0,2,68,131,0,137,1826,1895,69,1
21389ref,9024,9316,JUNC00000201,9,+,9024,9316,255;0;0,2,96,128,0,164,9120,9188,68,1
21389ref,7449,7700,JUNC00000163,4,+,7449,7700,255;0;0,2,36,149,0,102,7485,7551,66,1
21389ref,7347,7699,JUNC00000165,7,+,7347,7699,255;0;0,2,147,139,0,213,7494,7560,66,1
21389ref,2861,3167,JUNC00000096,3,-,2861,3167,255;0;0,2,95,146,0,160,2956,3021,65,1
21389ref,8291,8613,JUNC00000192,97,+,8291,8613,255;0;0,2,147,112,0,210,8438,8501,63,1
21389ref,2920,3132,JUNC00000100,1,+,2920,3132,255;0;0,2,127,24,0,188,3047,3108,61,1
21389ref,952,1208,JUNC00000031,15,-,952,1208,255;0;0,2,147,50,0,206,1099,1158,59,1
21389ref,4671,4968,JUNC00000127,3,-,4671,4968,255;0;0,2,95,143,0,154,4766,4825,59,1
21389ref,524,770,JUNC00000008,6,-,524,770,255;0;0,2,47,141,0,105,571,629,58,1
21389ref,4444,4694,JUNC00000119,16,-,4444,4694,255;0;0,2,53,139,0,111,4497,4555,58,1
21389ref,4800,5013,JUNC00000129,3,-,4800,5013,255;0;0,2,107,48,0,165,4907,4965,58,1
21389ref,9036,9245,JUNC00000207,1,+,9036,9245,255;0;0,2,143,8,0,201,9179,9237,58,1
21389ref,953,1307,JUNC00000032,1294,-,953,1307,255;0;0,2,148,149,0,205,1101,1158,57,1
21389ref,5886,6094,JUNC00000146,1,+,5886,6094,255;0;0,2,79,72,0,136,5965,6022,57,1
21389ref,9090,9302,JUNC00000208,7,+,9090,9302,255;0;0,2,147,8,0,204,9237,9294,57,1
21389ref,5589,5895,JUNC00000140,3,+,5589,5895,255;0;0,2,103,147,0,159,5692,5748,56,1
21389ref,2904,3164,JUNC00000099,3,+,2904,3164,255;0;0,2,127,78,0,182,3031,3086,55,1
21389ref,1725,2060,JUNC00000063,18,-,1725,2060,255;0;0,2,135,146,0,189,1860,1914,54,1
21389ref,6003,6236,JUNC00000149,4,-,6003,6236,255;0;0,2,141,38,0,195,6144,6198,54,1
21389ref,529,733,JUNC00000011,1,-,529,733,255;0;0,2,74,77,0,127,603,656,53,1
21389ref,825,1171,JUNC00000023,52,+,825,1171,255;0;0,2,144,149,0,197,969,1022,53,1
21389ref,1658,1870,JUNC00000056,2,+,1658,1870,255;0;0,2,135,24,0,188,1793,1846,53,1
21389ref,4249,4458,JUNC00000114,5,+,4249,4458,255;0;0,2,8,148,0,61,4257,4310,53,1
21389ref,7936,8159,JUNC00000185,2,-,7936,8159,255;0;0,2,20,150,0,73,7956,8009,53,1
21389ref,1803,2006,JUNC00000062,3,-,1803,2006,255;0;0,2,57,94,0,109,1860,1912,52,1
21389ref,6804,7154,JUNC00000157,4,+,6804,7154,255;0;0,2,150,148,0,202,6954,7006,52,1
21389ref,7502,7772,JUNC00000170,4,-,7502,7772,255;0;0,2,147,71,0,199,7649,7701,52,1
21389ref,7726,8064,JUNC00000181,28,-,7726,8064,255;0;0,2,140,148,0,190,7866,7916,50,1
21389ref,2560,2639,JUNC00000081,1,+,2560,2639,255;0;0,2,20,10,0,69,2580,2629,49,1
21389ref,6370,6568,JUNC00000155,1,+,6370,6568,255;0;0,2,74,77,0,121,6444,6491,47,1
21389ref,621,890,JUNC00000016,2,-,621,890,255;0;0,2,123,105,0,164,744,785,41,1
21389ref,1917,2107,JUNC00000069,1,-,1917,2107,255;0;0,2,130,21,0,169,2047,2086,39,1
21389ref,9003,9341,JUNC00000204,5,+,9003,9341,255;0;0,2,150,150,0,188,9153,9191,38,1
21389ref,7520,7778,JUNC00000171,5,+,7520,7778,255;0;0,2,140,82,0,176,7660,7696,36,1
21389ref,9925,10112,JUNC00000214,1,-,9925,10112,255;0;0,2,25,126,0,61,9950,9986,36,1
21389ref,2449,2782,JUNC00000083,1183,-,2449,2782,255;0;0,2,149,149,0,184,2598,2633,35,1
21389ref,2802,3130,JUNC00000095,8,-,2802,3130,255;0;0,2,147,146,0,182,2949,2984,35,1
21389ref,2983,3169,JUNC00000098,1,+,2983,3169,255;0;0,2,29,122,0,64,3012,3047,35,1
21389ref,4028,4241,JUNC00000109,9,-,4028,4241,255;0;0,2,28,150,0,63,4056,4091,35,1
21389ref,7924,8128,JUNC00000184,2,-,7924,8128,255;0;0,2,20,150,0,54,7944,7978,34,1
21389ref,946,1276,JUNC00000030,4,+,946,1276,255;0;0,2,149,148,0,182,1095,1128,33,1
21389ref,4724,4941,JUNC00000126,2,+,4724,4941,255;0;0,2,41,143,0,74,4765,4798,33,1
21389ref,5451,5780,JUNC00000137,182,-,5451,5780,255;0;0,2,149,147,0,182,5600,5633,33,1
21389ref,4848,5139,JUNC00000130,34,+,4848,5139,255;0;0,2,111,148,0,143,4959,4991,32,1
21389ref,7556,7773,JUNC00000168,5,-,7556,7773,255;0;0,2,37,148,0,69,7593,7625,32,1
21389ref,174,398,JUNC00000002,377,+,174,398,255;0;0,2,150,43,0,181,324,355,31,1
21389ref,5834,6156,JUNC00000147,2,+,5834,6156,255;0;0,2,142,149,0,173,5976,6007,31,1
21389ref,4232,4413,JUNC00000116,1,-,4232,4413,255;0;0,2,120,31,0,150,4352,4382,30,1
21389ref,4230,4437,JUNC00000117,29,+,4230,4437,255;0;0,2,145,32,0,175,4375,4405,30,1
21389ref,6101,6426,JUNC00000152,6,+,6101,6426,255;0;0,2,148,149,0,176,6249,6277,28,1
21389ref,3134,3433,JUNC00000104,79,-,3134,3433,255;0;0,2,123,149,0,150,3257,3284,27,1
21389ref,7386,7681,JUNC00000166,3,-,7386,7681,255;0;0,2,144,125,0,170,7530,7556,26,1
21389ref,9238,9298,JUNC00000210,1,-,9238,9298,255;0;0,2,24,10,0,50,9262,9288,26,1
21389ref,3023,3212,JUNC00000102,126,+,3023,3212,255;0;0,2,148,16,0,173,3171,3196,25,1
21389ref,5596,5777,JUNC00000138,524,-,5596,5777,255;0;0,2,8,149,0,32,5604,5628,24,1
21389ref,7696,8011,JUNC00000180,2,+,7696,8011,255;0;0,2,144,147,0,168,7840,7864,24,1
21389ref,4540,4862,JUNC00000121,7,+,4540,4862,255;0;0,2,149,150,0,172,4689,4712,23,1
21389ref,2434,2753,JUNC00000082,3,+,2434,2753,255;0;0,2,150,147,0,172,2584,2606,22,1
21389ref,6098,6289,JUNC00000151,3,+,6098,6289,255;0;0,2,149,20,0,171,6247,6269,22,1
21389ref,6107,6286,JUNC00000153,10,+,6107,6286,255;0;0,2,148,9,0,170,6255,6277,22,1
21389ref,8949,9173,JUNC00000200,2719,+,8949,9173,255;0;0,2,53,149,0,75,9002,9024,22,1
21389ref,7797,7969,JUNC00000177,1,-,7797,7969,255;0;0,2,9,142,0,30,7806,7827,21,1
21389ref,2179,2374,JUNC00000073,7,+,2179,2374,255;0;0,2,148,27,0,168,2327,2347,20,1
21389ref,5927,6191,JUNC00000148,4,-,5927,6191,255;0;0,2,95,149,0,115,6022,6042,20,1
21389ref,2445,2598,JUNC00000075,7,-,2445,2598,255;0;0,2,19,115,0,38,2464,2483,19,1
21389ref,1772,1941,JUNC00000064,3,-,1772,1941,255;0;0,2,124,27,0,142,1896,1914,18,1
21389ref,4680,4907,JUNC00000125,3,+,4680,4907,255;0;0,2,85,124,0,103,4765,4783,18,1
21389ref,2668,2856,JUNC00000090,5,-,2668,2856,255;0;0,2,148,24,0,164,2816,2832,16,1
21389ref,2465,2729,JUNC00000084,4,+,2465,2729,255;0;0,2,149,100,0,164,2614,2629,15,1
21389ref,8987,9298,JUNC00000203,10,+,8987,9298,255;0;0,2,149,147,0,164,9136,9151,15,1
21389ref,9007,9321,JUNC00000205,13,+,9007,9321,255;0;0,2,149,150,0,164,9156,9171,15,1
21389ref,4249,4417,JUNC00000113,14,+,4249,4417,255;0;0,2,8,146,0,22,4257,4271,14,1
21389ref,8294,8606,JUNC00000193,8,+,8294,8606,255;0;0,2,150,148,0,164,8444,8458,14,1
21389ref,329,639,JUNC00000003,5,+,329,639,255;0;0,2,148,149,0,161,477,490,13,1
21389ref,2445,2609,JUNC00000079,1,+,2445,2609,255;0;0,2,120,31,0,133,2565,2578,13,1
21389ref,5705,5991,JUNC00000142,7,+,5705,5991,255;0;0,2,136,137,0,149,5841,5854,13,1
21389ref,9993,10164,JUNC00000215,4,-,9993,10164,255;0;0,2,149,9,0,162,10142,10155,13,1
21389ref,2112,2296,JUNC00000071,7,+,2112,2296,255;0;0,2,24,149,0,35,2136,2147,11,1
21389ref,3960,4267,JUNC00000112,4,-,3960,4267,255;0;0,2,147,149,0,158,4107,4118,11,1
21389ref,8784,9054,JUNC00000197,3,-,8784,9054,255;0;0,2,122,137,0,133,8906,8917,11,1
21389ref,9030,9196,JUNC00000206,6,+,9030,9196,255;0;0,2,149,8,0,158,9179,9188,9,1
21389ref,1003,1307,JUNC00000039,1070,-,1003,1307,255;0;0,2,147,149,0,155,1150,1158,8,1
21389ref,824,1126,JUNC00000022,1664,+,824,1126,255;0;0,2,145,150,0,152,969,976,7,1
21389ref,1289,1590,JUNC00000048,5,-,1289,1590,255;0;0,2,149,145,0,156,1438,1445,7,1
21389ref,5017,5251,JUNC00000133,20,+,5017,5251,255;0;0,2,147,80,0,154,5164,5171,7,1
21389ref,7540,7845,JUNC00000173,3,+,7540,7845,255;0;0,2,149,149,0,156,7689,7696,7,1
21389ref,8307,8466,JUNC00000190,18,+,8307,8466,255;0;0,2,124,28,0,131,8431,8438,7,1
21389ref,973,1273,JUNC00000033,35,+,973,1273,255;0;0,2,149,145,0,155,1122,1128,6,1
21389ref,1819,1994,JUNC00000061,7,+,1819,1994,255;0;0,2,21,148,0,27,1840,1846,6,1
21389ref,5760,5953,JUNC00000144,2,+,5760,5953,255;0;0,2,118,69,0,124,5878,5884,6,1
21389ref,9402,9704,JUNC00000212,2,+,9402,9704,255;0;0,2,148,148,0,154,9550,9556,6,1
21389ref,7426,7607,JUNC00000167,6,-,7426,7607,255;0;0,2,147,29,0,152,7573,7578,5,1
21389ref,8777,9078,JUNC00000199,27940,+,8777,9078,255;0;0,2,146,150,0,151,8923,8928,5,1
24564ref,2691,9640,JUNC00000041,7,+,2691,9640,255;0;0,2,150,101,0,6848,2841,9539,6698,1
24564ref,3887,9676,JUNC00000047,9,+,3887,9676,255;0;0,2,25,148,0,5641,3912,9528,5616,1
24564ref,4321,9089,JUNC00000055,1,+,4321,9089,255;0;0,2,59,92,0,4676,4380,8997,4617,1
24564ref,1630,6454,JUNC00000024,460,-,1630,6454,255;0;0,2,121,150,0,4674,1751,6304,4553,1
24564ref,5699,9830,JUNC00000060,2,+,5699,9830,255;0;0,2,20,148,0,3983,5719,9682,3963,1
24564ref,2696,6434,JUNC00000037,1,-,2696,6434,255;0;0,2,55,96,0,3642,2751,6338,3587,1
24564ref,2652,6093,JUNC00000038,640,+,2652,6093,255;0;0,2,119,150,0,3291,2771,5943,3172,1
24564ref,5166,8183,JUNC00000058,47,-,5166,8183,255;0;0,2,91,150,0,2867,5257,8033,2776,1
24564ref,687,2127,JUNC00000005,112,+,687,2127,255;0;0,2,145,146,0,1294,832,1981,1149,1
24564ref,6111,6562,JUNC00000066,1,+,6111,6562,255;0;0,2,70,81,0,370,6181,6481,300,1
24564ref,1262,1759,JUNC00000019,5,+,1262,1759,255;0;0,2,58,148,0,349,1320,1611,291,1
24564ref,1382,1876,JUNC00000020,69,+,1382,1876,255;0;0,2,83,144,0,350,1465,1732,267,1
24564ref,8647,9180,JUNC00000084,152,+,8647,9180,255;0;0,2,150,143,0,390,8797,9037,240,1
24564ref,3987,4447,JUNC00000050,289,+,3987,4447,255;0;0,2,133,124,0,336,4120,4323,203,1
24564ref,384,850,JUNC00000002,510,+,384,850,255;0;0,2,150,120,0,346,534,730,196,1
24564ref,8772,9232,JUNC00000085,378,+,8772,9232,255;0;0,2,149,149,0,311,8921,9083,162,1
24564ref,7406,7848,JUNC00000073,103,+,7406,7848,255;0;0,2,148,149,0,293,7554,7699,145,1
24564ref,7244,7505,JUNC00000069,2,+,7244,7505,255;0;0,2,47,72,0,189,7291,7433,142,1
24564ref,3960,4388,JUNC00000049,12,-,3960,4388,255;0;0,2,147,148,0,280,4107,4240,133,1
24564ref,1124,1552,JUNC00000018,965,+,1124,1552,255;0;0,2,146,150,0,278,1270,1402,132,1
24564ref,1536,1911,JUNC00000022,12,+,1536,1911,255;0;0,2,150,96,0,279,1686,1815,129,1
24564ref,3711,4134,JUNC00000045,30,-,3711,4134,255;0;0,2,148,150,0,273,3859,3984,125,1
24564ref,1803,2041,JUNC00000025,4,-,1803,2041,255;0;0,2,23,129,0,109,1826,1912,86,1
24564ref,2660,2965,JUNC00000036,71,-,2660,2965,255;0;0,2,70,149,0,156,2730,2816,86,1
24564ref,8884,9123,JUNC00000087,15,+,8884,9123,255;0;0,2,146,8,0,231,9030,9115,85,1
24564ref,5956,6208,JUNC00000065,36,+,5956,6208,255;0;0,2,149,27,0,225,6105,6181,76,1
24564ref,1607,1976,JUNC00000023,779,-,1607,1976,255;0;0,2,144,150,0,219,1751,1826,75,1
24564ref,585,873,JUNC00000003,196,+,585,873,255;0;0,2,71,143,0,145,656,730,74,1
24564ref,2607,2734,JUNC00000035,1,-,2607,2734,255;0;0,2,9,44,0,83,2616,2690,74,1
24564ref,239,578,JUNC00000001,4,+,239,578,255;0;0,2,118,150,0,189,357,428,71,1
24564ref,2911,3075,JUNC00000042,1,-,2911,3075,255;0;0,2,61,33,0,131,2972,3042,70,1
24564ref,3900,4136,JUNC00000048,22,+,3900,4136,255;0;0,2,24,147,0,89,3924,3989,65,1
24564ref,973,1305,JUNC00000012,12,-,973,1305,255;0;0,2,126,147,0,185,1099,1158,59,1
24564ref,4423,4674,JUNC00000057,210,-,4423,4674,255;0;0,2,74,119,0,132,4497,4555,58,1
24564ref,8373,8582,JUNC00000083,1,+,8373,8582,255;0;0,2,115,36,0,173,8488,8546,58,1
24564ref,955,1307,JUNC00000013,922,-,955,1307,255;0;0,2,146,149,0,203,1101,1158,57,1
24564ref,7726,7956,JUNC00000077,2,-,7726,7956,255;0;0,2,26,150,0,80,7752,7806,54,1
24564ref,7953,8166,JUNC00000079,175,+,7953,8166,255;0;0,2,9,150,0,63,7962,8016,54,1
24564ref,923,1171,JUNC00000010,26,+,923,1171,255;0;0,2,46,149,0,99,969,1022,53,1
24564ref,1716,1964,JUNC00000026,2,-,1716,1964,255;0;0,2,144,52,0,196,1860,1912,52,1
24564ref,4388,4646,JUNC00000056,57,-,4388,4646,255;0;0,2,67,149,0,109,4455,4497,42,1
24564ref,7344,7573,JUNC00000071,21,-,7344,7573,255;0;0,2,37,150,0,79,7381,7423,42,1
24564ref,9017,9212,JUNC00000089,5,+,9017,9212,255;0;0,2,145,8,0,187,9162,9204,42,1
24564ref,9858,10145,JUNC00000091,5,-,9858,10145,255;0;0,2,95,150,0,137,9953,9995,42,1
24564ref,599,878,JUNC00000004,77,-,599,878,255;0;0,2,145,93,0,186,744,785,41,1
24564ref,3300,3439,JUNC00000044,2,+,3300,3439,255;0;0,2,53,45,0,94,3353,3394,41,1
24564ref,7966,8303,JUNC00000080,7,-,7966,8303,255;0;0,2,149,147,0,190,8115,8156,41,1
24564ref,950,1289,JUNC00000011,15,-,950,1289,255;0;0,2,149,150,0,189,1099,1139,40,1
24564ref,5589,5924,JUNC00000061,91,+,5589,5924,255;0;0,2,147,149,0,186,5736,5775,39,1
24564ref,7512,7849,JUNC00000075,48,+,7512,7849,255;0;0,2,148,150,0,187,7660,7699,39,1
24564ref,8427,8630,JUNC00000082,69,+,8427,8630,255;0;0,2,19,146,0,57,8446,8484,38,1
24564ref,2238,2572,JUNC00000030,24,-,2238,2572,255;0;0,2,150,148,0,186,2388,2424,36,1
24564ref,7512,7705,JUNC00000074,3,+,7512,7705,255;0;0,2,148,9,0,184,7660,7696,36,1
24564ref,5826,6157,JUNC00000064,8,+,5826,6157,255;0;0,2,150,150,0,181,5976,6007,31,1
24564ref,980,1167,JUNC00000016,52,-,980,1167,255;0;0,2,148,9,0,178,1128,1158,30,1
24564ref,4254,4531,JUNC00000054,188,-,4254,4531,255;0;0,2,98,149,0,128,4352,4382,30,1
24564ref,773,1097,JUNC00000008,2,+,773,1097,255;0;0,2,148,148,0,176,921,949,28,1
24564ref,8148,8327,JUNC00000081,1,+,8148,8327,255;0;0,2,132,19,0,160,8280,8308,28,1
24564ref,10060,10239,JUNC00000093,1,+,10060,10239,255;0;0,2,104,47,0,132,10164,10192,28,1
24564ref,3234,3428,JUNC00000043,5,-,3234,3428,255;0;0,2,23,144,0,50,3257,3284,27,1
24564ref,7703,7899,JUNC00000078,4,-,7703,7899,255;0;0,2,145,24,0,172,7848,7875,27,1
24564ref,7382,7606,JUNC00000072,23,-,7382,7606,255;0;0,2,148,50,0,174,7530,7556,26,1
24564ref,699,1019,JUNC00000006,87,+,699,1019,255;0;0,2,147,148,0,172,846,871,25,1
24564ref,5535,5718,JUNC00000059,44,+,5535,5718,255;0;0,2,8,150,0,33,5543,5568,25,1
24564ref,6970,7275,JUNC00000068,9,-,6970,7275,255;0;0,2,131,149,0,156,7101,7126,25,1
24564ref,3720,4041,JUNC00000046,5640,+,3720,4041,255;0;0,2,150,147,0,174,3870,3894,24,1
24564ref,9513,9734,JUNC00000090,4,+,9513,9734,255;0;0,2,51,147,0,74,9564,9587,23,1
24564ref,1857,2172,JUNC00000027,15,+,1857,2172,255;0;0,2,150,143,0,172,2007,2029,22,1
24564ref,4089,4411,JUNC00000052,2,-,4089,4411,255;0;0,2,150,150,0,172,4239,4261,22,1
24564ref,7357,7535,JUNC00000070,4,-,7357,7535,255;0;0,2,8,148,0,30,7365,7387,22,1
24564ref,2240,2556,JUNC00000029,9,+,2240,2556,255;0;0,2,148,149,0,167,2388,2407,19,1
24564ref,4089,4407,JUNC00000051,24,-,4089,4407,255;0;0,2,150,150,0,168,4239,4257,18,1
24564ref,1675,1846,JUNC00000021,2,-,1675,1846,255;0;0,2,8,147,0,24,1683,1699,16,1
24564ref,2671,2980,JUNC00000039,35,-,2671,2980,255;0;0,2,145,148,0,161,2816,2832,16,1
24564ref,2333,2637,JUNC00000032,3,+,2333,2637,255;0;0,2,142,147,0,157,2475,2490,15,1
24564ref,2438,2746,JUNC00000033,10,+,2438,2746,255;0;0,2,146,147,0,161,2584,2599,15,1
24564ref,2449,2763,JUNC00000034,19,+,2449,2763,255;0;0,2,149,150,0,164,2598,2613,15,1
24564ref,9994,10160,JUNC00000092,1,+,9994,10160,255;0;0,2,143,8,0,158,10137,10152,15,1
24564ref,1987,2300,JUNC00000028,3,+,1987,2300,255;0;0,2,149,150,0,163,2136,2150,14,1
24564ref,4183,4418,JUNC00000053,27,+,4183,4418,255;0;0,2,74,147,0,88,4257,4271,14,1
24564ref,2771,2981,JUNC00000040,27,-,2771,2981,255;0;0,2,49,149,0,61,2820,2832,12,1
24564ref,1003,1307,JUNC00000017,62,-,1003,1307,255;0;0,2,147,149,0,155,1150,1158,8,1
24564ref,5783,6086,JUNC00000063,64,-,5783,6086,255;0;0,2,150,145,0,158,5933,5941,8,1
24564ref,6107,6409,JUNC00000067,3,-,6107,6409,255;0;0,2,148,146,0,156,6255,6263,8,1
24564ref,825,1125,JUNC00000009,27,+,825,1125,255;0;0,2,144,149,0,151,969,976,7,1
24564ref,7539,7845,JUNC00000076,6,+,7539,7845,255;0;0,2,150,149,0,157,7689,7696,7,1
24564ref,965,1269,JUNC00000014,3,+,965,1269,255;0;0,2,149,149,0,155,1114,1120,6,1
24564ref,975,1275,JUNC00000015,8,+,975,1275,255;0;0,2,147,147,0,153,1122,1128,6,1
24564ref,5783,5999,JUNC00000062,36,-,5783,5999,255;0;0,2,150,60,0,156,5933,5939,6,1
24564ref,8952,9127,JUNC00000088,22,-,8952,9127,255;0;0,2,150,19,0,156,9102,9108,6,1
24564ref,761,1009,JUNC00000007,100,-,761,1009,255;0;0,2,94,149,0,99,855,860,5,1
24564ref,2372,2560,JUNC00000031,24,-,2372,2560,255;0;0,2,34,149,0,39,2406,2411,5,1
24564ref,8796,9078,JUNC00000086,1673,+,8796,9078,255;0;0,2,127,150,0,132,8923,8928,5,1
19966ref,696,9561,JUNC00000033,18,+,696,9561,255;0;0,2,147,150,0,8715,843,9411,8568,1
19966ref,2695,9698,JUNC00000118,215,-,2695,9698,255;0;0,2,107,43,0,6960,2802,9655,6853,1
19966ref,1075,7552,JUNC00000052,8,-,1075,7552,255;0;0,2,149,8,0,6469,1224,7544,6320,1
19966ref,975,7032,JUNC00000048,124,+,975,7032,255;0;0,2,147,49,0,6008,1122,6983,5861,1
19966ref,743,6678,JUNC00000031,48,+,743,6678,255;0;0,2,50,142,0,5793,793,6536,5743,1
19966ref,2784,8036,JUNC00000128,401,+,2784,8036,255;0;0,2,135,114,0,5138,2919,7922,5003,1
19966ref,5167,10185,JUNC00000194,1,-,5167,10185,255;0;0,2,108,43,0,4975,5275,10142,4867,1
19966ref,1456,6237,JUNC00000063,19,+,1456,6237,255;0;0,2,68,100,0,4681,1524,6137,4613,1
19966ref,4158,9029,JUNC00000165,21,+,4158,9029,255;0;0,2,147,149,0,4722,4305,8880,4575,1
19966ref,4088,8924,JUNC00000160,113,+,4088,8924,255;0;0,2,139,149,0,4687,4227,8775,4548,1
19966ref,5230,9856,JUNC00000195,86,+,5230,9856,255;0;0,2,94,142,0,4484,5324,9714,4390,1
19966ref,862,4914,JUNC00000040,42,+,862,4914,255;0;0,2,129,149,0,3903,991,4765,3774,1
19966ref,746,4481,JUNC00000028,50,+,746,4481,255;0;0,2,37,46,0,3689,783,4435,3652,1
19966ref,2699,6488,JUNC00000117,5,-,2699,6488,255;0;0,2,52,150,0,3639,2751,6338,3587,1
19966ref,1953,5608,JUNC00000075,401,+,1953,5608,255;0;0,2,114,137,0,3518,2067,5471,3404,1
19966ref,6537,10119,JUNC00000229,300,+,6537,10119,255;0;0,2,54,149,0,3433,6591,9970,3379,1
19966ref,2537,6027,JUNC00000101,32,+,2537,6027,255;0;0,2,41,133,0,3357,2578,5894,3316,1
19966ref,5854,9078,JUNC00000216,31,+,5854,9078,255;0;0,2,108,150,0,3074,5962,8928,2966,1
19966ref,5962,9092,JUNC00000219,4,+,5962,9092,255;0;0,2,29,150,0,2980,5991,8942,2951,1
19966ref,4925,8069,JUNC00000188,74,+,4925,8069,255;0;0,2,75,147,0,2997,5000,7922,2922,1
19966ref,4519,7714,JUNC00000178,2,+,4519,7714,255;0;0,2,148,149,0,3046,4667,7565,2898,1
19966ref,4188,7202,JUNC00000159,18,-,4188,7202,255;0;0,2,39,150,0,2864,4227,7052,2825,1
19966ref,7531,10119,JUNC00000268,10,+,7531,10119,255;0;0,2,147,149,0,2439,7678,9970,2292,1
19966ref,7549,10137,JUNC00000272,11,+,7549,10137,255;0;0,2,150,146,0,2442,7699,9991,2292,1
19966ref,3762,6289,JUNC00000145,37,+,3762,6289,255;0;0,2,140,108,0,2419,3902,6181,2279,1
19966ref,5771,7544,JUNC00000210,18,-,5771,7544,255;0;0,2,59,148,0,1625,5830,7396,1566,1
19966ref,6156,7734,JUNC00000227,198,+,6156,7734,255;0;0,2,149,149,0,1429,6305,7585,1280,1
19966ref,4987,6288,JUNC00000189,113,-,4987,6288,255;0;0,2,143,144,0,1157,5130,6144,1014,1
19966ref,1382,2621,JUNC00000065,83,+,1382,2621,255;0;0,2,150,150,0,1089,1532,2471,939,1
19966ref,6985,8064,JUNC00000246,34,-,6985,8064,255;0;0,2,143,148,0,931,7128,7916,788,1
19966ref,8552,9176,JUNC00000298,1,+,8552,9176,255;0;0,2,122,28,0,596,8674,9148,474,1
19966ref,488,1133,JUNC00000003,13,+,488,1133,255;0;0,2,58,131,0,514,546,1002,456,1
19966ref,8602,9321,JUNC00000299,32,-,8602,9321,255;0;0,2,145,140,0,579,8747,9181,434,1
19966ref,7711,8430,JUNC00000278,5810,-,7711,8430,255;0;0,2,146,148,0,571,7857,8282,425,1
19966ref,6926,7536,JUNC00000244,68,+,6926,7536,255;0;0,2,147,42,0,568,7073,7494,421,1
19966ref,7159,7737,JUNC00000250,160,+,7159,7737,255;0;0,2,8,149,0,429,7167,7588,421,1
19966ref,548,1125,JUNC00000008,13,+,548,1125,255;0;0,2,60,140,0,437,608,985,377,1
19966ref,1123,1694,JUNC00000055,82,+,1123,1694,255;0;0,2,147,53,0,518,1270,1641,371,1
19966ref,1275,1806,JUNC00000057,81,+,1275,1806,255;0;0,2,33,128,0,403,1308,1678,370,1
19966ref,6934,7459,JUNC00000243,2,-,6934,7459,255;0;0,2,122,41,0,484,7056,7418,362,1
19966ref,5381,5896,JUNC00000197,74,+,5381,5896,255;0;0,2,37,148,0,367,5418,5748,330,1
19966ref,6484,7108,JUNC00000230,33,-,6484,7108,255;0;0,2,148,149,0,475,6632,6959,327,1
19966ref,4130,4590,JUNC00000162,1,-,4130,4590,255;0;0,2,116,35,0,425,4246,4555,309,1
19966ref,8727,9173,JUNC00000300,1,+,8727,9173,255;0;0,2,114,36,0,410,8841,9137,296,1
19966ref,5957,6550,JUNC00000223,10,+,5957,6550,255;0;0,2,148,150,0,443,6105,6400,295,1
19966ref,6021,6544,JUNC00000224,205,-,6021,6544,255;0;0,2,105,125,0,398,6126,6419,293,1
19966ref,701,1129,JUNC00000023,8,+,701,1129,255;0;0,2,37,114,0,314,738,1015,277,1
19966ref,3788,4237,JUNC00000140,708,+,3788,4237,255;0;0,2,46,149,0,300,3834,4088,254,1
19966ref,9604,10137,JUNC00000314,7,+,9604,10137,255;0;0,2,145,144,0,389,9749,9993,244,1
19966ref,4662,5193,JUNC00000180,115,+,4662,5193,255;0;0,2,147,143,0,388,4809,5050,241,1
19966ref,5644,6062,JUNC00000203,96,+,5644,6062,255;0;0,2,55,125,0,293,5699,5937,238,1
19966ref,8532,9044,JUNC00000297,43,+,8532,9044,255;0;0,2,142,142,0,370,8674,8902,228,1
19966ref,4716,5236,JUNC00000182,17,-,4716,5236,255;0;0,2,147,149,0,371,4863,5087,224,1
19966ref,9830,10205,JUNC00000323,11,-,9830,10205,255;0;0,2,144,8,0,367,9974,10197,223,1
19966ref,6004,6374,JUNC00000220,37,+,6004,6374,255;0;0,2,8,143,0,227,6012,6231,219,1
19966ref,569,976,JUNC00000011,22,+,569,976,255;0;0,2,44,150,0,257,613,826,213,1
19966ref,5680,6190,JUNC00000209,59,+,5680,6190,255;0;0,2,150,149,0,361,5830,6041,211,1
19966ref,1565,2072,JUNC00000068,4,+,1565,2072,255;0;0,2,148,149,0,358,1713,1923,210,1
19966ref,1006,1371,JUNC00000051,29,-,1006,1371,255;0;0,2,148,8,0,357,1154,1363,209,1
19966ref,549,1008,JUNC00000012,15,-,549,1008,255;0;0,2,103,148,0,311,652,860,208,1
19966ref,7412,7772,JUNC00000258,3,-,7412,7772,255;0;0,2,24,145,0,215,7436,7627,191,1
19966ref,3843,4332,JUNC00000150,109,+,3843,4332,255;0;0,2,150,149,0,340,3993,4183,190,1
19966ref,1294,1641,JUNC00000061,22,+,1294,1641,255;0;0,2,144,23,0,324,1438,1618,180,1
19966ref,7274,7746,JUNC00000257,4,+,7274,7746,255;0;0,2,147,146,0,326,7421,7600,179,1
19966ref,7540,8013,JUNC00000270,11,+,7540,8013,255;0;0,2,149,149,0,324,7689,7864,175,1
19966ref,2172,2642,JUNC00000080,52,-,2172,2642,255;0;0,2,147,149,0,321,2319,2493,174,1
19966ref,2215,2644,JUNC00000081,95,+,2215,2644,255;0;0,2,112,143,0,286,2327,2501,174,1
19966ref,7551,8018,JUNC00000271,131,+,7551,8018,255;0;0,2,148,145,0,322,7699,7873,174,1
19966ref,8413,8750,JUNC00000293,37,+,8413,8750,255;0;0,2,25,144,0,193,8438,8606,168,1
19966ref,560,1025,JUNC00000021,14,+,560,1025,255;0;0,2,150,150,0,315,710,875,165,1
19966ref,7054,7516,JUNC00000252,20,+,7054,7516,255;0;0,2,149,150,0,312,7203,7366,163,1
19966ref,7685,8141,JUNC00000276,10,+,7685,8141,255;0;0,2,147,147,0,309,7832,7994,162,1
19966ref,2505,2956,JUNC00000113,10,+,2505,2956,255;0;0,2,147,145,0,306,2652,2811,159,1
19966ref,7585,8038,JUNC00000273,52,+,7585,8038,255;0;0,2,148,150,0,303,7733,7888,155,1
19966ref,653,1013,JUNC00000020,25,+,653,1013,255;0;0,2,57,149,0,211,710,864,154,1
19966ref,571,1019,JUNC00000022,68,+,571,1019,255;0;0,2,146,148,0,300,717,871,154,1
19966ref,8400,8743,JUNC00000295,25,+,8400,8743,255;0;0,2,46,143,0,200,8446,8600,154,1
19966ref,2345,2791,JUNC00000092,12,+,2345,2791,255;0;0,2,146,147,0,299,2491,2644,153,1
19966ref,8290,8625,JUNC00000292,469,+,8290,8625,255;0;0,2,148,38,0,297,8438,8587,149,1
19966ref,9693,10128,JUNC00000316,57,-,9693,10128,255;0;0,2,143,148,0,287,9836,9980,144,1
19966ref,2654,2988,JUNC00000116,65,+,2654,2988,255;0;0,2,43,148,0,186,2697,2840,143,1
19966ref,743,963,JUNC00000030,13,+,743,963,255;0;0,2,50,28,0,192,793,935,142,1
19966ref,2342,2779,JUNC00000091,14,+,2342,2779,255;0;0,2,149,150,0,287,2491,2629,138,1
19966ref,2358,2784,JUNC00000097,12,+,2358,2784,255;0;0,2,143,146,0,280,2501,2638,137,1
19966ref,2353,2784,JUNC00000096,6,+,2353,2784,255;0;0,2,148,148,0,283,2501,2636,135,1
19966ref,4380,4814,JUNC00000175,10,+,4380,4814,255;0;0,2,149,150,0,284,4529,4664,135,1
19966ref,4395,4769,JUNC00000176,30,-,4395,4769,255;0;0,2,144,95,0,279,4539,4674,135,1
19966ref,4062,4389,JUNC00000155,21,-,4062,4389,255;0;0,2,45,149,0,178,4107,4240,133,1
19966ref,1123,1549,JUNC00000054,39,+,1123,1549,255;0;0,2,147,147,0,279,1270,1402,132,1
19966ref,3507,3831,JUNC00000135,43,-,3507,3831,255;0;0,2,147,46,0,278,3654,3785,131,1
19966ref,3820,4171,JUNC00000144,61,+,3820,4171,255;0;0,2,74,146,0,205,3894,4025,131,1
19966ref,2377,2777,JUNC00000095,17,+,2377,2777,255;0;0,2,124,148,0,252,2501,2629,128,1
19966ref,538,836,JUNC00000007,22,+,538,836,255;0;0,2,24,148,0,150,562,688,126,1
19966ref,2459,2750,JUNC00000089,6,+,2459,2750,255;0;0,2,22,147,0,144,2481,2603,122,1
19966ref,691,937,JUNC00000026,3,-,691,937,255;0;0,2,66,59,0,187,757,878,121,1
19966ref,8841,9258,JUNC00000303,29,+,8841,9258,255;0;0,2,147,150,0,267,8988,9108,120,1
19966ref,8841,9258,JUNC00000304,29,+,8841,9258,255;0;0,2,149,150,0,267,8990,9108,118,1
19966ref,2344,2756,JUNC00000094,5,+,2344,2756,255;0;0,2,149,150,0,262,2493,2606,113,1
19966ref,2342,2753,JUNC00000090,10,+,2342,2753,255;0;0,2,149,150,0,261,2491,2603,112,1
19966ref,4150,4562,JUNC00000164,7,-,4150,4562,255;0;0,2,150,150,0,262,4300,4412,112,1
19966ref,4179,4575,JUNC00000166,138,+,4179,4575,255;0;0,2,144,140,0,256,4323,4435,112,1
19966ref,5226,5544,JUNC00000196,4,+,5226,5544,255;0;0,2,150,56,0,262,5376,5488,112,1
19966ref,3968,4372,JUNC00000157,88,-,3968,4372,255;0;0,2,149,150,0,254,4117,4222,105,1
19966ref,3856,4135,JUNC00000143,20,+,3856,4135,255;0;0,2,26,149,0,130,3882,3986,104,1
19966ref,5435,5792,JUNC00000199,334,-,5435,5792,255;0;0,2,104,149,0,208,5539,5643,104,1
19966ref,8932,9333,JUNC00000305,3,-,8932,9333,255;0;0,2,150,147,0,254,9082,9186,104,1
19966ref,3781,4182,JUNC00000147,28,+,3781,4182,255;0;0,2,149,149,0,252,3930,4033,103,1
19966ref,7890,8288,JUNC00000283,12,+,7890,8288,255;0;0,2,150,145,0,253,8040,8143,103,1
19966ref,4088,4378,JUNC00000161,18,+,4088,4378,255;0;0,2,150,38,0,252,4238,4340,102,1
19966ref,1418,1709,JUNC00000062,82,+,1418,1709,255;0;0,2,47,144,0,147,1465,1565,100,1
19966ref,2238,2635,JUNC00000084,102,+,2238,2635,255;0;0,2,150,147,0,250,2388,2488,100,1
19966ref,4398,4789,JUNC00000177,141,-,4398,4789,255;0;0,2,146,145,0,246,4544,4644,100,1
19966ref,6683,6971,JUNC00000231,19,-,6683,6971,255;0;0,2,40,150,0,138,6723,6821,98,1
19966ref,539,806,JUNC00000006,7,-,539,806,255;0;0,2,23,148,0,119,562,658,96,1
19966ref,3754,4042,JUNC00000139,82,+,3754,4042,255;0;0,2,44,148,0,140,3798,3894,96,1
19966ref,9558,9852,JUNC00000312,4,-,9558,9852,255;0;0,2,49,150,0,144,9607,9702,95,1
19966ref,4180,4573,JUNC00000167,11,+,4180,4573,255;0;0,2,149,150,0,243,4329,4423,94,1
19966ref,2803,3189,JUNC00000130,269,-,2803,3189,255;0;0,2,146,147,0,239,2949,3042,93,1
19966ref,6810,7170,JUNC00000238,69,+,6810,7170,255;0;0,2,119,148,0,212,6929,7022,93,1
19966ref,6891,7184,JUNC00000241,24,-,6891,7184,255;0;0,2,51,149,0,144,6942,7035,93,1
19966ref,5777,6168,JUNC00000213,13,+,5777,6168,255;0;0,2,149,150,0,241,5926,6018,92,1
19966ref,2394,2653,JUNC00000085,12,-,2394,2653,255;0;0,2,18,150,0,109,2412,2503,91,1
19966ref,6706,6968,JUNC00000232,19,-,6706,6968,255;0;0,2,23,150,0,112,6729,6818,89,1
19966ref,701,1061,JUNC00000032,13,+,701,1061,255;0;0,2,125,147,0,213,826,914,88,1
19966ref,1818,2056,JUNC00000071,18,-,1818,2056,255;0;0,2,8,144,0,94,1826,1912,86,1
19966ref,2235,2620,JUNC00000083,48,+,2235,2620,255;0;0,2,150,149,0,236,2385,2471,86,1
19966ref,6891,7175,JUNC00000240,42,-,6891,7175,255;0;0,2,51,150,0,134,6942,7025,83,1
19966ref,5635,6013,JUNC00000206,2,+,5635,6013,255;0;0,2,149,147,0,231,5784,5866,82,1
19966ref,6599,6980,JUNC00000233,17,+,6599,6980,255;0;0,2,150,149,0,232,6749,6831,82,1
19966ref,8775,9142,JUNC00000301,45,+,8775,9142,255;0;0,2,140,145,0,222,8915,8997,82,1
19966ref,5789,6166,JUNC00000215,85,+,5789,6166,255;0;0,2,148,148,0,229,5937,6018,81,1
19966ref,5653,6029,JUNC00000207,3,+,5653,6029,255;0;0,2,147,150,0,226,5800,5879,79,1
19966ref,5001,5376,JUNC00000191,10,+,5001,5376,255;0;0,2,150,148,0,227,5151,5228,77,1
19966ref,7338,7712,JUNC00000259,33,+,7338,7712,255;0;0,2,147,150,0,224,7485,7562,77,1
19966ref,8294,8522,JUNC00000289,1,+,8294,8522,255;0;0,2,67,84,0,144,8361,8438,77,1
19966ref,9792,10075,JUNC00000317,34,+,9792,10075,255;0;0,2,57,150,0,133,9849,9925,76,1
19966ref,614,986,JUNC00000027,14,+,614,986,255;0;0,2,150,147,0,225,764,839,75,1
19966ref,8042,8329,JUNC00000285,55,+,8042,8329,255;0;0,2,62,150,0,137,8104,8179,75,1
19966ref,594,836,JUNC00000010,123,+,594,836,255;0;0,2,19,150,0,92,613,686,73,1
19966ref,626,887,JUNC00000017,151,+,626,887,255;0;0,2,48,142,0,119,674,745,71,1
19966ref,1796,2034,JUNC00000070,17,-,1796,2034,255;0;0,2,19,149,0,89,1815,1885,70,1
19966ref,6746,7108,JUNC00000237,63,-,6746,7108,255;0;0,2,146,146,0,216,6892,6962,70,1
19966ref,1813,2053,JUNC00000072,5,+,1813,2053,255;0;0,2,25,147,0,93,1838,1906,68,1
19966ref,417,778,JUNC00000005,3,-,417,778,255;0;0,2,145,149,0,212,562,629,67,1
19966ref,7362,7700,JUNC00000261,139,-,7362,7700,255;0;0,2,149,122,0,216,7511,7578,67,1
19966ref,3657,3978,JUNC00000137,77,-,3657,3978,255;0;0,2,110,145,0,176,3767,3833,66,1
19966ref,5016,5376,JUNC00000192,26,+,5016,5376,255;0;0,2,148,146,0,214,5164,5230,66,1
19966ref,2882,3152,JUNC00000129,197,-,2882,3152,255;0;0,2,67,138,0,132,2949,3014,65,1
19966ref,4273,4509,JUNC00000170,2,-,4273,4509,255;0;0,2,149,22,0,214,4422,4487,65,1
19966ref,8283,8598,JUNC00000290,74,+,8283,8598,255;0;0,2,148,102,0,213,8431,8496,65,1
19966ref,877,1233,JUNC00000041,2,+,877,1233,255;0;0,2,144,149,0,207,1021,1084,63,1
19966ref,8290,8607,JUNC00000291,654,+,8290,8607,255;0;0,2,148,106,0,211,8438,8501,63,1
19966ref,570,824,JUNC00000009,7,+,570,824,255;0;0,2,43,150,0,104,613,674,61,1
19966ref,7714,8064,JUNC00000277,9,-,7714,8064,255;0;0,2,143,148,0,202,7857,7916,59,1
19966ref,9195,9551,JUNC00000311,496,+,9195,9551,255;0;0,2,147,150,0,206,9342,9401,59,1
19966ref,2856,3212,JUNC00000131,5,+,2856,3212,255;0;0,2,150,148,0,208,3006,3064,58,1
19966ref,4456,4670,JUNC00000172,8,+,4456,4670,255;0;0,2,8,148,0,66,4464,4522,58,1
19966ref,4849,5100,JUNC00000183,19,+,4849,5100,255;0;0,2,44,149,0,102,4893,4951,58,1
19966ref,4863,4995,JUNC00000184,1,-,4863,4995,255;0;0,2,44,30,0,102,4907,4965,58,1
19966ref,955,1239,JUNC00000044,1004,-,955,1239,255;0;0,2,146,81,0,203,1101,1158,57,1
19966ref,5941,6096,JUNC00000217,3,+,5941,6096,255;0;0,2,24,74,0,81,5965,6022,57,1
19966ref,7789,8141,JUNC00000282,12,-,7789,8141,255;0;0,2,149,149,0,203,7938,7992,54,1
19966ref,415,765,JUNC00000004,14,-,415,765,255;0;0,2,147,150,0,200,562,615,53,1
19966ref,825,1171,JUNC00000039,14,+,825,1171,255;0;0,2,144,149,0,197,969,1022,53,1
19966ref,9972,10116,JUNC00000325,10,-,9972,10116,255;0;0,2,42,50,0,94,10014,10066,52,1
19966ref,1489,1730,JUNC00000064,40,-,1489,1730,255;0;0,2,41,149,0,92,1530,1581,51,1
19966ref,2061,2276,JUNC00000076,7,-,2061,2276,255;0;0,2,18,147,0,68,2079,2129,50,1
19966ref,4319,4561,JUNC00000168,105,+,4319,4561,255;0;0,2,43,149,0,93,4362,4412,50,1
19966ref,5797,5966,JUNC00000208,9,-,5797,5966,255;0;0,2,23,96,0,73,5820,5870,50,1
19966ref,7723,8064,JUNC00000280,35,-,7723,8064,255;0;0,2,143,148,0,193,7866,7916,50,1
19966ref,2435,2777,JUNC00000102,20,+,2435,2777,255;0;0,2,145,148,0,194,2580,2629,49,1
19966ref,2476,2818,JUNC00000112,15,+,2476,2818,255;0;0,2,145,148,0,194,2621,2670,49,1
19966ref,6025,6368,JUNC00000225,44,+,6025,6368,255;0;0,2,146,148,0,195,6171,6220,49,1
19966ref,1123,1461,JUNC00000053,33,+,1123,1461,255;0;0,2,147,146,0,192,1270,1315,45,1
19966ref,3920,4141,JUNC00000148,40,+,3920,4141,255;0;0,2,26,150,0,71,3946,3991,45,1
19966ref,2416,2757,JUNC00000099,5,-,2416,2757,255;0;0,2,150,149,0,192,2566,2608,42,1
19966ref,9806,10016,JUNC00000322,13,-,9806,10016,255;0;0,2,147,21,0,189,9953,9995,42,1
19966ref,601,905,JUNC00000025,11,-,601,905,255;0;0,2,143,120,0,184,744,785,41,1
19966ref,7151,7488,JUNC00000255,28,-,7151,7488,255;0;0,2,150,146,0,191,7301,7342,41,1
19966ref,2445,2779,JUNC00000104,11,+,2445,2779,255;0;0,2,144,150,0,184,2589,2629,40,1
19966ref,5824,6161,JUNC00000218,168,-,5824,6161,255;0;0,2,150,147,0,190,5974,6014,40,1
19966ref,6731,6966,JUNC00000234,18,-,6731,6966,255;0;0,2,47,148,0,87,6778,6818,40,1
19966ref,5710,5924,JUNC00000205,19,+,5710,5924,255;0;0,2,26,149,0,65,5736,5775,39,1
19966ref,1421,1758,JUNC00000066,18,+,1421,1758,255;0;0,2,150,149,0,188,1571,1609,38,1
19966ref,2471,2802,JUNC00000110,29,+,2471,2802,255;0;0,2,143,150,0,181,2614,2652,38,1
19966ref,2671,3006,JUNC00000123,15,-,2671,3006,255;0;0,2,149,148,0,187,2820,2858,38,1
19966ref,5783,6121,JUNC00000214,21,+,5783,6121,255;0;0,2,150,150,0,188,5933,5971,38,1
19966ref,7497,7835,JUNC00000265,12,+,7497,7835,255;0;0,2,150,150,0,188,7647,7685,38,1
19966ref,9917,10110,JUNC00000320,5,+,9917,10110,255;0;0,2,8,147,0,46,9925,9963,38,1
19966ref,1246,1579,JUNC00000058,10,+,1246,1579,255;0;0,2,147,149,0,184,1393,1430,37,1
19966ref,7038,7273,JUNC00000245,66,+,7038,7273,255;0;0,2,51,147,0,88,7089,7126,37,1
19966ref,2145,2476,JUNC00000079,67,+,2145,2476,255;0;0,2,146,149,0,182,2291,2327,36,1
19966ref,3593,3923,JUNC00000136,70,+,3593,3923,255;0;0,2,145,149,0,181,3738,3774,36,1
19966ref,4615,4948,JUNC00000179,60,+,4615,4948,255;0;0,2,150,147,0,186,4765,4801,36,1
19966ref,7518,7821,JUNC00000267,8,+,7518,7821,255;0;0,2,142,125,0,178,7660,7696,36,1
19966ref,9008,9255,JUNC00000307,30,-,9008,9255,255;0;0,2,150,61,0,186,9158,9194,36,1
19966ref,758,1089,JUNC00000035,2,-,758,1089,255;0;0,2,147,149,0,182,905,940,35,1
19966ref,2431,2658,JUNC00000100,18,+,2431,2658,255;0;0,2,147,45,0,182,2578,2613,35,1
19966ref,2444,2776,JUNC00000106,11,-,2444,2776,255;0;0,2,150,147,0,185,2594,2629,35,1
19966ref,2449,2781,JUNC00000107,172,-,2449,2781,255;0;0,2,149,148,0,184,2598,2633,35,1
19966ref,4030,4241,JUNC00000152,31,-,4030,4241,255;0;0,2,26,150,0,61,4056,4091,35,1
19966ref,965,1295,JUNC00000045,8,+,965,1295,255;0;0,2,146,150,0,180,1111,1145,34,1
19966ref,2659,2989,JUNC00000120,81,+,2659,2989,255;0;0,2,147,149,0,181,2806,2840,34,1
19966ref,7502,7835,JUNC00000266,16,+,7502,7835,255;0;0,2,149,150,0,183,7651,7685,34,1
19966ref,703,969,JUNC00000029,69,+,703,969,255;0;0,2,90,143,0,123,793,826,33,1
19966ref,5471,5780,JUNC00000201,32,-,5471,5780,255;0;0,2,129,147,0,162,5600,5633,33,1
19966ref,7741,7940,JUNC00000275,16,+,7741,7940,255;0;0,2,19,148,0,51,7760,7792,32,1
19966ref,2390,2612,JUNC00000086,7,-,2390,2612,255;0;0,2,43,148,0,74,2433,2464,31,1
19966ref,3770,4097,JUNC00000146,57,-,3770,4097,255;0;0,2,149,147,0,180,3919,3950,31,1
19966ref,7732,7914,JUNC00000274,1,+,7732,7914,255;0;0,2,9,142,0,40,7741,7772,31,1
19966ref,9959,10148,JUNC00000326,63,+,9959,10148,255;0;0,2,147,12,0,177,10106,10136,30,1
19966ref,644,845,JUNC00000016,28,+,644,845,255;0;0,2,23,149,0,52,667,696,29,1
19966ref,7963,8284,JUNC00000287,24,-,7963,8284,255;0;0,2,149,143,0,178,8112,8141,29,1
19966ref,3505,3828,JUNC00000134,82,+,3505,3828,255;0;0,2,149,146,0,177,3654,3682,28,1
19966ref,9192,9348,JUNC00000309,2,+,9192,9348,255;0;0,2,108,20,0,136,9300,9328,28,1
19966ref,518,843,JUNC00000015,42,+,518,843,255;0;0,2,149,149,0,176,667,694,27,1
19966ref,3204,3434,JUNC00000133,37,-,3204,3434,255;0;0,2,53,150,0,80,3257,3284,27,1
19966ref,3720,4041,JUNC00000141,45,+,3720,4041,255;0;0,2,147,147,0,174,3867,3894,27,1
19966ref,502,703,JUNC00000002,13,-,502,703,255;0;0,2,26,149,0,52,528,554,26,1
19966ref,1147,1458,JUNC00000056,12,+,1147,1458,255;0;0,2,142,143,0,168,1289,1315,26,1
19966ref,7385,7706,JUNC00000262,17,-,7385,7706,255;0;0,2,145,150,0,171,7530,7556,26,1
19966ref,650,850,JUNC00000018,215,+,650,850,255;0;0,2,26,149,0,51,676,701,25,1
19966ref,697,1018,JUNC00000034,8,+,697,1018,255;0;0,2,149,147,0,174,846,871,25,1
19966ref,949,1272,JUNC00000043,11,-,949,1272,255;0;0,2,150,148,0,175,1099,1124,25,1
19966ref,3022,3345,JUNC00000132,114,+,3022,3345,255;0;0,2,149,149,0,174,3171,3196,25,1
19966ref,4337,4655,JUNC00000174,28,+,4337,4655,255;0;0,2,145,148,0,170,4482,4507,25,1
19966ref,2792,2988,JUNC00000122,5,-,2792,2988,255;0;0,2,24,148,0,48,2816,2840,24,1
19966ref,3789,4041,JUNC00000142,25,+,3789,4041,255;0;0,2,81,147,0,105,3870,3894,24,1
19966ref,4942,5153,JUNC00000187,70,-,4942,5153,255;0;0,2,38,149,0,62,4980,5004,24,1
19966ref,5596,5776,JUNC00000202,86,-,5596,5776,255;0;0,2,8,148,0,32,5604,5628,24,1
19966ref,1977,2295,JUNC00000077,15,+,1977,2295,255;0;0,2,145,150,0,168,2122,2145,23,1
19966ref,2309,2504,JUNC00000082,4,+,2309,2504,255;0;0,2,22,150,0,45,2331,2354,23,1
19966ref,2434,2756,JUNC00000103,39,+,2434,2756,255;0;0,2,150,150,0,172,2584,2606,22,1
19966ref,2467,2785,JUNC00000109,5,+,2467,2785,255;0;0,2,147,149,0,169,2614,2636,22,1
19966ref,4902,5151,JUNC00000186,8,-,4902,5151,255;0;0,2,78,149,0,100,4980,5002,22,1
19966ref,5332,5654,JUNC00000198,6,+,5332,5654,255;0;0,2,150,150,0,172,5482,5504,22,1
19966ref,7347,7553,JUNC00000256,13,-,7347,7553,255;0;0,2,34,150,0,56,7381,7403,22,1
19966ref,978,1292,JUNC00000049,42,+,978,1292,255;0;0,2,149,145,0,169,1127,1147,20,1
19966ref,1276,1519,JUNC00000060,74,-,1276,1519,255;0;0,2,149,74,0,169,1425,1445,20,1
19966ref,5001,5319,JUNC00000190,8,+,5001,5319,255;0;0,2,150,148,0,170,5151,5171,20,1
19966ref,9600,9863,JUNC00000313,317,+,9600,9863,255;0;0,2,94,149,0,114,9694,9714,20,1
19966ref,644,835,JUNC00000014,20,+,644,835,255;0;0,2,23,149,0,42,667,686,19,1
19966ref,850,1138,JUNC00000038,11,+,850,1138,255;0;0,2,119,150,0,138,969,988,19,1
19966ref,2743,3062,JUNC00000127,11,+,2743,3062,255;0;0,2,150,150,0,169,2893,2912,19,1
19966ref,4816,4988,JUNC00000181,40,-,4816,4988,255;0;0,2,9,144,0,28,4825,4844,19,1
19966ref,7425,7741,JUNC00000264,10,-,7425,7741,255;0;0,2,148,149,0,167,7573,7592,19,1
19966ref,9675,9992,JUNC00000315,4,-,9675,9992,255;0;0,2,149,149,0,168,9824,9843,19,1
19966ref,9792,10105,JUNC00000321,2,-,9792,10105,255;0;0,2,148,146,0,167,9940,9959,19,1
19966ref,967,1282,JUNC00000047,8,+,967,1282,255;0;0,2,149,149,0,166,1116,1133,17,1
19966ref,1827,2138,JUNC00000074,37,-,1827,2138,255;0;0,2,147,147,0,164,1974,1991,17,1
19966ref,2470,2785,JUNC00000111,19,+,2470,2785,255;0;0,2,149,149,0,166,2619,2636,17,1
19966ref,7963,8278,JUNC00000286,92,-,7963,8278,255;0;0,2,149,149,0,166,8112,8129,17,1
19966ref,2459,2647,JUNC00000088,12,+,2459,2647,255;0;0,2,22,150,0,38,2481,2497,16,1
19966ref,2344,2659,JUNC00000093,18,+,2344,2659,255;0;0,2,149,150,0,165,2493,2509,16,1
19966ref,2667,2979,JUNC00000121,27,-,2667,2979,255;0;0,2,149,147,0,165,2816,2832,16,1
19966ref,2697,3009,JUNC00000125,13,+,2697,3009,255;0;0,2,149,147,0,165,2846,2862,16,1
19966ref,2716,3030,JUNC00000126,44,+,2716,3030,255;0;0,2,149,149,0,165,2865,2881,16,1
19966ref,945,1259,JUNC00000042,8,+,945,1259,255;0;0,2,150,149,0,165,1095,1110,15,1
19966ref,2327,2511,JUNC00000087,6,+,2327,2511,255;0;0,2,148,21,0,163,2475,2490,15,1
19966ref,2593,2779,JUNC00000108,3,+,2593,2779,255;0;0,2,21,150,0,36,2614,2629,15,1
19966ref,4020,4186,JUNC00000151,4,-,4020,4186,255;0;0,2,8,143,0,23,4028,4043,15,1
19966ref,9989,10188,JUNC00000327,17,+,9989,10188,255;0;0,2,148,36,0,163,10137,10152,15,1
19966ref,597,908,JUNC00000024,97,-,597,908,255;0;0,2,147,150,0,161,744,758,14,1
19966ref,4027,4241,JUNC00000153,195,-,4027,4241,255;0;0,2,50,150,0,64,4077,4091,14,1
19966ref,3946,4253,JUNC00000154,40,+,3946,4253,255;0;0,2,146,147,0,160,4092,4106,14,1
19966ref,4038,4350,JUNC00000158,13,+,4038,4350,255;0;0,2,148,150,0,162,4186,4200,14,1
19966ref,4107,4418,JUNC00000163,51,+,4107,4418,255;0;0,2,150,147,0,164,4257,4271,14,1
19966ref,5404,5711,JUNC00000200,160,+,5404,5711,255;0;0,2,145,148,0,159,5549,5563,14,1
19966ref,7009,7321,JUNC00000248,7,-,7009,7321,255;0;0,2,149,149,0,163,7158,7172,14,1
19966ref,7052,7361,JUNC00000251,5,-,7052,7361,255;0;0,2,145,150,0,159,7197,7211,14,1
19966ref,8296,8606,JUNC00000294,17,+,8296,8606,255;0;0,2,148,148,0,162,8444,8458,14,1
19966ref,9078,9388,JUNC00000308,10,-,9078,9388,255;0;0,2,147,149,0,161,9225,9239,14,1
19966ref,3959,4272,JUNC00000156,105,-,3959,4272,255;0;0,2,150,150,0,163,4109,4122,13,1
19966ref,5692,5994,JUNC00000211,33,+,5692,5994,255;0;0,2,149,140,0,162,5841,5854,13,1
19966ref,7278,7448,JUNC00000254,53,-,7278,7448,255;0;0,2,9,148,0,22,7287,7300,13,1
19966ref,10130,10361,JUNC00000328,3,-,10130,10361,255;0;0,2,145,73,0,158,10275,10288,13,1
19966ref,2407,2713,JUNC00000098,24,+,2407,2713,255;0;0,2,146,148,0,158,2553,2565,12,1
19966ref,2680,2991,JUNC00000124,72,+,2680,2991,255;0;0,2,150,149,0,162,2830,2842,12,1
19966ref,8987,9295,JUNC00000306,10,+,8987,9295,255;0;0,2,149,147,0,161,9136,9148,12,1
19966ref,9714,10025,JUNC00000318,4,+,9714,10025,255;0;0,2,149,150,0,161,9863,9875,12,1
19966ref,637,871,JUNC00000019,340,+,637,871,255;0;0,2,73,150,0,84,710,721,11,1
19966ref,2110,2297,JUNC00000078,38,+,2110,2297,255;0;0,2,26,150,0,37,2136,2147,11,1
19966ref,4290,4598,JUNC00000171,18,-,4290,4598,255;0;0,2,149,148,0,160,4439,4450,11,1
19966ref,7130,7320,JUNC00000249,57,+,7130,7320,255;0;0,2,33,146,0,44,7163,7174,11,1
19966ref,9184,9492,JUNC00000310,4,-,9184,9492,255;0;0,2,149,148,0,160,9333,9344,11,1
19966ref,797,982,JUNC00000036,5,-,797,982,255;0;0,2,146,29,0,156,943,953,10,1
19966ref,2530,2839,JUNC00000114,8,-,2530,2839,255;0;0,2,150,149,0,160,2680,2690,10,1
19966ref,3735,3945,JUNC00000138,708,+,3735,3945,255;0;0,2,51,149,0,61,3786,3796,10,1
19966ref,9730,9910,JUNC00000319,2,+,9730,9910,255;0;0,2,147,23,0,157,9877,9887,10,1
19966ref,305,611,JUNC00000001,14,+,305,611,255;0;0,2,149,148,0,158,454,463,9,1
19966ref,4854,5094,JUNC00000185,82,+,4854,5094,255;0;0,2,81,150,0,90,4935,4944,9,1
19966ref,970,1256,JUNC00000046,4,+,970,1256,255;0;0,2,144,134,0,152,1114,1122,8,1
19966ref,1003,1263,JUNC00000050,224,-,1003,1263,255;0;0,2,147,105,0,155,1150,1158,8,1
19966ref,1607,1909,JUNC00000069,34,+,1607,1909,255;0;0,2,144,150,0,152,1751,1759,8,1
19966ref,2653,2840,JUNC00000115,19,+,2653,2840,255;0;0,2,29,150,0,37,2682,2690,8,1
19966ref,2659,2963,JUNC00000119,74,+,2659,2963,255;0;0,2,147,149,0,155,2806,2814,8,1
19966ref,5698,5879,JUNC00000204,14,+,5698,5879,255;0;0,2,24,149,0,32,5722,5730,8,1
19966ref,6015,6086,JUNC00000221,57,+,6015,6086,255;0;0,2,43,20,0,51,6058,6066,8,1
19966ref,6112,6312,JUNC00000226,93,+,6112,6312,255;0;0,2,149,43,0,157,6261,6269,8,1
19966ref,6728,7032,JUNC00000236,75,+,6728,7032,255;0;0,2,148,148,0,156,6876,6884,8,1
19966ref,6891,7100,JUNC00000239,21,-,6891,7100,255;0;0,2,51,150,0,59,6942,6950,8,1
19966ref,8003,8262,JUNC00000284,30,+,8003,8262,255;0;0,2,101,150,0,109,8104,8112,8,1
19966ref,644,824,JUNC00000013,190,+,644,824,255;0;0,2,23,150,0,30,667,674,7,1
19966ref,824,1125,JUNC00000037,80,+,824,1125,255;0;0,2,145,149,0,152,969,976,7,1
19966ref,7540,7845,JUNC00000269,9,+,7540,7845,255;0;0,2,149,149,0,156,7689,7696,7,1
19966ref,7718,8021,JUNC00000279,18,+,7718,8021,255;0;0,2,148,148,0,155,7866,7873,7,1
19966ref,9855,10161,JUNC00000324,8,-,9855,10161,255;0;0,2,149,150,0,156,10004,10011,7,1
19966ref,1714,2014,JUNC00000073,2,+,1714,2014,255;0;0,2,146,148,0,152,1860,1866,6,1
19966ref,2444,2746,JUNC00000105,14,+,2444,2746,255;0;0,2,149,147,0,155,2593,2599,6,1
19966ref,4233,4433,JUNC00000169,812,-,4233,4433,255;0;0,2,149,45,0,155,4382,4388,6,1
19966ref,4316,4620,JUNC00000173,16,-,4316,4620,255;0;0,2,150,148,0,156,4466,4472,6,1
19966ref,5115,5316,JUNC00000193,87,+,5115,5316,255;0;0,2,150,45,0,156,5265,5271,6,1
19966ref,5728,6032,JUNC00000212,18,+,5728,6032,255;0;0,2,150,148,0,156,5878,5884,6,1
19966ref,6305,6610,JUNC00000228,53,-,6305,6610,255;0;0,2,150,149,0,156,6455,6461,6,1
19966ref,7020,7200,JUNC00000242,40,-,7020,7200,255;0;0,2,26,148,0,32,7046,7052,6,1
19966ref,7216,7416,JUNC00000253,29,-,7216,7416,255;0;0,2,47,147,0,53,7263,7269,6,1
19966ref,7499,7527,JUNC00000260,1,-,7499,7527,255;0;0,2,12,10,0,18,7511,7517,6,1
19966ref,7966,8270,JUNC00000288,67,-,7966,8270,255;0;0,2,149,149,0,155,8115,8121,6,1
19966ref,1262,1534,JUNC00000059,22,+,1262,1534,255;0;0,2,149,118,0,154,1411,1416,5,1
19966ref,1567,1736,JUNC00000067,4,+,1567,1736,255;0;0,2,19,145,0,24,1586,1591,5,1
19966ref,3932,4111,JUNC00000149,139,+,3932,4111,255;0;0,2,24,150,0,29,3956,3961,5,1
19966ref,5956,6161,JUNC00000222,8,+,5956,6161,255;0;0,2,149,51,0,154,6105,6110,5,1
19966ref,6728,7030,JUNC00000235,173,+,6728,7030,255;0;0,2,148,149,0,153,6876,6881,5,1
19966ref,6990,7290,JUNC00000247,48,+,6990,7290,255;0;0,2,147,148,0,152,7137,7142,5,1
19966ref,7423,7657,JUNC00000263,9,-,7423,7657,255;0;0,2,150,79,0,155,7573,7578,5,1
19966ref,7725,8028,JUNC00000281,21,-,7725,8028,255;0;0,2,150,148,0,155,7875,7880,5,1
19966ref,8301,8603,JUNC00000296,9,+,8301,8603,255;0;0,2,148,149,0,153,8449,8454,5,1
19966ref,8775,9078,JUNC00000302,2003,+,8775,9078,255;0;0,2,148,150,0,153,8923,8928,5,1
19933ref,174,9673,JUNC00000001,424,+,174,9673,255;0;0,2,150,145,0,9354,324,9528,9204,1
19933ref,972,9661,JUNC00000047,18,+,972,9661,255;0;0,2,142,150,0,8539,1114,9511,8397,1
19933ref,977,9504,JUNC00000057,44,+,977,9504,255;0;0,2,150,8,0,8519,1127,9496,8369,1
19933ref,1915,10337,JUNC00000075,2,+,1915,10337,255;0;0,2,125,83,0,8339,2040,10254,8214,1
19933ref,977,9080,JUNC00000056,31,+,977,9080,255;0;0,2,150,140,0,7963,1127,8940,7813,1
19933ref,908,8464,JUNC00000034,200,+,908,8464,255;0;0,2,147,103,0,7453,1055,8361,7306,1
19933ref,2210,9653,JUNC00000079,50,-,2210,9653,255;0;0,2,66,108,0,7335,2276,9545,7269,1
19933ref,2588,9642,JUNC00000095,6,+,2588,9642,255;0;0,2,147,146,0,6908,2735,9496,6761,1
19933ref,972,7891,JUNC00000051,16,+,972,7891,255;0;0,2,150,24,0,6895,1122,7867,6745,1
19933ref,2431,9237,JUNC00000088,7,+,2431,9237,255;0;0,2,147,122,0,6684,2578,9115,6537,1
19933ref,975,7649,JUNC00000050,66,+,975,7649,255;0;0,2,147,145,0,6529,1122,7504,6382,1
19933ref,1074,7699,JUNC00000060,61,+,1074,7699,255;0;0,2,147,148,0,6477,1221,7551,6330,1
19933ref,3023,9504,JUNC00000113,31,+,3023,9504,255;0;0,2,150,26,0,6455,3173,9478,6305,1
19933ref,3047,9550,JUNC00000114,6,+,3047,9550,255;0;0,2,149,54,0,6449,3196,9496,6300,1
19933ref,3967,10048,JUNC00000122,7,-,3967,10048,255;0;0,2,150,55,0,6026,4117,9993,5876,1
19933ref,4469,10468,JUNC00000129,1,-,4469,10468,255;0;0,2,28,123,0,5876,4497,10345,5848,1
19933ref,3674,9663,JUNC00000117,90,+,3674,9663,255;0;0,2,8,148,0,5841,3682,9515,5833,1
19933ref,1965,8049,JUNC00000078,2,-,1965,8049,255;0;0,2,129,150,0,5934,2094,7899,5805,1
19933ref,330,6215,JUNC00000002,2,+,330,6215,255;0;0,2,38,112,0,5773,368,6103,5735,1
19933ref,4433,10377,JUNC00000132,3,+,4433,10377,255;0;0,2,146,94,0,5850,4579,10283,5704,1
19933ref,1898,7587,JUNC00000076,10,-,1898,7587,255;0;0,2,149,36,0,5653,2047,7551,5504,1
19933ref,1694,7322,JUNC00000072,1,+,1694,7322,255;0;0,2,106,45,0,5583,1800,7277,5477,1
19933ref,1943,7521,JUNC00000077,1,+,1943,7521,255;0;0,2,124,27,0,5551,2067,7494,5427,1
19933ref,798,6226,JUNC00000025,6495,-,798,6226,255;0;0,2,145,149,0,5279,943,6077,5134,1
19933ref,3948,9268,JUNC00000121,258,+,3948,9268,255;0;0,2,144,148,0,5172,4092,9120,5028,1
19933ref,1096,6248,JUNC00000046,26,+,1096,6248,255;0;0,2,18,148,0,5004,1114,6100,4986,1
19933ref,5018,10204,JUNC00000139,28,-,5018,10204,255;0;0,2,148,65,0,5121,5166,10139,4973,1
19933ref,2805,7669,JUNC00000108,7,+,2805,7669,255;0;0,2,25,147,0,4717,2830,7522,4692,1
19933ref,2699,7250,JUNC00000109,6,+,2699,7250,255;0;0,2,149,10,0,4541,2848,7240,4392,1
19933ref,920,5594,JUNC00000036,9,-,920,5594,255;0;0,2,148,147,0,4527,1068,5447,4379,1
19933ref,4621,9248,JUNC00000134,15,+,4621,9248,255;0;0,2,144,148,0,4479,4765,9100,4335,1
19933ref,5197,9212,JUNC00000140,140,+,5197,9212,255;0;0,2,140,15,0,4000,5337,9197,3860,1
19933ref,977,4886,JUNC00000055,56,+,977,4886,255;0;0,2,150,142,0,3767,1127,4744,3617,1
19933ref,2985,6684,JUNC00000112,243,+,2985,6684,255;0;0,2,87,148,0,3551,3072,6536,3464,1
19933ref,1236,4950,JUNC00000063,8,+,1236,4950,255;0;0,2,147,149,0,3565,1383,4801,3418,1
19933ref,966,4646,JUNC00000048,12,+,966,4646,255;0;0,2,150,149,0,3531,1116,4497,3381,1
19933ref,5727,9091,JUNC00000144,384,+,5727,9091,255;0;0,2,9,149,0,3215,5736,8942,3206,1
19933ref,6947,10028,JUNC00000172,3,+,6947,10028,255;0;0,2,107,112,0,2969,7054,9916,2862,1
19933ref,6038,9077,JUNC00000157,7,-,6038,9077,255;0;0,2,150,149,0,2890,6188,8928,2740,1
19933ref,6057,9056,JUNC00000159,318,+,6057,9056,255;0;0,2,149,149,0,2850,6206,8907,2701,1
19933ref,6071,9064,JUNC00000160,39,+,6071,9064,255;0;0,2,143,149,0,2844,6214,8915,2701,1
19933ref,3390,6308,JUNC00000116,7,-,3390,6308,255;0;0,2,71,147,0,2771,3461,6161,2700,1
19933ref,322,3177,JUNC00000005,39,+,322,3177,255;0;0,2,149,69,0,2786,471,3108,2637,1
19933ref,2803,5730,JUNC00000110,2615,-,2803,5730,255;0;0,2,146,150,0,2777,2949,5580,2631,1
19933ref,5788,8647,JUNC00000150,75,+,5788,8647,255;0;0,2,149,146,0,2713,5937,8501,2564,1
19933ref,966,3450,JUNC00000045,4,+,966,3450,255;0;0,2,148,64,0,2420,1114,3386,2272,1
19933ref,6887,9304,JUNC00000170,2,-,6887,9304,255;0;0,2,57,146,0,2271,6944,9158,2214,1
19933ref,974,3447,JUNC00000049,105,+,974,3447,255;0;0,2,148,143,0,2330,1122,3304,2182,1
19933ref,932,3195,JUNC00000027,6,+,932,3195,255;0;0,2,26,148,0,2115,958,3047,2089,1
19933ref,2353,4329,JUNC00000085,88,+,2353,4329,255;0;0,2,148,64,0,1912,2501,4265,1764,1
19933ref,2657,4665,JUNC00000102,17,+,2657,4665,255;0;0,2,149,149,0,1859,2806,4516,1710,1
19933ref,1074,3033,JUNC00000061,202,+,1074,3033,255;0;0,2,150,149,0,1810,1224,2884,1660,1
19933ref,977,2690,JUNC00000054,37,+,977,2690,255;0;0,2,150,28,0,1685,1127,2662,1535,1
19933ref,2309,4134,JUNC00000084,2,-,2309,4134,255;0;0,2,148,148,0,1677,2457,3986,1529,1
19933ref,946,2639,JUNC00000039,55,+,946,2639,255;0;0,2,149,26,0,1667,1095,2613,1518,1
19933ref,976,2537,JUNC00000031,22,+,976,2537,255;0;0,2,26,144,0,1417,1002,2393,1391,1
19933ref,6058,7592,JUNC00000158,12,+,6058,7592,255;0;0,2,148,24,0,1510,6206,7568,1362,1
19933ref,2669,4238,JUNC00000105,71,-,2669,4238,255;0;0,2,147,132,0,1437,2816,4106,1290,1
19933ref,4750,6266,JUNC00000137,51,-,4750,6266,255;0;0,2,150,150,0,1366,4900,6116,1216,1
19933ref,6071,7522,JUNC00000163,18,+,6071,7522,255;0;0,2,148,143,0,1308,6219,7379,1160,1
19933ref,7515,8888,JUNC00000183,6,-,7515,8888,255;0;0,2,78,148,0,1225,7593,8740,1147,1
19933ref,359,1611,JUNC00000004,951,+,359,1611,255;0;0,2,44,146,0,1106,403,1465,1062,1
19933ref,4948,6117,JUNC00000138,12,-,4948,6117,255;0;0,2,149,24,0,1145,5097,6093,996,1
19933ref,7894,9165,JUNC00000197,241,+,7894,9165,255;0;0,2,140,141,0,1130,8034,9024,990,1
19933ref,1425,2600,JUNC00000066,64,+,1425,2600,255;0;0,2,128,146,0,1029,1553,2454,901,1
19933ref,977,1993,JUNC00000053,48,+,977,1993,255;0;0,2,150,23,0,993,1127,1970,843,1
19933ref,913,1957,JUNC00000035,38,+,913,1957,255;0;0,2,147,144,0,900,1060,1813,753,1
19933ref,933,1962,JUNC00000037,151,+,933,1962,255;0;0,2,150,147,0,882,1083,1815,732,1
19933ref,7723,8456,JUNC00000194,105,+,7723,8456,255;0;0,2,150,26,0,707,7873,8430,557,1
19933ref,6523,7191,JUNC00000167,4,-,6523,7191,255;0;0,2,23,148,0,520,6546,7043,497,1
19933ref,6071,6744,JUNC00000162,5,+,6071,6744,255;0;0,2,148,148,0,525,6219,6596,377,1
19933ref,582,1115,JUNC00000015,9,+,582,1115,255;0;0,2,148,46,0,487,730,1069,339,1
19933ref,438,1059,JUNC00000009,3,-,438,1059,255;0;0,2,148,149,0,472,586,910,324,1
19933ref,798,1394,JUNC00000024,707,-,798,1394,255;0;0,2,145,149,0,447,943,1245,302,1
19933ref,513,1109,JUNC00000012,10,-,513,1109,255;0;0,2,147,149,0,447,660,960,300,1
19933ref,2288,2788,JUNC00000083,254,+,2288,2788,255;0;0,2,130,73,0,427,2418,2715,297,1
19933ref,878,1452,JUNC00000032,86,+,878,1452,255;0;0,2,137,144,0,430,1015,1308,293,1
19933ref,2667,3177,JUNC00000104,35,-,2667,3177,255;0;0,2,149,69,0,441,2816,3108,292,1
19933ref,599,1060,JUNC00000011,49,+,599,1060,255;0;0,2,57,146,0,315,656,914,258,1
19933ref,4714,5236,JUNC00000136,67,-,4714,5236,255;0;0,2,149,149,0,373,4863,5087,224,1
19933ref,331,839,JUNC00000007,965,+,331,839,255;0;0,2,150,148,0,360,481,691,210,1
19933ref,8783,9111,JUNC00000201,1,-,8783,9111,255;0;0,2,39,112,0,216,8822,8999,177,1
19933ref,9832,10173,JUNC00000217,261,-,9832,10173,255;0;0,2,50,126,0,215,9882,10047,165,1
19933ref,4581,5039,JUNC00000133,195,+,4581,5039,255;0;0,2,147,148,0,310,4728,4891,163,1
19933ref,963,1414,JUNC00000043,10,+,963,1414,255;0;0,2,146,144,0,307,1109,1270,161,1
19933ref,7550,7896,JUNC00000187,16,+,7550,7896,255;0;0,2,149,42,0,304,7699,7854,155,1
19933ref,741,1099,JUNC00000016,45,+,741,1099,255;0;0,2,54,150,0,208,795,949,154,1
19933ref,1263,1653,JUNC00000065,60,+,1263,1653,255;0;0,2,148,105,0,285,1411,1548,137,1
19933ref,4394,4822,JUNC00000131,102,-,4394,4822,255;0;0,2,145,148,0,280,4539,4674,135,1
19933ref,7770,8192,JUNC00000195,31,+,7770,8192,255;0;0,2,146,148,0,274,7916,8044,128,1
19933ref,4176,4579,JUNC00000124,322,+,4176,4579,255;0;0,2,147,144,0,259,4323,4435,112,1
19933ref,4351,4755,JUNC00000130,5,-,4351,4755,255;0;0,2,148,145,0,259,4499,4610,111,1
19933ref,424,824,JUNC00000008,97,-,424,824,255;0;0,2,147,148,0,252,571,676,105,1
19933ref,2601,3000,JUNC00000096,20,-,2601,3000,255;0;0,2,150,144,0,255,2751,2856,105,1
19933ref,5394,5693,JUNC00000141,2,+,5394,5693,255;0;0,2,46,149,0,150,5440,5544,104,1
19933ref,4815,5068,JUNC00000135,1,-,4815,5068,255;0;0,2,48,103,0,150,4863,4965,102,1
19933ref,6360,6669,JUNC00000165,4,-,6360,6669,255;0;0,2,59,149,0,160,6419,6520,101,1
19933ref,9021,9274,JUNC00000207,46,+,9021,9274,255;0;0,2,9,146,0,107,9030,9128,98,1
19933ref,896,1158,JUNC00000033,5,+,896,1158,255;0;0,2,149,19,0,243,1045,1139,94,1
19933ref,2394,2778,JUNC00000086,154,-,2394,2778,255;0;0,2,150,142,0,242,2544,2636,92,1
19933ref,713,1098,JUNC00000019,93,+,713,1098,255;0;0,2,145,149,0,236,858,949,91,1
19933ref,7551,7828,JUNC00000189,43,+,7551,7828,255;0;0,2,150,42,0,235,7701,7786,85,1
19933ref,7775,8152,JUNC00000196,267,+,7775,8152,255;0;0,2,147,145,0,232,7922,8007,85,1
19933ref,7468,7847,JUNC00000184,30,+,7468,7847,255;0;0,2,148,148,0,231,7616,7699,83,1
19933ref,7552,7824,JUNC00000188,39,+,7552,7824,255;0;0,2,149,40,0,232,7701,7784,83,1
19933ref,5634,6013,JUNC00000145,18,+,5634,6013,255;0;0,2,150,147,0,232,5784,5866,82,1
19933ref,6271,6562,JUNC00000164,3,-,6271,6562,255;0;0,2,148,61,0,230,6419,6501,82,1
19933ref,9413,9645,JUNC00000212,1,+,9413,9645,255;0;0,2,93,58,0,174,9506,9587,81,1
19933ref,558,832,JUNC00000010,5,-,558,832,255;0;0,2,45,149,0,125,603,683,80,1
19933ref,7009,7383,JUNC00000175,4,-,7009,7383,255;0;0,2,149,148,0,226,7158,7235,77,1
19933ref,527,888,JUNC00000013,764,+,527,888,255;0;0,2,147,143,0,218,674,745,71,1
19933ref,7362,7724,JUNC00000181,347,-,7362,7724,255;0;0,2,149,146,0,216,7511,7578,67,1
19933ref,7709,8072,JUNC00000193,196,-,7709,8072,255;0;0,2,148,148,0,215,7857,7924,67,1
19933ref,8977,9243,JUNC00000206,307,+,8977,9243,255;0;0,2,53,146,0,120,9030,9097,67,1
19933ref,2945,3169,JUNC00000111,72,-,2945,3169,255;0;0,2,11,148,0,76,2956,3021,65,1
19933ref,1820,2033,JUNC00000074,2,-,1820,2033,255;0;0,2,30,121,0,92,1850,1912,62,1
19933ref,10008,10280,JUNC00000220,37,+,10008,10280,255;0;0,2,147,65,0,207,10155,10215,60,1
19933ref,4460,4590,JUNC00000128,446,-,4460,4590,255;0;0,2,37,35,0,95,4497,4555,58,1
19933ref,8430,8639,JUNC00000200,2,+,8430,8639,255;0;0,2,58,93,0,116,8488,8546,58,1
19933ref,9033,9245,JUNC00000211,12,+,9033,9245,255;0;0,2,146,8,0,204,9179,9237,58,1
19933ref,953,1278,JUNC00000042,4442,-,953,1278,255;0;0,2,148,120,0,205,1101,1158,57,1
19933ref,569,814,JUNC00000014,2,-,569,814,255;0;0,2,145,44,0,201,714,770,56,1
19933ref,9665,9973,JUNC00000214,2,-,9665,9973,255;0;0,2,103,149,0,159,9768,9824,56,1
19933ref,2494,2744,JUNC00000094,3,-,2494,2744,255;0;0,2,149,47,0,203,2643,2697,54,1
19933ref,826,1171,JUNC00000029,29,+,826,1171,255;0;0,2,143,149,0,196,969,1022,53,1
19933ref,6758,7106,JUNC00000169,50,-,6758,7106,255;0;0,2,148,147,0,201,6906,6959,53,1
19933ref,780,1021,JUNC00000017,63,+,780,1021,255;0;0,2,46,143,0,98,826,878,52,1
19933ref,2483,2828,JUNC00000093,10,+,2483,2828,255;0;0,2,148,147,0,198,2631,2681,50,1
19933ref,5680,6009,JUNC00000147,12,+,5680,6009,255;0;0,2,150,130,0,199,5830,5879,49,1
19933ref,9716,10007,JUNC00000216,157,-,9716,10007,255;0;0,2,93,149,0,142,9809,9858,49,1
19933ref,7101,7299,JUNC00000176,2,+,7101,7299,255;0;0,2,142,8,0,190,7243,7291,48,1
19933ref,5671,5869,JUNC00000146,1,-,5671,5869,255;0;0,2,143,8,0,190,5814,5861,47,1
19933ref,7279,7534,JUNC00000178,93,+,7279,7534,255;0;0,2,59,149,0,106,7338,7385,47,1
19933ref,8911,9250,JUNC00000208,3,-,8911,9250,255;0;0,2,145,147,0,192,9056,9103,47,1
19933ref,949,1293,JUNC00000041,18,-,949,1293,255;0;0,2,150,148,0,196,1099,1145,46,1
19933ref,949,1291,JUNC00000040,613,-,949,1291,255;0;0,2,150,149,0,193,1099,1142,43,1
19933ref,6959,7199,JUNC00000173,12,+,6959,7199,255;0;0,2,148,49,0,191,7107,7150,43,1
19933ref,7676,8012,JUNC00000192,13,+,7676,8012,255;0;0,2,149,145,0,191,7825,7867,42,1
19933ref,701,1038,JUNC00000018,22,+,701,1038,255;0;0,2,148,148,0,189,849,890,41,1
19933ref,2418,2643,JUNC00000087,5,+,2418,2643,255;0;0,2,147,37,0,188,2565,2606,41,1
19933ref,5825,6021,JUNC00000151,9,-,5825,6021,255;0;0,2,147,9,0,187,5972,6012,40,1
19933ref,1669,1870,JUNC00000068,3,+,1669,1870,255;0;0,2,17,147,0,54,1686,1723,37,1
19933ref,7360,7693,JUNC00000180,3,-,7360,7693,255;0;0,2,147,149,0,184,7507,7544,37,1
19933ref,6691,7024,JUNC00000168,4,-,6691,7024,255;0;0,2,149,148,0,185,6840,6876,36,1
19933ref,7511,7706,JUNC00000186,4,+,7511,7706,255;0;0,2,149,10,0,185,7660,7696,36,1
19933ref,2448,2781,JUNC00000091,3159,-,2448,2781,255;0;0,2,150,148,0,185,2598,2633,35,1
19933ref,2660,2988,JUNC00000101,10,+,2660,2988,255;0;0,2,146,148,0,180,2806,2840,34,1
19933ref,945,1277,JUNC00000038,29,+,945,1277,255;0;0,2,150,149,0,183,1095,1128,33,1
19933ref,5539,5783,JUNC00000142,211,-,5539,5783,255;0;0,2,61,150,0,94,5600,5633,33,1
19933ref,732,1055,JUNC00000021,9,+,732,1055,255;0;0,2,146,145,0,178,878,910,32,1
19933ref,7720,7812,JUNC00000190,2,+,7720,7812,255;0;0,2,21,40,0,52,7741,7772,31,1
19933ref,979,1168,JUNC00000058,279,-,979,1168,255;0;0,2,149,10,0,179,1128,1158,30,1
19933ref,4330,4529,JUNC00000125,3,-,4330,4529,255;0;0,2,20,149,0,50,4350,4380,30,1
19933ref,4289,4531,JUNC00000126,3,-,4289,4531,255;0;0,2,63,149,0,93,4352,4382,30,1
19933ref,4226,4491,JUNC00000127,43,+,4226,4491,255;0;0,2,149,86,0,179,4375,4405,30,1
19933ref,8952,9281,JUNC00000209,22,-,8952,9281,255;0;0,2,150,149,0,180,9102,9132,30,1
19933ref,5578,5783,JUNC00000143,483,-,5578,5783,255;0;0,2,26,150,0,55,5604,5633,29,1
19933ref,2624,2946,JUNC00000097,46,+,2624,2946,255;0;0,2,147,148,0,174,2771,2798,27,1
19933ref,3201,3433,JUNC00000115,25,-,3201,3433,255;0;0,2,56,149,0,83,3257,3284,27,1
19933ref,1565,1889,JUNC00000071,5,+,1565,1889,255;0;0,2,148,150,0,174,1713,1739,26,1
19933ref,1207,1527,JUNC00000062,28,+,1207,1527,255;0;0,2,146,150,0,170,1353,1377,24,1
19933ref,966,1282,JUNC00000044,19,+,966,1282,255;0;0,2,145,149,0,167,1111,1133,22,1
19933ref,7511,7706,JUNC00000185,2,+,7511,7706,255;0;0,2,149,24,0,171,7660,7682,22,1
19933ref,977,1292,JUNC00000052,189,+,977,1292,255;0;0,2,150,145,0,170,1127,1147,20,1
19933ref,2670,2990,JUNC00000106,8,-,2670,2990,255;0;0,2,150,150,0,170,2820,2840,20,1
19933ref,9701,9943,JUNC00000215,173,+,9701,9943,255;0;0,2,74,148,0,94,9775,9795,20,1
19933ref,2263,2473,JUNC00000080,77,+,2263,2473,255;0;0,2,47,146,0,64,2310,2327,17,1
19933ref,3606,3916,JUNC00000118,191,-,3606,3916,255;0;0,2,144,149,0,161,3750,3767,17,1
19933ref,7964,8279,JUNC00000198,114,-,7964,8279,255;0;0,2,148,150,0,165,8112,8129,17,1
19933ref,2667,2858,JUNC00000103,43,-,2667,2858,255;0;0,2,149,26,0,165,2816,2832,16,1
19933ref,6311,6623,JUNC00000166,3,+,6311,6623,255;0;0,2,148,148,0,164,6459,6475,16,1
19933ref,7235,7423,JUNC00000177,8,-,7235,7423,255;0;0,2,26,146,0,42,7261,7277,16,1
19933ref,1262,1553,JUNC00000064,14,+,1262,1553,255;0;0,2,149,127,0,164,1411,1426,15,1
19933ref,2436,2747,JUNC00000089,8,+,2436,2747,255;0;0,2,148,148,0,163,2584,2599,15,1
19933ref,2448,2761,JUNC00000090,41,+,2448,2761,255;0;0,2,150,148,0,165,2598,2613,15,1
19933ref,2465,2777,JUNC00000092,15,+,2465,2777,255;0;0,2,149,148,0,164,2614,2629,15,1
19933ref,2750,2991,JUNC00000107,40,+,2750,2991,255;0;0,2,80,146,0,95,2830,2845,15,1
19933ref,9993,10225,JUNC00000219,16,+,9993,10225,255;0;0,2,144,73,0,159,10137,10152,15,1
19933ref,2778,2963,JUNC00000100,6,-,2778,2963,255;0;0,2,24,147,0,38,2802,2816,14,1
19933ref,3996,4240,JUNC00000120,66,-,3996,4240,255;0;0,2,81,149,0,95,4077,4091,14,1
19933ref,4109,4418,JUNC00000123,43,+,4109,4418,255;0;0,2,148,147,0,162,4257,4271,14,1
19933ref,8300,8613,JUNC00000199,50,+,8300,8613,255;0;0,2,149,150,0,163,8449,8463,14,1
19933ref,773,1084,JUNC00000022,95,-,773,1084,255;0;0,2,149,149,0,162,922,935,13,1
19933ref,931,1116,JUNC00000026,5,+,931,1116,255;0;0,2,22,150,0,35,953,966,13,1
19933ref,9802,9988,JUNC00000218,29,-,9802,9988,255;0;0,2,148,25,0,161,9950,9963,13,1
19933ref,243,547,JUNC00000003,4,+,243,547,255;0;0,2,148,144,0,160,391,403,12,1
19933ref,1518,1826,JUNC00000067,47,+,1518,1826,255;0;0,2,148,148,0,160,1666,1678,12,1
19933ref,8935,9125,JUNC00000205,33,+,8935,9125,255;0;0,2,30,148,0,42,8965,8977,12,1
19933ref,331,642,JUNC00000006,20,+,331,642,255;0;0,2,150,150,0,161,481,492,11,1
19933ref,817,1027,JUNC00000020,45,+,817,1027,255;0;0,2,50,149,0,61,867,878,11,1
19933ref,914,1099,JUNC00000023,13,+,914,1099,255;0;0,2,24,150,0,35,938,949,11,1
19933ref,6015,6178,JUNC00000155,38,-,6015,6178,255;0;0,2,100,52,0,111,6115,6126,11,1
19933ref,6077,6280,JUNC00000156,341,-,6077,6280,255;0;0,2,43,149,0,54,6120,6131,11,1
19933ref,860,1127,JUNC00000030,8,+,860,1127,255;0;0,2,118,139,0,128,978,988,10,1
19933ref,8827,9078,JUNC00000203,10268,-,8827,9078,255;0;0,2,94,148,0,103,8921,8930,9,1
19933ref,9032,9196,JUNC00000210,14,+,9032,9196,255;0;0,2,147,8,0,156,9179,9188,9,1
19933ref,1001,1231,JUNC00000059,853,-,1001,1231,255;0;0,2,149,73,0,157,1150,1158,8,1
19933ref,2409,2573,JUNC00000082,43,+,2409,2573,255;0;0,2,9,147,0,17,2418,2426,8,1
19933ref,2745,2947,JUNC00000098,21,-,2745,2947,255;0;0,2,45,149,0,53,2790,2798,8,1
19933ref,5751,6058,JUNC00000149,61,+,5751,6058,255;0;0,2,150,149,0,158,5901,5909,8,1
19933ref,5864,6167,JUNC00000153,32,+,5864,6167,255;0;0,2,148,147,0,156,6012,6020,8,1
19933ref,7368,7594,JUNC00000179,48,+,7368,7594,255;0;0,2,68,150,0,76,7436,7444,8,1
19933ref,824,1126,JUNC00000028,148,+,824,1126,255;0;0,2,145,150,0,152,969,976,7,1
19933ref,3793,4003,JUNC00000119,26,-,3793,4003,255;0;0,2,54,149,0,61,3847,3854,7,1
19933ref,7773,7969,JUNC00000191,30,+,7773,7969,255;0;0,2,40,149,0,47,7813,7820,7,1
19933ref,9490,9723,JUNC00000213,61,+,9490,9723,255;0;0,2,149,77,0,156,9639,9646,7,1
19933ref,10138,10329,JUNC00000221,162,+,10138,10329,255;0;0,2,148,36,0,155,10286,10293,7,1
19933ref,1564,1864,JUNC00000069,2,-,1564,1864,255;0;0,2,147,147,0,153,1711,1717,6,1
19933ref,1565,1864,JUNC00000070,4,+,1565,1864,255;0;0,2,148,145,0,154,1713,1719,6,1
19933ref,1794,1994,JUNC00000073,10,+,1794,1994,255;0;0,2,46,148,0,52,1840,1846,6,1
19933ref,2383,2567,JUNC00000081,13,+,2383,2567,255;0;0,2,29,149,0,35,2412,2418,6,1
19933ref,2645,2948,JUNC00000099,2,-,2645,2948,255;0;0,2,147,150,0,153,2792,2798,6,1
19933ref,5729,6029,JUNC00000148,6,+,5729,6029,255;0;0,2,149,145,0,155,5878,5884,6,1
19933ref,5864,6064,JUNC00000152,44,+,5864,6064,255;0;0,2,148,46,0,154,6012,6018,6,1
19933ref,5936,6236,JUNC00000154,10,-,5936,6236,255;0;0,2,146,148,0,152,6082,6088,6,1
19933ref,6071,6233,JUNC00000161,7,+,6071,6233,255;0;0,2,148,8,0,154,6219,6225,6,1
19933ref,6829,7132,JUNC00000171,64,+,6829,7132,255;0;0,2,148,149,0,154,6977,6983,6,1
19933ref,6971,7274,JUNC00000174,131,+,6971,7274,255;0;0,2,149,148,0,155,7120,7126,6,1
19933ref,7424,7600,JUNC00000182,22,-,7424,7600,255;0;0,2,149,22,0,154,7573,7578,5,1
19933ref,8760,9061,JUNC00000202,6,+,8760,9061,255;0;0,2,148,148,0,153,8908,8913,5,1
19933ref,8829,9078,JUNC00000204,17688,+,8829,9078,255;0;0,2,94,150,0,99,8923,8928,5,1
21337ref,1785,9144,JUNC00000082,25,+,1785,9144,255;0;0,2,51,147,0,7212,1836,8997,7161,1
21337ref,625,7708,JUNC00000030,55,+,625,7708,255;0;0,2,148,148,0,6935,773,7560,6787,1
21337ref,3502,10014,JUNC00000136,22,+,3502,10014,255;0;0,2,149,147,0,6365,3651,9867,6216,1
21337ref,3224,7360,JUNC00000134,78,+,3224,7360,255;0;0,2,8,143,0,3993,3232,7217,3985,1
21337ref,649,4599,JUNC00000022,138,+,649,4599,255;0;0,2,81,44,0,3906,730,4555,3825,1
21337ref,594,4664,JUNC00000019,6,+,594,4664,255;0;0,2,116,148,0,3922,710,4516,3806,1
21337ref,848,4864,JUNC00000046,17,+,848,4864,255;0;0,2,148,87,0,3929,996,4777,3781,1
21337ref,6473,10120,JUNC00000206,257,+,6473,10120,255;0;0,2,118,150,0,3497,6591,9970,3379,1
21337ref,4944,8583,JUNC00000180,364,+,4944,8583,255;0;0,2,144,145,0,3494,5088,8438,3350,1
21337ref,2763,6158,JUNC00000116,28,+,2763,6158,255;0;0,2,43,146,0,3249,2806,6012,3206,1
21337ref,2669,6109,JUNC00000119,169,-,2669,6109,255;0;0,2,147,87,0,3353,2816,6022,3206,1
21337ref,620,3986,JUNC00000027,47,+,620,3986,255;0;0,2,144,92,0,3274,764,3894,3130,1
21337ref,4338,7572,JUNC00000166,69,-,4338,7572,255;0;0,2,148,149,0,3085,4486,7423,2937,1
21337ref,871,4041,JUNC00000049,114,+,871,4041,255;0;0,2,144,147,0,3023,1015,3894,2879,1
21337ref,3956,7042,JUNC00000147,153,-,3956,7042,255;0;0,2,121,150,0,2936,4077,6892,2815,1
21337ref,5018,8021,JUNC00000183,33,+,5018,8021,255;0;0,2,146,148,0,2855,5164,7873,2709,1
21337ref,4124,6449,JUNC00000151,5,+,4124,6449,255;0;0,2,103,147,0,2178,4227,6302,2075,1
21337ref,4090,6462,JUNC00000153,11,-,4090,6462,255;0;0,2,149,148,0,2224,4239,6314,2075,1
21337ref,3197,5037,JUNC00000133,88,+,3197,5037,255;0;0,2,35,146,0,1694,3232,4891,1659,1
21337ref,5762,7617,JUNC00000198,4,+,5762,7617,255;0;0,2,149,148,0,1707,5911,7469,1558,1
21337ref,2692,4521,JUNC00000123,6,+,2692,4521,255;0;0,2,149,149,0,1680,2841,4372,1531,1
21337ref,4525,6182,JUNC00000169,129,-,4525,6182,255;0;0,2,149,147,0,1510,4674,6035,1361,1
21337ref,4542,6202,JUNC00000170,38,-,4542,6202,255;0;0,2,149,150,0,1510,4691,6052,1361,1
21337ref,5533,6831,JUNC00000188,79,+,5533,6831,255;0;0,2,93,149,0,1149,5626,6682,1056,1
21337ref,974,2301,JUNC00000058,19,+,974,2301,255;0;0,2,148,145,0,1182,1122,2156,1034,1
21337ref,7819,9002,JUNC00000244,40,+,7819,9002,255;0;0,2,13,149,0,1034,7832,8853,1021,1
21337ref,650,1852,JUNC00000029,66,-,650,1852,255;0;0,2,120,101,0,1101,770,1751,981,1
21337ref,7854,9062,JUNC00000254,126,+,7854,9062,255;0;0,2,140,147,0,1061,7994,8915,921,1
21337ref,1368,2217,JUNC00000070,126,+,1368,2217,255;0;0,2,148,150,0,699,1516,2067,551,1
21337ref,1377,2224,JUNC00000071,82,+,1377,2224,255;0;0,2,149,147,0,700,1526,2077,551,1
21337ref,6926,7642,JUNC00000218,401,+,6926,7642,255;0;0,2,147,148,0,568,7073,7494,421,1
21337ref,578,1130,JUNC00000010,25,+,578,1130,255;0;0,2,30,145,0,407,608,985,377,1
21337ref,546,1133,JUNC00000014,20,+,546,1133,255;0;0,2,110,118,0,469,656,1015,359,1
21337ref,3901,4410,JUNC00000139,8,-,3901,4410,255;0;0,2,8,145,0,364,3909,4265,356,1
21337ref,5656,6288,JUNC00000193,7,+,5656,6288,255;0;0,2,147,149,0,483,5803,6139,336,1
21337ref,5165,5710,JUNC00000184,266,+,5165,5710,255;0;0,2,140,147,0,398,5305,5563,258,1
21337ref,4134,4647,JUNC00000155,14,-,4134,4647,255;0;0,2,112,150,0,363,4246,4497,251,1
21337ref,2680,3107,JUNC00000122,2,+,2680,3107,255;0;0,2,150,28,0,399,2830,3079,249,1
21337ref,3857,4385,JUNC00000146,13,+,3857,4385,255;0;0,2,148,148,0,380,4005,4237,232,1
21337ref,8570,9044,JUNC00000263,34,+,8570,9044,255;0;0,2,104,142,0,332,8674,8902,228,1
21337ref,4715,5235,JUNC00000175,4,-,4715,5235,255;0;0,2,148,148,0,372,4863,5087,224,1
21337ref,667,1079,JUNC00000023,20,-,667,1079,255;0;0,2,65,147,0,265,732,932,200,1
21337ref,499,878,JUNC00000007,10,+,499,878,255;0;0,2,35,148,0,231,534,730,196,1
21337ref,7411,7771,JUNC00000233,45,-,7411,7771,255;0;0,2,25,148,0,212,7436,7623,187,1
21337ref,5755,6213,JUNC00000197,10,+,5755,6213,255;0;0,2,146,147,0,311,5901,6066,165,1
21337ref,1691,2061,JUNC00000079,60,-,1691,2061,255;0;0,2,60,147,0,223,1751,1914,163,1
21337ref,8789,9232,JUNC00000269,112,+,8789,9232,255;0;0,2,132,149,0,294,8921,9083,162,1
21337ref,5016,5474,JUNC00000182,1056,+,5016,5474,255;0;0,2,148,150,0,308,5164,5324,160,1
21337ref,2429,2769,JUNC00000096,11,-,2429,2769,255;0;0,2,35,148,0,192,2464,2621,157,1
21337ref,617,958,JUNC00000013,45,+,617,958,255;0;0,2,39,146,0,195,656,812,156,1
21337ref,2649,2974,JUNC00000109,17,-,2649,2974,255;0;0,2,21,149,0,176,2670,2825,155,1
21337ref,655,1012,JUNC00000018,17,+,655,1012,255;0;0,2,55,148,0,209,710,864,154,1
21337ref,571,1020,JUNC00000020,159,+,571,1020,255;0;0,2,146,149,0,300,717,871,154,1
21337ref,6596,6893,JUNC00000207,26,+,6596,6893,255;0;0,2,8,143,0,154,6604,6750,146,1
21337ref,8293,8736,JUNC00000260,20,+,8293,8736,255;0;0,2,148,149,0,294,8441,8587,146,1
21337ref,3842,4284,JUNC00000145,68,-,3842,4284,255;0;0,2,148,150,0,292,3990,4134,144,1
21337ref,499,819,JUNC00000006,18,+,499,819,255;0;0,2,35,145,0,175,534,674,140,1
21337ref,1265,1606,JUNC00000068,50,+,1265,1606,255;0;0,2,146,58,0,283,1411,1548,137,1
21337ref,4410,4798,JUNC00000168,17,-,4410,4798,255;0;0,2,129,124,0,264,4539,4674,135,1
21337ref,1122,1548,JUNC00000062,61,+,1122,1548,255;0;0,2,148,146,0,280,1270,1402,132,1
21337ref,2238,2665,JUNC00000092,133,-,2238,2665,255;0;0,2,150,150,0,277,2388,2515,127,1
21337ref,7137,7437,JUNC00000225,36,+,7137,7437,255;0;0,2,26,150,0,150,7163,7287,124,1
21337ref,7156,7440,JUNC00000226,22,+,7156,7440,255;0;0,2,11,149,0,135,7167,7291,124,1
21337ref,2343,2763,JUNC00000099,6,+,2343,2763,255;0;0,2,150,150,0,270,2493,2613,120,1
21337ref,4722,5073,JUNC00000173,51,+,4722,5073,255;0;0,2,93,146,0,205,4815,4927,112,1
21337ref,6723,7031,JUNC00000210,31,+,6723,7031,255;0;0,2,50,150,0,158,6773,6881,108,1
21337ref,2658,2929,JUNC00000110,3,-,2658,2929,255;0;0,2,22,146,0,125,2680,2783,103,1
21337ref,8449,8735,JUNC00000262,24,+,8449,8735,255;0;0,2,36,148,0,138,8485,8587,102,1
21337ref,8759,9158,JUNC00000266,13,+,8759,9158,255;0;0,2,149,148,0,251,8908,9010,102,1
21337ref,2086,2476,JUNC00000088,50,+,2086,2476,255;0;0,2,143,149,0,241,2229,2327,98,1
21337ref,2268,2655,JUNC00000093,45,+,2268,2655,255;0;0,2,150,146,0,241,2418,2509,91,1
21337ref,1757,2055,JUNC00000081,44,-,1757,2055,255;0;0,2,69,143,0,155,1826,1912,86,1
21337ref,3912,4168,JUNC00000140,12,-,3912,4168,255;0;0,2,20,150,0,106,3932,4018,86,1
21337ref,4997,5146,JUNC00000179,26,+,4997,5146,255;0;0,2,35,33,0,116,5032,5113,81,1
21337ref,7284,7551,JUNC00000229,5,+,7284,7551,255;0;0,2,38,149,0,118,7322,7402,80,1
21337ref,9790,10036,JUNC00000282,206,-,9790,10036,255;0;0,2,19,147,0,99,9809,9889,80,1
21337ref,1409,1729,JUNC00000069,126,-,1409,1729,255;0;0,2,97,144,0,176,1506,1585,79,1
21337ref,2941,3170,JUNC00000125,2,-,2941,3170,255;0;0,2,8,144,0,85,2949,3026,77,1
21337ref,614,983,JUNC00000026,11,+,614,983,255;0;0,2,150,144,0,225,764,839,75,1
21337ref,754,993,JUNC00000028,15,-,754,993,255;0;0,2,16,148,0,91,770,845,75,1
21337ref,527,878,JUNC00000012,29,+,527,878,255;0;0,2,129,148,0,203,656,730,74,1
21337ref,9079,9302,JUNC00000275,7,+,9079,9302,255;0;0,2,143,8,0,215,9222,9294,72,1
21337ref,563,887,JUNC00000016,44,+,563,887,255;0;0,2,111,142,0,182,674,745,71,1
21337ref,698,941,JUNC00000034,9,+,698,941,255;0;0,2,148,25,0,218,846,916,70,1
21337ref,6744,7108,JUNC00000213,117,-,6744,7108,255;0;0,2,148,146,0,218,6892,6962,70,1
21337ref,7685,8042,JUNC00000243,63,+,7685,8042,255;0;0,2,140,148,0,209,7825,7894,69,1
21337ref,1818,1969,JUNC00000083,1,+,1818,1969,255;0;0,2,32,51,0,100,1850,1918,68,1
21337ref,485,850,JUNC00000011,207,+,485,850,255;0;0,2,149,149,0,216,634,701,67,1
21337ref,7361,7613,JUNC00000235,160,-,7361,7613,255;0;0,2,150,35,0,217,7511,7578,67,1
21337ref,6158,6517,JUNC00000205,4,+,6158,6517,255;0;0,2,147,146,0,213,6305,6371,66,1
21337ref,2864,3161,JUNC00000124,136,-,2864,3161,255;0;0,2,85,147,0,150,2949,3014,65,1
21337ref,2807,3169,JUNC00000126,9,-,2807,3169,255;0;0,2,149,148,0,214,2956,3021,65,1
21337ref,4200,4460,JUNC00000156,24,-,4200,4460,255;0;0,2,48,148,0,112,4248,4312,64,1
21337ref,2440,2678,JUNC00000100,3,+,2440,2678,255;0;0,2,103,72,0,166,2543,2606,63,1
21337ref,2836,3077,JUNC00000128,13,+,2836,3077,255;0;0,2,146,32,0,209,2982,3045,63,1
21337ref,2667,3025,JUNC00000118,225,-,2667,3025,255;0;0,2,149,147,0,211,2816,2878,62,1
21337ref,7473,7698,JUNC00000234,19,+,7473,7698,255;0;0,2,21,145,0,80,7494,7553,59,1
21337ref,4378,4696,JUNC00000167,103,-,4378,4696,255;0;0,2,119,141,0,177,4497,4555,58,1
21337ref,5510,5817,JUNC00000187,52,+,5510,5817,255;0;0,2,103,146,0,161,5613,5671,58,1
21337ref,834,1077,JUNC00000040,12,+,834,1077,255;0;0,2,44,142,0,101,878,935,57,1
21337ref,955,1307,JUNC00000053,1266,-,955,1307,255;0;0,2,146,149,0,203,1101,1158,57,1
21337ref,3753,3964,JUNC00000137,7,+,3753,3964,255;0;0,2,8,146,0,65,3761,3818,57,1
21337ref,9456,9734,JUNC00000277,2,+,9456,9734,255;0;0,2,74,147,0,131,9530,9587,57,1
21337ref,672,1019,JUNC00000031,84,+,672,1019,255;0;0,2,144,148,0,199,816,871,55,1
21337ref,7697,7956,JUNC00000242,41,-,7697,7956,255;0;0,2,55,150,0,109,7752,7806,54,1
21337ref,826,1170,JUNC00000045,16,+,826,1170,255;0;0,2,143,148,0,196,969,1022,53,1
21337ref,6758,7107,JUNC00000215,30,-,6758,7107,255;0;0,2,148,148,0,201,6906,6959,53,1
21337ref,7987,8339,JUNC00000257,44,+,7987,8339,255;0;0,2,149,150,0,202,8136,8189,53,1
21337ref,1432,1758,JUNC00000074,30,+,1432,1758,255;0;0,2,125,149,0,177,1557,1609,52,1
21337ref,2615,2959,JUNC00000113,26,-,2615,2959,255;0;0,2,146,148,0,196,2761,2811,50,1
21337ref,6758,7104,JUNC00000214,63,-,6758,7104,255;0;0,2,148,148,0,198,6906,6956,50,1
21337ref,9631,9970,JUNC00000280,190,+,9631,9970,255;0;0,2,140,149,0,190,9771,9821,50,1
21337ref,2432,2777,JUNC00000101,16,+,2432,2777,255;0;0,2,148,148,0,197,2580,2629,49,1
21337ref,3068,3268,JUNC00000129,1,+,3068,3268,255;0;0,2,10,141,0,59,3078,3127,49,1
21337ref,3943,4286,JUNC00000148,79,+,3943,4286,255;0;0,2,149,145,0,198,4092,4141,49,1
21337ref,5681,6027,JUNC00000194,2,+,5681,6027,255;0;0,2,149,148,0,198,5830,5879,49,1
21337ref,858,1203,JUNC00000047,2,-,858,1203,255;0;0,2,149,148,0,197,1007,1055,48,1
21337ref,6807,7147,JUNC00000217,2,-,6807,7147,255;0;0,2,144,148,0,192,6951,6999,48,1
21337ref,7815,8037,JUNC00000245,17,+,7815,8037,255;0;0,2,25,149,0,73,7840,7888,48,1
21337ref,8304,8528,JUNC00000261,5,+,8304,8528,255;0;0,2,145,32,0,192,8449,8496,47,1
21337ref,949,1292,JUNC00000052,16,-,949,1292,255;0;0,2,150,147,0,196,1099,1145,46,1
21337ref,2263,2336,JUNC00000089,1,+,2263,2336,255;0;0,2,8,19,0,54,2271,2317,46,1
21337ref,7321,7592,JUNC00000230,62,+,7321,7592,255;0;0,2,80,148,0,123,7401,7444,43,1
21337ref,1498,1740,JUNC00000073,21,-,1498,1740,255;0;0,2,51,149,0,93,1549,1591,42,1
21337ref,599,903,JUNC00000024,21,-,599,903,255;0;0,2,145,118,0,186,744,785,41,1
21337ref,871,1200,JUNC00000048,60,+,871,1200,255;0;0,2,144,145,0,184,1015,1055,40,1
21337ref,2441,2776,JUNC00000103,5,+,2441,2776,255;0;0,2,148,147,0,188,2589,2629,40,1
21337ref,5825,6161,JUNC00000199,40,-,5825,6161,255;0;0,2,147,149,0,187,5972,6012,40,1
21337ref,753,1012,JUNC00000032,40,+,753,1012,255;0;0,2,73,148,0,111,826,864,38,1
21337ref,3830,4167,JUNC00000144,23,-,3830,4167,255;0;0,2,150,149,0,188,3980,4018,38,1
21337ref,7497,7835,JUNC00000237,15,+,7497,7835,255;0;0,2,150,150,0,188,7647,7685,38,1
21337ref,1519,1855,JUNC00000077,4,+,1519,1855,255;0;0,2,149,150,0,186,1668,1705,37,1
21337ref,6587,6814,JUNC00000208,44,-,6587,6814,255;0;0,2,42,148,0,79,6629,6666,37,1
21337ref,2238,2573,JUNC00000091,36,-,2238,2573,255;0;0,2,150,149,0,186,2388,2424,36,1
21337ref,7513,7706,JUNC00000239,3,+,7513,7706,255;0;0,2,147,10,0,183,7660,7696,36,1
21337ref,7709,8041,JUNC00000246,23,+,7709,8041,255;0;0,2,146,150,0,182,7855,7891,36,1
21337ref,9008,9241,JUNC00000273,40,-,9008,9241,255;0;0,2,150,47,0,186,9158,9194,36,1
21337ref,2314,2644,JUNC00000095,12,+,2314,2644,255;0;0,2,148,147,0,183,2462,2497,35,1
21337ref,2444,2776,JUNC00000105,8,-,2444,2776,255;0;0,2,150,147,0,185,2594,2629,35,1
21337ref,2448,2782,JUNC00000107,324,-,2448,2782,255;0;0,2,150,149,0,185,2598,2633,35,1
21337ref,2659,2989,JUNC00000115,28,+,2659,2989,255;0;0,2,147,149,0,181,2806,2840,34,1
21337ref,2433,2640,JUNC00000094,7,-,2433,2640,255;0;0,2,24,150,0,57,2457,2490,33,1
21337ref,2684,2939,JUNC00000111,44,-,2684,2939,255;0;0,2,72,150,0,105,2756,2789,33,1
21337ref,5464,5783,JUNC00000186,42,-,5464,5783,255;0;0,2,136,150,0,169,5600,5633,33,1
21337ref,729,1058,JUNC00000039,16,+,729,1058,255;0;0,2,149,148,0,181,878,910,32,1
21337ref,1498,1731,JUNC00000072,42,-,1498,1731,255;0;0,2,51,150,0,83,1549,1581,32,1
21337ref,7709,8037,JUNC00000249,72,+,7709,8037,255;0;0,2,148,149,0,179,7857,7888,31,1
21337ref,979,1308,JUNC00000060,55,-,979,1308,255;0;0,2,149,150,0,179,1128,1158,30,1
21337ref,2727,2941,JUNC00000112,7,-,2727,2941,255;0;0,2,34,150,0,64,2761,2791,30,1
21337ref,4184,4511,JUNC00000158,16,+,4184,4511,255;0;0,2,147,150,0,177,4331,4361,30,1
21337ref,4211,4531,JUNC00000160,66,-,4211,4531,255;0;0,2,141,149,0,171,4352,4382,30,1
21337ref,4225,4524,JUNC00000162,42,+,4225,4524,255;0;0,2,150,119,0,180,4375,4405,30,1
21337ref,7513,7840,JUNC00000238,16,+,7513,7840,255;0;0,2,147,150,0,177,7660,7690,30,1
21337ref,674,936,JUNC00000025,103,+,674,936,255;0;0,2,90,143,0,119,764,793,29,1
21337ref,4847,5084,JUNC00000178,13,+,4847,5084,255;0;0,2,146,62,0,175,4993,5022,29,1
21337ref,6105,6432,JUNC00000204,14,+,6105,6432,255;0;0,2,150,148,0,179,6255,6284,29,1
21337ref,4232,4555,JUNC00000163,89,+,4232,4555,255;0;0,2,148,147,0,176,4380,4408,28,1
21337ref,949,1271,JUNC00000051,23,+,949,1271,255;0;0,2,146,149,0,173,1095,1122,27,1
21337ref,3183,3434,JUNC00000135,47,-,3183,3434,255;0;0,2,74,150,0,101,3257,3284,27,1
21337ref,3816,4044,JUNC00000138,76,+,3816,4044,255;0;0,2,51,150,0,78,3867,3894,27,1
21337ref,962,1287,JUNC00000055,10,+,962,1287,255;0;0,2,149,150,0,175,1111,1137,26,1
21337ref,3009,3333,JUNC00000130,4,+,3009,3333,255;0;0,2,148,150,0,174,3157,3183,26,1
21337ref,7083,7282,JUNC00000220,2,-,7083,7282,255;0;0,2,25,148,0,51,7108,7134,26,1
21337ref,698,1020,JUNC00000033,20,+,698,1020,255;0;0,2,148,149,0,173,846,871,25,1
21337ref,975,1171,JUNC00000057,5,+,975,1171,255;0;0,2,147,24,0,172,1122,1147,25,1
21337ref,1977,2299,JUNC00000087,8,-,1977,2299,255;0;0,2,148,149,0,173,2125,2150,25,1
21337ref,3022,3220,JUNC00000131,117,+,3022,3220,255;0;0,2,149,24,0,174,3171,3196,25,1
21337ref,7032,7275,JUNC00000219,25,-,7032,7275,255;0;0,2,69,149,0,94,7101,7126,25,1
21337ref,8290,8513,JUNC00000259,23,+,8290,8513,255;0;0,2,148,50,0,173,8438,8463,25,1
21337ref,582,899,JUNC00000021,33,+,582,899,255;0;0,2,148,145,0,172,730,754,24,1
21337ref,1229,1527,JUNC00000064,42,+,1229,1527,255;0;0,2,124,150,0,148,1353,1377,24,1
21337ref,2667,2988,JUNC00000117,4,-,2667,2988,255;0;0,2,149,148,0,173,2816,2840,24,1
21337ref,6967,7286,JUNC00000221,19,-,6967,7286,255;0;0,2,148,147,0,172,7115,7139,24,1
21337ref,8774,9078,JUNC00000265,35,-,8774,9078,255;0;0,2,132,148,0,156,8906,8930,24,1
21337ref,8918,9096,JUNC00000271,10,+,8918,9096,255;0;0,2,95,59,0,119,9013,9037,24,1
21337ref,963,1283,JUNC00000054,33,+,963,1283,255;0;0,2,148,150,0,170,1111,1133,22,1
21337ref,1977,2292,JUNC00000086,7,-,1977,2292,255;0;0,2,148,145,0,170,2125,2147,22,1
21337ref,4326,4522,JUNC00000159,127,-,4326,4522,255;0;0,2,26,148,0,48,4352,4374,22,1
21337ref,4936,5151,JUNC00000177,81,-,4936,5151,255;0;0,2,44,149,0,66,4980,5002,22,1
21337ref,8006,8326,JUNC00000258,102,+,8006,8326,255;0;0,2,148,150,0,170,8154,8176,22,1
21337ref,1691,1924,JUNC00000080,54,+,1691,1924,255;0;0,2,63,149,0,84,1754,1775,21,1
21337ref,2342,2662,JUNC00000098,17,+,2342,2662,255;0;0,2,149,150,0,170,2491,2512,21,1
21337ref,653,842,JUNC00000015,56,+,653,842,255;0;0,2,21,148,0,41,674,694,20,1
21337ref,769,968,JUNC00000041,42,-,769,968,255;0;0,2,149,30,0,169,918,938,20,1
21337ref,5006,5321,JUNC00000181,16,+,5006,5321,255;0;0,2,145,150,0,165,5151,5171,20,1
21337ref,5921,6240,JUNC00000201,25,+,5921,6240,255;0;0,2,149,150,0,169,6070,6090,20,1
21337ref,7115,7432,JUNC00000227,19,-,7115,7432,255;0;0,2,148,149,0,168,7263,7283,20,1
21337ref,1202,1517,JUNC00000063,3,+,1202,1517,255;0;0,2,148,149,0,166,1350,1368,18,1
21337ref,4214,4407,JUNC00000152,10,-,4214,4407,255;0;0,2,25,150,0,43,4239,4257,18,1
21337ref,4622,4927,JUNC00000172,145,+,4622,4927,255;0;0,2,143,144,0,161,4765,4783,18,1
21337ref,967,1283,JUNC00000056,10,+,967,1283,255;0;0,2,149,150,0,166,1116,1133,17,1
21337ref,1645,1830,JUNC00000076,19,+,1645,1830,255;0;0,2,21,147,0,38,1666,1683,17,1
21337ref,2470,2785,JUNC00000108,12,+,2470,2785,255;0;0,2,149,149,0,166,2619,2636,17,1
21337ref,7963,8277,JUNC00000256,60,-,7963,8277,255;0;0,2,149,148,0,166,8112,8129,17,1
21337ref,6905,7100,JUNC00000216,16,-,6905,7100,255;0;0,2,29,150,0,45,6934,6950,16,1
21337ref,7524,7840,JUNC00000240,19,+,7524,7840,255;0;0,2,150,150,0,166,7674,7690,16,1
21337ref,946,1259,JUNC00000050,4,+,946,1259,255;0;0,2,149,149,0,164,1095,1110,15,1
21337ref,2436,2748,JUNC00000102,7,+,2436,2748,255;0;0,2,148,149,0,163,2584,2599,15,1
21337ref,2448,2763,JUNC00000106,21,+,2448,2763,255;0;0,2,150,150,0,165,2598,2613,15,1
21337ref,2680,2994,JUNC00000121,43,+,2680,2994,255;0;0,2,150,149,0,165,2830,2845,15,1
21337ref,4271,4557,JUNC00000165,17,+,4271,4557,255;0;0,2,122,149,0,137,4393,4408,15,1
21337ref,6036,6348,JUNC00000203,6,+,6036,6348,255;0;0,2,147,150,0,162,6183,6198,15,1
21337ref,7959,8270,JUNC00000255,21,+,7959,8270,255;0;0,2,147,149,0,162,8106,8121,15,1
21337ref,2914,3131,JUNC00000127,63,-,2914,3131,255;0;0,2,53,150,0,67,2967,2981,14,1
21337ref,4134,4418,JUNC00000157,36,+,4134,4418,255;0;0,2,123,147,0,137,4257,4271,14,1
21337ref,7009,7321,JUNC00000224,2,-,7009,7321,255;0;0,2,149,149,0,163,7158,7172,14,1
21337ref,7262,7572,JUNC00000232,12,-,7262,7572,255;0;0,2,147,149,0,161,7409,7423,14,1
21337ref,7794,8099,JUNC00000252,79,+,7794,8099,255;0;0,2,144,147,0,158,7938,7952,14,1
21337ref,7842,8007,JUNC00000253,1,-,7842,8007,255;0;0,2,122,29,0,136,7964,7978,14,1
21337ref,9125,9292,JUNC00000276,2,+,9125,9292,255;0;0,2,145,8,0,159,9270,9284,14,1
21337ref,324,636,JUNC00000003,309,+,324,636,255;0;0,2,150,149,0,163,474,487,13,1
21337ref,329,638,JUNC00000004,5,+,329,638,255;0;0,2,148,148,0,161,477,490,13,1
21337ref,1457,1768,JUNC00000075,85,+,1457,1768,255;0;0,2,148,150,0,161,1605,1618,13,1
21337ref,2192,2502,JUNC00000090,3,+,2192,2502,255;0;0,2,149,148,0,162,2341,2354,13,1
21337ref,4024,4297,JUNC00000150,150,+,4024,4297,255;0;0,2,112,148,0,125,4136,4149,13,1
21337ref,5692,5945,JUNC00000195,3,+,5692,5945,255;0;0,2,149,91,0,162,5841,5854,13,1
21337ref,7261,7448,JUNC00000228,77,-,7261,7448,255;0;0,2,26,148,0,39,7287,7300,13,1
21337ref,8891,9076,JUNC00000267,12,+,8891,9076,255;0;0,2,24,148,0,37,8915,8928,13,1
21337ref,10128,10438,JUNC00000284,12,-,10128,10438,255;0;0,2,147,150,0,160,10275,10288,13,1
21337ref,2677,2978,JUNC00000120,5,-,2677,2978,255;0;0,2,143,146,0,155,2820,2832,12,1
21337ref,5608,5919,JUNC00000191,4,+,5608,5919,255;0;0,2,149,150,0,161,5757,5769,12,1
21337ref,5615,5925,JUNC00000192,23,+,5615,5925,255;0;0,2,148,150,0,160,5763,5775,12,1
21337ref,6967,7137,JUNC00000222,27,+,6967,7137,255;0;0,2,150,8,0,162,7117,7129,12,1
21337ref,8775,9082,JUNC00000268,24,-,8775,9082,255;0;0,2,146,149,0,158,8921,8933,12,1
21337ref,332,641,JUNC00000005,16,+,332,641,255;0;0,2,149,149,0,160,481,492,11,1
21337ref,701,870,JUNC00000017,320,+,701,870,255;0;0,2,9,149,0,20,710,721,11,1
21337ref,707,1015,JUNC00000036,8,-,707,1015,255;0;0,2,148,149,0,159,855,866,11,1
21337ref,721,1028,JUNC00000038,106,+,721,1028,255;0;0,2,146,150,0,157,867,878,11,1
21337ref,1577,1885,JUNC00000078,21,-,1577,1885,255;0;0,2,148,149,0,159,1725,1736,11,1
21337ref,1846,2155,JUNC00000084,3,-,1846,2155,255;0;0,2,149,149,0,160,1995,2006,11,1
21337ref,6768,7047,JUNC00000212,83,-,6768,7047,255;0;0,2,124,144,0,135,6892,6903,11,1
21337ref,800,1099,JUNC00000043,9,-,800,1099,255;0;0,2,143,146,0,153,943,953,10,1
21337ref,4834,5000,JUNC00000174,16,-,4834,5000,255;0;0,2,9,147,0,19,4843,4853,10,1
21337ref,7708,8016,JUNC00000248,4,+,7708,8016,255;0;0,2,149,149,0,159,7857,7867,10,1
21337ref,8692,8998,JUNC00000264,23,+,8692,8998,255;0;0,2,149,147,0,159,8841,8851,10,1
21337ref,304,487,JUNC00000002,65,+,304,487,255;0;0,2,150,24,0,159,454,463,9,1
21337ref,1239,1544,JUNC00000065,3,-,1239,1544,255;0;0,2,147,149,0,156,1386,1395,9,1
21337ref,2471,2640,JUNC00000097,21,+,2471,2640,255;0;0,2,10,150,0,19,2481,2490,9,1
21337ref,2655,2958,JUNC00000114,10,-,2655,2958,255;0;0,2,147,147,0,156,2802,2811,9,1
21337ref,4790,5092,JUNC00000176,33,+,4790,5092,255;0;0,2,145,148,0,154,4935,4944,9,1
21337ref,5248,5551,JUNC00000185,219,+,5248,5551,255;0;0,2,150,144,0,159,5398,5407,9,1
21337ref,9030,9198,JUNC00000274,10,+,9030,9198,255;0;0,2,149,10,0,158,9179,9188,9,1
21337ref,1002,1307,JUNC00000061,87,-,1002,1307,255;0;0,2,148,149,0,156,1150,1158,8,1
21337ref,5956,6166,JUNC00000200,63,+,5956,6166,255;0;0,2,56,146,0,64,6012,6020,8,1
21337ref,294,596,JUNC00000001,24,+,294,596,255;0;0,2,148,147,0,155,442,449,7,1
21337ref,824,1125,JUNC00000044,88,+,824,1125,255;0;0,2,145,149,0,152,969,976,7,1
21337ref,1857,2162,JUNC00000085,29,+,1857,2162,255;0;0,2,150,148,0,157,2007,2014,7,1
21337ref,3047,3213,JUNC00000132,32,-,3047,3213,255;0;0,2,150,9,0,157,3197,3204,7,1
21337ref,3931,4110,JUNC00000142,22,+,3931,4110,255;0;0,2,23,149,0,30,3954,3961,7,1
21337ref,4229,4532,JUNC00000161,4,-,4229,4532,255;0;0,2,146,150,0,153,4375,4382,7,1
21337ref,4563,4868,JUNC00000171,13,+,4563,4868,255;0;0,2,150,148,0,157,4713,4720,7,1
21337ref,7539,7846,JUNC00000241,12,+,7539,7846,255;0;0,2,150,150,0,157,7689,7696,7,1
21337ref,7712,8013,JUNC00000247,8,+,7712,8013,255;0;0,2,145,149,0,152,7857,7864,7,1
21337ref,7718,8021,JUNC00000250,9,+,7718,8021,255;0;0,2,148,148,0,155,7866,7873,7,1
21337ref,534,592,JUNC00000008,3,+,534,592,255;0;0,2,18,34,0,24,552,558,6,1
21337ref,423,725,JUNC00000009,4,+,423,725,255;0;0,2,148,148,0,154,571,577,6,1
21337ref,712,1012,JUNC00000037,7,-,712,1012,255;0;0,2,148,146,0,154,860,866,6,1
21337ref,2444,2748,JUNC00000104,9,+,2444,2748,255;0;0,2,149,149,0,155,2593,2599,6,1
21337ref,4235,4414,JUNC00000164,196,-,4235,4414,255;0;0,2,147,26,0,153,4382,4388,6,1
21337ref,5728,6033,JUNC00000196,28,+,5728,6033,255;0;0,2,150,149,0,156,5878,5884,6,1
21337ref,6600,6904,JUNC00000209,8,+,6600,6904,255;0;0,2,149,149,0,155,6749,6755,6,1
21337ref,8953,9256,JUNC00000272,13,-,8953,9256,255;0;0,2,149,148,0,155,9102,9108,6,1
21337ref,707,1009,JUNC00000035,15,-,707,1009,255;0;0,2,148,149,0,153,855,860,5,1
21337ref,911,1083,JUNC00000042,11,+,911,1083,255;0;0,2,19,148,0,24,930,935,5,1
21337ref,980,1141,JUNC00000059,19,-,980,1141,255;0;0,2,148,8,0,153,1128,1133,5,1
21337ref,1244,1547,JUNC00000066,18,+,1244,1547,255;0;0,2,149,149,0,154,1393,1398,5,1
21337ref,1314,1512,JUNC00000067,2,+,1314,1512,255;0;0,2,97,96,0,102,1411,1416,5,1
21337ref,3936,4106,JUNC00000141,22,-,3936,4106,255;0;0,2,15,150,0,20,3951,3956,5,1
21337ref,3933,4111,JUNC00000143,65,+,3933,4111,255;0;0,2,23,150,0,28,3956,3961,5,1
21337ref,3970,4274,JUNC00000149,8,+,3970,4274,255;0;0,2,150,149,0,155,4120,4125,5,1
21337ref,4092,4395,JUNC00000154,3,-,4092,4395,255;0;0,2,150,148,0,155,4242,4247,5,1
21337ref,5538,5791,JUNC00000189,17,-,5538,5791,255;0;0,2,100,148,0,105,5638,5643,5,1
21337ref,5514,5817,JUNC00000190,9,-,5514,5817,255;0;0,2,150,148,0,155,5664,5669,5,1
21337ref,5955,6248,JUNC00000202,17,+,5955,6248,255;0;0,2,150,138,0,155,6105,6110,5,1
21337ref,6774,6951,JUNC00000211,49,-,6774,6951,255;0;0,2,24,148,0,29,6798,6803,5,1
21337ref,6988,7252,JUNC00000223,75,+,6988,7252,255;0;0,2,149,110,0,154,7137,7142,5,1
21337ref,7343,7556,JUNC00000231,87,-,7343,7556,255;0;0,2,61,147,0,66,7404,7409,5,1
21337ref,7423,7647,JUNC00000236,19,-,7423,7647,255;0;0,2,150,69,0,155,7573,7578,5,1
21337ref,7725,8027,JUNC00000251,15,-,7725,8027,255;0;0,2,150,147,0,155,7875,7880,5,1
21337ref,8779,9078,JUNC00000270,3046,+,8779,9078,255;0;0,2,144,150,0,149,8923,8928,5,1
21337ref,9561,9765,JUNC00000278,33,+,9561,9765,255;0;0,2,52,147,0,57,9613,9618,5,1
21337ref,9479,9779,JUNC00000279,356,+,9479,9779,255;0;0,2,148,147,0,153,9627,9632,5,1
21337ref,9788,9963,JUNC00000281,3,-,9788,9963,255;0;0,2,21,149,0,26,9809,9814,5,1
21337ref,9890,10073,JUNC00000283,106,+,9890,10073,255;0;0,2,30,148,0,35,9920,9925,5,1
16504ref2,1006,10037,JUNC00000025,1,+,1006,10037,255;0;0,2,9,26,0,9005,1015,10011,8996,0
16504ref2,1972,10275,JUNC00000061,1,+,1972,10275,255;0;0,2,9,142,0,8161,1981,10133,8152,0
16504ref2,1037,7873,JUNC00000027,2,+,1037,7873,255;0;0,2,8,120,0,6716,1045,7753,6708,0
16504ref2,1005,7719,JUNC00000024,29,+,1005,7719,255;0;0,2,10,145,0,6569,1015,7574,6559,0
16504ref2,878,7735,JUNC00000026,175,+,878,7735,255;0;0,2,148,150,0,6707,1026,7585,6559,0
16504ref2,1839,8578,JUNC00000060,5,-,1839,8578,255;0;0,2,94,145,0,6594,1933,8433,6500,0
16504ref2,4055,9345,JUNC00000090,7,+,4055,9345,255;0;0,2,20,141,0,5149,4075,9204,5129,0
16504ref2,5041,10220,JUNC00000119,1,+,5041,10220,255;0;0,2,123,28,0,5151,5164,10192,5028,0
16504ref2,1078,6254,JUNC00000030,1,-,1078,6254,255;0;0,2,23,128,0,5048,1101,6126,5025,0
16504ref2,2499,7637,JUNC00000073,1,-,2499,7637,255;0;0,2,108,43,0,5095,2607,7594,4987,0
16504ref2,4582,9765,JUNC00000108,8,+,4582,9765,255;0;0,2,142,147,0,5036,4724,9618,4894,0
16504ref2,4296,9298,JUNC00000100,3,+,4296,9298,255;0;0,2,79,147,0,4855,4375,9151,4776,0
16504ref2,4165,9088,JUNC00000093,1,-,4165,9088,255;0;0,2,62,89,0,4834,4227,8999,4772,0
16504ref2,1282,6156,JUNC00000042,1,+,1282,6156,255;0;0,2,101,50,0,4824,1383,6106,4723,0
16504ref2,4555,9080,JUNC00000105,18,+,4555,9080,255;0;0,2,11,140,0,4385,4566,8940,4374,0
16504ref2,4102,8583,JUNC00000092,1,-,4102,8583,255;0;0,2,48,103,0,4378,4150,8480,4330,0
16504ref2,1846,6244,JUNC00000062,4,+,1846,6244,255;0;0,2,149,19,0,4379,1995,6225,4230,0
16504ref2,379,4051,JUNC00000005,11,-,379,4051,255;0;0,2,149,145,0,3527,528,3906,3378,0
16504ref2,2666,6178,JUNC00000074,3,-,2666,6178,255;0;0,2,80,126,0,3386,2746,6052,3306,0
16504ref2,2670,6059,JUNC00000077,3,-,2670,6059,255;0;0,2,146,37,0,3352,2816,6022,3206,0
16504ref2,962,4203,JUNC00000031,2,+,962,4203,255;0;0,2,149,146,0,3095,1111,4057,2946,0
16504ref2,6124,9081,JUNC00000131,1,+,6124,9081,255;0;0,2,47,104,0,2853,6171,8977,2806,0
16504ref2,6193,9094,JUNC00000132,1,+,6193,9094,255;0;0,2,54,97,0,2804,6247,8997,2750,0
16504ref2,7694,10465,JUNC00000166,30,-,7694,10465,255;0;0,2,146,150,0,2621,7840,10315,2475,0
16504ref2,7723,10441,JUNC00000169,4991,+,7723,10441,255;0;0,2,150,150,0,2568,7873,10291,2418,0
16504ref2,1226,3389,JUNC00000038,1,+,1226,3389,255;0;0,2,82,69,0,2094,1308,3320,2012,0
16504ref2,7809,9945,JUNC00000170,2,+,7809,9945,255;0;0,2,107,150,0,1986,7916,9795,1879,0
16504ref2,6605,8695,JUNC00000136,19,+,6605,8695,255;0;0,2,144,149,0,1941,6749,8546,1797,0
16504ref2,4854,6330,JUNC00000114,1,-,4854,6330,255;0;0,2,84,67,0,1409,4938,6263,1325,0
16504ref2,6115,7564,JUNC00000134,6,+,6115,7564,255;0;0,2,146,11,0,1438,6261,7553,1292,0
16504ref2,7652,8991,JUNC00000161,2,+,7652,8991,255;0;0,2,148,49,0,1290,7800,8942,1142,0
16504ref2,1262,2536,JUNC00000037,10,-,1262,2536,255;0;0,2,18,143,0,1131,1280,2393,1113,0
16504ref2,7423,8644,JUNC00000150,9,-,7423,8644,255;0;0,2,150,24,0,1197,7573,8620,1047,0
16504ref2,4990,6247,JUNC00000116,3,-,4990,6247,255;0;0,2,140,103,0,1154,5130,6144,1014,0
16504ref2,1225,2496,JUNC00000040,3,+,1225,2496,255;0;0,2,131,149,0,1122,1356,2347,991,0
16504ref2,2978,4099,JUNC00000079,2,+,2978,4099,255;0;0,2,41,110,0,1011,3019,3989,970,0
16504ref2,3978,5005,JUNC00000089,2,+,3978,5005,255;0;0,2,97,54,0,973,4075,4951,876,0
16504ref2,7998,9022,JUNC00000172,30,+,7998,9022,255;0;0,2,9,145,0,879,8007,8877,870,0
16504ref2,9091,10115,JUNC00000197,99,+,9091,10115,255;0;0,2,146,145,0,879,9237,9970,733,0
16504ref2,4597,5454,JUNC00000106,7,-,4597,5454,255;0;0,2,77,147,0,710,4674,5307,633,0
16504ref2,315,1133,JUNC00000003,27,+,315,1133,255;0;0,2,60,131,0,687,375,1002,627,0
16504ref2,6854,7627,JUNC00000138,1,-,6854,7627,255;0;0,2,107,44,0,729,6961,7583,622,0
16504ref2,2248,3011,JUNC00000066,2,-,2248,3011,255;0;0,2,112,39,0,724,2360,2972,612,0
16504ref2,4260,4949,JUNC00000095,1,-,4260,4949,255;0;0,2,27,124,0,565,4287,4825,538,0
16504ref2,294,961,JUNC00000004,1,-,294,961,255;0;0,2,143,8,0,659,437,953,516,0
16504ref2,1237,1884,JUNC00000045,4,-,1237,1884,255;0;0,2,149,13,0,634,1386,1871,485,0
16504ref2,468,1133,JUNC00000006,14,+,468,1133,255;0;0,2,66,118,0,547,534,1015,481,0
16504ref2,398,1133,JUNC00000007,6,+,398,1133,255;0;0,2,148,131,0,604,546,1002,456,0
16504ref2,7566,8062,JUNC00000152,8,+,7566,8062,255;0;0,2,57,21,0,475,7623,8041,418,0
16504ref2,8954,9506,JUNC00000190,17,+,8954,9506,255;0;0,2,150,28,0,524,9104,9478,374,0
16504ref2,4541,5077,JUNC00000107,2,-,4541,5077,255;0;0,2,148,23,0,513,4689,5054,365,0
16504ref2,5356,5870,JUNC00000122,2,-,5356,5870,255;0;0,2,93,58,0,456,5449,5812,363,0
16504ref2,6157,6745,JUNC00000133,4,+,6157,6745,255;0;0,2,92,141,0,447,6249,6604,355,0
16504ref2,650,1133,JUNC00000009,7,+,650,1133,255;0;0,2,24,118,0,365,674,1015,341,0
16504ref2,617,1150,JUNC00000010,8,-,617,1150,255;0;0,2,59,133,0,400,676,1017,341,0
16504ref2,5375,5856,JUNC00000121,1,+,5375,5856,255;0;0,2,43,108,0,373,5418,5748,330,0
16504ref2,576,1092,JUNC00000012,39,-,576,1092,255;0;0,2,147,45,0,471,723,1047,324,0
16504ref2,6753,7356,JUNC00000137,3,+,6753,7356,255;0;0,2,150,142,0,461,6903,7214,311,0
16504ref2,1905,2363,JUNC00000063,1,-,1905,2363,255;0;0,2,142,9,0,449,2047,2354,307,0
16504ref2,871,1452,JUNC00000023,22,+,871,1452,255;0;0,2,144,144,0,437,1015,1308,293,0
16504ref2,3799,4243,JUNC00000086,10,+,3799,4243,255;0;0,2,125,26,0,418,3924,4217,293,0
16504ref2,7568,8006,JUNC00000158,1,+,7568,8006,255;0;0,2,131,20,0,418,7699,7986,287,0
16504ref2,593,1024,JUNC00000013,2,+,593,1024,255;0;0,2,145,9,0,422,738,1015,277,0
16504ref2,7338,7767,JUNC00000143,23,-,7338,7767,255;0;0,2,71,82,0,347,7409,7685,276,0
16504ref2,7313,7716,JUNC00000141,1,+,7313,7716,255;0;0,2,9,126,0,277,7322,7590,268,0
16504ref2,7964,8517,JUNC00000176,665,+,7964,8517,255;0;0,2,148,142,0,411,8112,8375,263,0
16504ref2,9666,10061,JUNC00000201,2,+,9666,10061,255;0;0,2,83,68,0,327,9749,9993,244,0
16504ref2,4291,4658,JUNC00000097,1,+,4291,4658,255;0;0,2,32,92,0,275,4323,4566,243,0
16504ref2,4800,5192,JUNC00000110,1,+,4800,5192,255;0;0,2,9,142,0,250,4809,5050,241,0
16504ref2,8598,8977,JUNC00000184,1,+,8598,8977,255;0;0,2,76,75,0,304,8674,8902,228,0
16504ref2,9888,10264,JUNC00000204,1,+,9888,10264,255;0;0,2,52,99,0,277,9940,10165,225,0
16504ref2,2667,3142,JUNC00000076,21,-,2667,3142,255;0;0,2,149,105,0,370,2816,3037,221,0
16504ref2,2425,2792,JUNC00000067,3,+,2425,2792,255;0;0,2,56,95,0,272,2481,2697,216,0
16504ref2,7686,8194,JUNC00000164,9,+,7686,8194,255;0;0,2,146,147,0,361,7832,8047,215,0
16504ref2,9645,10010,JUNC00000200,1,-,9645,10010,255;0;0,2,43,108,0,257,9688,9902,214,0
16504ref2,4357,4715,JUNC00000101,2,+,4357,4715,255;0;0,2,21,130,0,228,4378,4585,207,0
16504ref2,9728,10071,JUNC00000202,1,-,9728,10071,255;0;0,2,81,70,0,273,9809,10001,192,0
16504ref2,7385,7727,JUNC00000144,2,-,7385,7727,255;0;0,2,51,100,0,242,7436,7627,191,0
16504ref2,8744,9058,JUNC00000185,1,+,8744,9058,255;0;0,2,43,81,0,233,8787,8977,190,0
16504ref2,607,1087,JUNC00000014,6,-,607,1087,255;0;0,2,150,147,0,333,757,940,183,0
16504ref2,622,962,JUNC00000015,105,-,622,962,255;0;0,2,148,9,0,331,770,953,183,0
16504ref2,7551,7995,JUNC00000157,21,+,7551,7995,255;0;0,2,148,122,0,322,7699,7873,174,0
16504ref2,5917,6264,JUNC00000127,2,+,5917,6264,255;0;0,2,26,148,0,199,5943,6116,173,0
16504ref2,7552,7984,JUNC00000156,8,+,7552,7984,255;0;0,2,147,117,0,315,7699,7867,168,0
16504ref2,5016,5446,JUNC00000118,16,+,5016,5446,255;0;0,2,148,122,0,308,5164,5324,160,0
16504ref2,7697,8140,JUNC00000165,2,+,7697,8140,255;0;0,2,140,146,0,297,7837,7994,157,0
16504ref2,7585,8036,JUNC00000160,21,+,7585,8036,255;0;0,2,148,148,0,303,7733,7888,155,0
16504ref2,708,1018,JUNC00000011,9,+,708,1018,255;0;0,2,9,147,0,163,717,871,154,0
16504ref2,1265,1606,JUNC00000047,21,+,1265,1606,255;0;0,2,146,41,0,300,1411,1565,154,0
16504ref2,8115,8419,JUNC00000177,1,+,8115,8419,255;0;0,2,123,27,0,277,8238,8392,154,0
16504ref2,175,479,JUNC00000001,1,-,175,479,255;0;0,2,56,95,0,209,231,384,153,0
16504ref2,2891,3321,JUNC00000080,4732,+,2891,3321,255;0;0,2,149,143,0,287,3040,3178,138,0
16504ref2,1238,1672,JUNC00000044,8,-,1238,1672,255;0;0,2,148,149,0,285,1386,1523,137,0
16504ref2,1263,1606,JUNC00000046,31,+,1263,1606,255;0;0,2,148,58,0,285,1411,1548,137,0
16504ref2,8368,8803,JUNC00000182,1693,+,8368,8803,255;0;0,2,149,149,0,286,8517,8654,137,0
16504ref2,4394,4736,JUNC00000104,19,-,4394,4736,255;0;0,2,145,62,0,280,4539,4674,135,0
16504ref2,4016,4300,JUNC00000091,3,-,4016,4300,255;0;0,2,91,60,0,224,4107,4240,133,0
16504ref2,8483,8766,JUNC00000183,2,+,8483,8766,255;0;0,2,143,8,0,275,8626,8758,132,0
16504ref2,3758,4170,JUNC00000085,38,+,3758,4170,255;0;0,2,136,145,0,267,3894,4025,131,0
16504ref2,9057,9473,JUNC00000195,3,-,9057,9473,255;0;0,2,149,143,0,273,9206,9330,124,0
16504ref2,474,725,JUNC00000008,2,+,474,725,255;0;0,2,78,51,0,200,552,674,122,0
16504ref2,4631,4952,JUNC00000109,2,-,4631,4952,255;0;0,2,135,66,0,255,4766,4886,120,0
16504ref2,2436,2810,JUNC00000070,8,+,2436,2810,255;0;0,2,142,115,0,259,2578,2695,117,0
16504ref2,2434,2732,JUNC00000071,10,+,2434,2732,255;0;0,2,146,35,0,263,2580,2697,117,0
16504ref2,9766,10034,JUNC00000203,1,-,9766,10034,255;0;0,2,97,54,0,214,9863,9980,117,0
16504ref2,2389,2772,JUNC00000068,4,-,2389,2772,255;0;0,2,147,120,0,263,2536,2652,116,0
16504ref2,4176,4449,JUNC00000096,2,+,4176,4449,255;0;0,2,147,14,0,259,4323,4435,112,0
16504ref2,767,1027,JUNC00000016,4,+,767,1027,255;0;0,2,16,135,0,125,783,892,109,0
16504ref2,4717,5011,JUNC00000111,2,+,4717,5011,255;0;0,2,144,60,0,234,4861,4951,90,0
16504ref2,1718,2057,JUNC00000057,28,-,1718,2057,255;0;0,2,108,145,0,194,1826,1912,86,0
16504ref2,8301,8684,JUNC00000180,2,+,8301,8684,255;0;0,2,148,149,0,234,8449,8535,86,0
16504ref2,5777,6018,JUNC00000126,8,+,5777,6018,255;0;0,2,149,9,0,232,5926,6009,83,0
16504ref2,7837,8066,JUNC00000171,1,-,7837,8066,255;0;0,2,127,24,0,205,7964,8042,78,0
16504ref2,8974,9345,JUNC00000191,4,+,8974,9345,255;0;0,2,146,148,0,223,9120,9197,77,0
16504ref2,99,445,JUNC00000002,213,+,99,445,255;0;0,2,150,121,0,225,249,324,75,0
16504ref2,1682,1972,JUNC00000053,10,-,1682,1972,255;0;0,2,69,146,0,144,1751,1826,75,0
16504ref2,7252,7507,JUNC00000140,606,-,7252,7507,255;0;0,2,35,146,0,109,7287,7361,74,0
16504ref2,8986,9345,JUNC00000192,2,+,8986,9345,255;0;0,2,146,141,0,218,9132,9204,72,0
16504ref2,1800,2031,JUNC00000056,3,-,1800,2031,255;0;0,2,15,146,0,85,1815,1885,70,0
16504ref2,1625,1985,JUNC00000055,2,-,1625,1985,255;0;0,2,144,147,0,213,1769,1838,69,0
16504ref2,7362,7727,JUNC00000147,320,-,7362,7727,255;0;0,2,149,149,0,216,7511,7578,67,0
16504ref2,7400,7701,JUNC00000145,11,+,7400,7701,255;0;0,2,94,141,0,160,7494,7560,66,0
16504ref2,4857,4995,JUNC00000112,10,-,4857,4995,255;0;0,2,22,51,0,87,4879,4944,65,0
16504ref2,7363,7721,JUNC00000146,2,-,7363,7721,255;0;0,2,148,147,0,211,7511,7574,63,0
16504ref2,8291,8645,JUNC00000179,102,+,8291,8645,255;0;0,2,147,144,0,210,8438,8501,63,0
16504ref2,1718,1931,JUNC00000058,1,-,1718,1931,255;0;0,2,132,19,0,194,1850,1912,62,0
16504ref2,9195,9553,JUNC00000198,1128,+,9195,9553,255;0;0,2,150,146,0,212,9345,9407,62,0
16504ref2,10049,10263,JUNC00000207,5,+,10049,10263,255;0;0,2,143,9,0,205,10192,10254,62,0
16504ref2,7579,7929,JUNC00000159,5,+,7579,7929,255;0;0,2,149,140,0,210,7728,7789,61,0
16504ref2,4365,4691,JUNC00000103,85,-,4365,4691,255;0;0,2,132,136,0,190,4497,4555,58,0
16504ref2,4780,4989,JUNC00000113,1,-,4780,4989,255;0;0,2,127,24,0,185,4907,4965,58,0
16504ref2,8379,8588,JUNC00000181,2,+,8379,8588,255;0;0,2,109,42,0,167,8488,8546,58,0
16504ref2,956,1281,JUNC00000029,1127,-,956,1281,255;0;0,2,145,123,0,202,1101,1158,57,0
16504ref2,1749,1957,JUNC00000054,1,-,1749,1957,255;0;0,2,20,131,0,77,1769,1826,57,0
16504ref2,5856,6064,JUNC00000128,1,+,5856,6064,255;0;0,2,109,42,0,166,5965,6022,57,0
16504ref2,7560,7699,JUNC00000151,12,+,7560,7699,255;0;0,2,56,28,0,111,7616,7671,55,0
16504ref2,7995,8200,JUNC00000174,2,+,7995,8200,255;0;0,2,63,88,0,117,8058,8112,54,0
16504ref2,8930,9156,JUNC00000189,3,-,8930,9156,255;0;0,2,148,24,0,202,9078,9132,54,0
16504ref2,825,1169,JUNC00000022,40,+,825,1169,255;0;0,2,144,147,0,197,969,1022,53,0
16504ref2,721,924,JUNC00000017,1,+,721,924,255;0;0,2,105,46,0,157,826,878,52,0
16504ref2,8908,9111,JUNC00000188,11,-,8908,9111,255;0;0,2,148,8,0,195,9056,9103,47,0
16504ref2,7385,7727,JUNC00000148,27,-,7385,7727,255;0;0,2,147,149,0,193,7532,7578,46,0
16504ref2,1152,1348,JUNC00000036,1,+,1152,1348,255;0;0,2,118,33,0,163,1270,1315,45,0
16504ref2,7658,7995,JUNC00000163,8,-,7658,7995,255;0;0,2,148,146,0,191,7806,7849,43,0
16504ref2,1492,1684,JUNC00000048,1,-,1492,1684,255;0;0,2,57,93,0,99,1549,1591,42,0
16504ref2,7219,7556,JUNC00000142,2,+,7219,7556,255;0;0,2,148,147,0,190,7367,7409,42,0
16504ref2,3235,3409,JUNC00000083,1,+,3235,3409,255;0;0,2,118,15,0,159,3353,3394,41,0
16504ref2,5590,5921,JUNC00000125,28,+,5590,5921,255;0;0,2,146,146,0,185,5736,5775,39,0
16504ref2,7575,7847,JUNC00000154,3,+,7575,7847,255;0;0,2,85,148,0,124,7660,7699,39,0
16504ref2,6507,6700,JUNC00000135,2,-,6507,6700,255;0;0,2,122,34,0,159,6629,6666,37,0
16504ref2,7598,7785,JUNC00000153,1,+,7598,7785,255;0;0,2,62,89,0,98,7660,7696,36,0
16504ref2,1216,1422,JUNC00000041,12,-,1216,1422,255;0;0,2,147,24,0,182,1363,1398,35,0
16504ref2,2449,2781,JUNC00000072,990,-,2449,2781,255;0;0,2,149,148,0,184,2598,2633,35,0
16504ref2,2740,2987,JUNC00000075,3,+,2740,2987,255;0;0,2,66,147,0,100,2806,2840,34,0
16504ref2,946,1274,JUNC00000028,4,+,946,1274,255;0;0,2,149,146,0,182,1095,1128,33,0
16504ref2,5585,5778,JUNC00000123,147,-,5585,5778,255;0;0,2,15,145,0,48,5600,5633,33,0
16504ref2,7956,8243,JUNC00000175,3,-,7956,8243,255;0;0,2,105,149,0,138,8061,8094,33,0
16504ref2,8869,9078,JUNC00000186,27,-,8869,9078,255;0;0,2,26,150,0,59,8895,8928,33,0
16504ref2,9527,9643,JUNC00000199,2,-,9527,9643,255;0;0,2,60,23,0,93,9587,9620,33,0
16504ref2,731,1006,JUNC00000018,4,+,731,1006,255;0;0,2,147,96,0,179,878,910,32,0
16504ref2,5830,6157,JUNC00000129,4,+,5830,6157,255;0;0,2,146,150,0,177,5976,6007,31,0
16504ref2,7708,8037,JUNC00000167,17,+,7708,8037,255;0;0,2,149,149,0,180,7857,7888,31,0
16504ref2,1503,1684,JUNC00000049,1,-,1503,1684,255;0;0,2,78,73,0,108,1581,1611,30,0
16504ref2,4291,4523,JUNC00000098,168,-,4291,4523,255;0;0,2,61,141,0,91,4352,4382,30,0
16504ref2,4232,4453,JUNC00000099,21,+,4232,4453,255;0;0,2,143,48,0,173,4375,4405,30,0
16504ref2,9077,9324,JUNC00000196,8,+,9077,9324,255;0;0,2,148,69,0,178,9225,9255,30,0
16504ref2,7873,8053,JUNC00000173,4,+,7873,8053,255;0;0,2,142,9,0,171,8015,8044,29,0
16504ref2,10019,10266,JUNC00000206,360,+,10019,10266,255;0;0,2,145,74,0,173,10164,10192,28,0
16504ref2,3127,3433,JUNC00000081,51,-,3127,3433,255;0;0,2,130,149,0,157,3257,3284,27,0
16504ref2,1729,1783,JUNC00000051,1,+,1729,1783,255;0;0,2,20,8,0,46,1749,1775,26,0
16504ref2,1729,1924,JUNC00000052,6,+,1729,1924,255;0;0,2,22,147,0,48,1751,1777,26,0
16504ref2,974,1165,JUNC00000033,31,+,974,1165,255;0;0,2,148,18,0,173,1122,1147,25,0
16504ref2,3778,3917,JUNC00000084,1,+,3778,3917,255;0;0,2,92,23,0,116,3870,3894,24,0
16504ref2,5566,5776,JUNC00000124,466,-,5566,5776,255;0;0,2,38,148,0,62,5604,5628,24,0
16504ref2,3952,4158,JUNC00000088,4,+,3952,4158,255;0;0,2,93,91,0,115,4045,4067,22,0
16504ref2,973,1285,JUNC00000032,3,+,973,1285,255;0;0,2,143,148,0,164,1116,1137,21,0
16504ref2,7798,7972,JUNC00000162,6,-,7798,7972,255;0;0,2,8,145,0,29,7806,7827,21,0
16504ref2,977,1297,JUNC00000034,263,+,977,1297,255;0;0,2,150,150,0,170,1127,1147,20,0
16504ref2,5001,5320,JUNC00000117,8,+,5001,5320,255;0;0,2,150,149,0,170,5151,5171,20,0
16504ref2,951,1134,JUNC00000021,36,+,951,1134,255;0;0,2,18,149,0,34,969,985,16,0
16504ref2,7540,7797,JUNC00000155,5,-,7540,7797,255;0;0,2,145,96,0,161,7685,7701,16,0
16504ref2,8987,9299,JUNC00000193,5,+,8987,9299,255;0;0,2,149,148,0,164,9136,9151,15,0
16504ref2,9968,10278,JUNC00000205,194,+,9968,10278,255;0;0,2,147,148,0,162,10115,10130,15,0
16504ref2,4131,4418,JUNC00000094,12,+,4131,4418,255;0;0,2,126,147,0,140,4257,4271,14,0
16504ref2,1456,1636,JUNC00000050,127,+,1456,1636,255;0;0,2,149,18,0,162,1605,1618,13,0
16504ref2,2439,2603,JUNC00000069,3,+,2439,2603,255;0;0,2,126,25,0,139,2565,2578,13,0
16504ref2,2853,3016,JUNC00000078,1,-,2853,3016,255;0;0,2,119,32,0,131,2972,2984,12,0
16504ref2,4855,5163,JUNC00000115,12,-,4855,5163,255;0;0,2,149,148,0,160,5004,5015,11,0
16504ref2,793,997,JUNC00000019,2,+,793,997,255;0;0,2,147,48,0,156,940,949,9,0
16504ref2,1242,1544,JUNC00000043,6,-,1242,1544,255;0;0,2,144,149,0,153,1386,1395,9,0
16504ref2,9031,9198,JUNC00000194,4,+,9031,9198,255;0;0,2,148,10,0,157,9179,9188,9,0
16504ref2,1001,1282,JUNC00000035,929,-,1001,1282,255;0;0,2,149,124,0,157,1150,1158,8,0
16504ref2,825,1126,JUNC00000020,626,+,825,1126,255;0;0,2,144,150,0,151,969,976,7,0
16504ref2,1755,1913,JUNC00000059,1,+,1755,1913,255;0;0,2,130,21,0,137,1885,1892,7,0
16504ref2,7718,7881,JUNC00000168,8,+,7718,7881,255;0;0,2,148,8,0,155,7866,7873,7,0
16504ref2,8410,8568,JUNC00000178,1,+,8410,8568,255;0;0,2,8,143,0,15,8418,8425,7,0
16504ref2,4234,4439,JUNC00000102,359,-,4234,4439,255;0;0,2,148,51,0,154,4382,4388,6,0
16504ref2,5115,5318,JUNC00000120,328,+,5115,5318,255;0;0,2,150,47,0,156,5265,5271,6,0
16504ref2,1204,1505,JUNC00000039,2,-,1204,1505,255;0;0,2,149,147,0,154,1353,1358,5,0
16504ref2,2170,2474,JUNC00000064,6,-,2170,2474,255;0;0,2,149,150,0,154,2319,2324,5,0
16504ref2,2201,2475,JUNC00000065,43,+,2201,2475,255;0;0,2,121,148,0,126,2322,2327,5,0
16504ref2,3196,3459,JUNC00000082,53,+,3196,3459,255;0;0,2,146,112,0,151,3342,3347,5,0
16504ref2,3830,4111,JUNC00000087,9,+,3830,4111,255;0;0,2,126,150,0,131,3956,3961,5,0
16504ref2,6031,6200,JUNC00000130,16,+,6031,6200,255;0;0,2,19,145,0,24,6050,6055,5,0
16504ref2,6988,7224,JUNC00000139,5,+,6988,7224,255;0;0,2,149,82,0,154,7137,7142,5,0
16504ref2,7423,7617,JUNC00000149,7,-,7423,7617,255;0;0,2,150,39,0,155,7573,7578,5,0
16504ref2,8822,9078,JUNC00000187,31062,+,8822,9078,255;0;0,2,101,150,0,106,8923,8928,5,0
16848ref2,294,9213,JUNC00000001,2,+,294,9213,255;0;0,2,30,98,0,8821,324,9115,8791,0
16848ref2,1468,8809,JUNC00000041,2,-,1468,8809,255;0;0,2,89,62,0,7279,1557,8747,7190,0
16848ref2,605,7531,JUNC00000006,37,+,605,7531,255;0;0,2,51,146,0,6780,656,7385,6729,0
16848ref2,976,7855,JUNC00000034,177,+,976,7855,255;0;0,2,146,144,0,6735,1122,7711,6589,0
16848ref2,976,7698,JUNC00000033,7,+,976,7698,255;0;0,2,146,23,0,6699,1122,7675,6553,0
16848ref2,2918,9680,JUNC00000076,196,+,2918,9680,255;0;0,2,98,150,0,6612,3016,9530,6514,0
16848ref2,3001,9382,JUNC00000078,39,+,3001,9382,255;0;0,2,46,145,0,6236,3047,9237,6190,0
16848ref2,878,6989,JUNC00000028,20,-,878,6989,255;0;0,2,144,97,0,6014,1022,6892,5870,0
16848ref2,2432,8045,JUNC00000060,2,+,2432,8045,255;0;0,2,148,146,0,5467,2580,7899,5319,0
16848ref2,2434,8051,JUNC00000063,4,+,2434,8051,255;0;0,2,150,148,0,5469,2584,7903,5319,0
16848ref2,3905,9376,JUNC00000093,21,+,3905,9376,255;0;0,2,145,146,0,5325,4050,9230,5180,0
16848ref2,2433,7770,JUNC00000059,56,+,2433,7770,255;0;0,2,145,71,0,5266,2578,7699,5121,0
16848ref2,2434,7715,JUNC00000062,10,+,2434,7715,255;0;0,2,150,150,0,5131,2584,7565,4981,0
16848ref2,1235,6193,JUNC00000038,2,+,1235,6193,255;0;0,2,148,87,0,4871,1383,6106,4723,0
16848ref2,2821,7518,JUNC00000072,1,+,2821,7518,255;0;0,2,9,116,0,4581,2830,7402,4572,0
16848ref2,3734,8252,JUNC00000086,199,+,3734,8252,255;0;0,2,139,140,0,4378,3873,8112,4239,0
16848ref2,4675,9077,JUNC00000110,10,+,4675,9077,255;0;0,2,24,149,0,4253,4699,8928,4229,0
16848ref2,962,4666,JUNC00000031,7,+,962,4666,255;0;0,2,149,150,0,3554,1111,4516,3405,0
16848ref2,4888,8282,JUNC00000114,1,+,4888,8282,255;0;0,2,112,32,0,3362,5000,8250,3250,0
16848ref2,4995,8310,JUNC00000115,2,+,4995,8310,255;0;0,2,9,56,0,3259,5004,8254,3250,0
16848ref2,4228,7740,JUNC00000101,11,+,4228,7740,255;0;0,2,150,150,0,3362,4378,7590,3212,0
16848ref2,6060,9299,JUNC00000127,7,+,6060,9299,255;0;0,2,146,148,0,3091,6206,9151,2945,0
16848ref2,4535,7734,JUNC00000109,30,+,4535,7734,255;0;0,2,149,149,0,3050,4684,7585,2901,0
16848ref2,2640,4042,JUNC00000066,8,+,2640,4042,255;0;0,2,57,148,0,1254,2697,3894,1197,0
16848ref2,7682,8905,JUNC00000149,4,+,7682,8905,255;0;0,2,143,64,0,1159,7825,8841,1016,0
16848ref2,8251,9060,JUNC00000157,384,+,8251,9060,255;0;0,2,143,145,0,664,8394,8915,521,0
16848ref2,2268,2891,JUNC00000050,5,+,2268,2891,255;0;0,2,42,144,0,479,2310,2747,437,0
16848ref2,4581,5250,JUNC00000111,23,+,4581,5250,255;0;0,2,143,147,0,522,4724,5103,379,0
16848ref2,581,1161,JUNC00000009,21,+,581,1161,255;0;0,2,93,146,0,434,674,1015,341,0
16848ref2,3941,4347,JUNC00000091,6,+,3941,4347,255;0;0,2,52,24,0,382,3993,4323,330,0
16848ref2,3928,4477,JUNC00000092,7,+,3928,4477,255;0;0,2,71,148,0,401,3999,4329,330,0
16848ref2,2505,2960,JUNC00000057,2,-,2505,2960,255;0;0,2,39,149,0,306,2544,2811,267,0
16848ref2,1599,2120,JUNC00000042,3390,+,1599,2120,255;0;0,2,150,148,0,373,1749,1972,223,0
16848ref2,693,1066,JUNC00000010,8,+,693,1066,255;0;0,2,21,150,0,223,714,916,202,0
16848ref2,7739,8093,JUNC00000148,3,+,7739,8093,255;0;0,2,86,77,0,277,7825,8016,191,0
16848ref2,2344,2814,JUNC00000056,33,-,2344,2814,255;0;0,2,149,147,0,323,2493,2667,174,0
16848ref2,7553,8019,JUNC00000146,29,+,7553,8019,255;0;0,2,146,146,0,320,7699,7873,174,0
16848ref2,7617,7936,JUNC00000145,8,+,7617,7936,255;0;0,2,82,69,0,250,7699,7867,168,0
16848ref2,8659,8975,JUNC00000160,1,+,8659,8975,255;0;0,2,116,35,0,281,8775,8940,165,0
16848ref2,8896,9233,JUNC00000162,288,+,8896,9233,255;0;0,2,25,150,0,187,8921,9083,162,0
16848ref2,627,1019,JUNC00000011,51,+,627,1019,255;0;0,2,90,148,0,244,717,871,154,0
16848ref2,9182,9579,JUNC00000168,11,+,9182,9579,255;0;0,2,146,101,0,296,9328,9478,150,0
16848ref2,9321,9622,JUNC00000169,1,+,9321,9622,255;0;0,2,46,105,0,196,9367,9517,150,0
16848ref2,9564,9860,JUNC00000171,1,-,9564,9860,255;0;0,2,91,60,0,236,9655,9800,145,0
16848ref2,3504,3939,JUNC00000083,1986,+,3504,3939,255;0;0,2,150,143,0,292,3654,3796,142,0
16848ref2,7636,8065,JUNC00000147,40,-,7636,8065,255;0;0,2,143,149,0,280,7779,7916,137,0
16848ref2,4396,4814,JUNC00000108,14,-,4396,4814,255;0;0,2,143,140,0,278,4539,4674,135,0
16848ref2,4503,4758,JUNC00000107,10,+,4503,4758,255;0;0,2,26,103,0,152,4529,4655,126,0
16848ref2,4883,5160,JUNC00000112,1,+,4883,5160,255;0;0,2,8,143,0,134,4891,5017,126,0
16848ref2,2343,2763,JUNC00000055,8,+,2343,2763,255;0;0,2,150,150,0,270,2493,2613,120,0
16848ref2,2431,2732,JUNC00000058,17,+,2431,2732,255;0;0,2,147,37,0,264,2578,2695,117,0
16848ref2,1915,2239,JUNC00000045,195,+,1915,2239,255;0;0,2,119,89,0,235,2034,2150,116,0
16848ref2,3532,3939,JUNC00000084,5376,+,3532,3939,255;0;0,2,150,143,0,264,3682,3796,114,0
16848ref2,733,1033,JUNC00000014,8,+,733,1033,255;0;0,2,50,141,0,159,783,892,109,0
16848ref2,7153,7559,JUNC00000139,34,+,7153,7559,255;0;0,2,150,150,0,256,7303,7409,106,0
16848ref2,7841,8191,JUNC00000155,3,+,7841,8191,255;0;0,2,101,147,0,203,7942,8044,102,0
16848ref2,6969,7363,JUNC00000135,38,-,6969,7363,255;0;0,2,149,149,0,245,7118,7214,96,0
16848ref2,713,1025,JUNC00000016,39,-,713,1025,255;0;0,2,72,147,0,165,785,878,93,0
16848ref2,2845,3063,JUNC00000074,4,+,2845,3063,255;0;0,2,97,31,0,187,2942,3032,90,0
16848ref2,7783,8065,JUNC00000150,51,-,7783,8065,255;0;0,2,46,149,0,133,7829,7916,87,0
16848ref2,3761,4139,JUNC00000088,3,-,3761,4139,255;0;0,2,148,150,0,228,3909,3989,80,0
16848ref2,695,920,JUNC00000012,1,+,695,920,255;0;0,2,43,108,0,117,738,812,74,0
16848ref2,3880,4125,JUNC00000087,3,+,3880,4125,255;0;0,2,22,149,0,96,3902,3976,74,0
16848ref2,8955,9325,JUNC00000165,7,+,8955,9325,255;0;0,2,149,147,0,223,9104,9178,74,0
16848ref2,564,887,JUNC00000008,115,+,564,887,255;0;0,2,110,142,0,181,674,745,71,0
16848ref2,1766,1964,JUNC00000044,2,+,1766,1964,255;0;0,2,84,46,0,152,1850,1918,68,0
16848ref2,720,999,JUNC00000015,10,-,720,999,255;0;0,2,65,148,0,131,785,851,66,0
16848ref2,4318,4677,JUNC00000104,18,-,4318,4677,255;0;0,2,148,146,0,213,4466,4531,65,0
16848ref2,2146,2463,JUNC00000049,41,+,2146,2463,255;0;0,2,104,149,0,168,2250,2314,64,0
16848ref2,6828,7060,JUNC00000130,2,+,6828,7060,255;0;0,2,149,21,0,211,6977,7039,62,0
16848ref2,2873,3163,JUNC00000075,147,-,2873,3163,255;0;0,2,83,149,0,141,2956,3014,58,0
16848ref2,4349,4681,JUNC00000106,86,-,4349,4681,255;0;0,2,148,126,0,206,4497,4555,58,0
16848ref2,782,1020,JUNC00000017,40,+,782,1020,255;0;0,2,34,149,0,89,816,871,55,0
16848ref2,624,836,JUNC00000004,137,-,624,836,255;0;0,2,8,150,0,62,632,686,54,0
16848ref2,5997,6244,JUNC00000126,3,-,5997,6244,255;0;0,2,147,46,0,201,6144,6198,54,0
16848ref2,8978,9183,JUNC00000164,1,-,8978,9183,255;0;0,2,100,51,0,154,9078,9132,54,0
16848ref2,924,1169,JUNC00000026,6,+,924,1169,255;0;0,2,45,147,0,98,969,1022,53,0
16848ref2,5681,6027,JUNC00000119,4,+,5681,6027,255;0;0,2,149,148,0,198,5830,5879,49,0
16848ref2,499,740,JUNC00000003,11,+,499,740,255;0;0,2,128,66,0,175,627,674,47,0
16848ref2,3929,4141,JUNC00000090,14,+,3929,4141,255;0;0,2,17,150,0,62,3946,3991,45,0
16848ref2,7362,7604,JUNC00000141,2,-,7362,7604,255;0;0,2,149,48,0,194,7511,7556,45,0
16848ref2,7153,7487,JUNC00000138,15,-,7153,7487,255;0;0,2,148,145,0,189,7301,7342,41,0
16848ref2,10042,10355,JUNC00000174,25,+,10042,10355,255;0;0,2,125,147,0,166,10167,10208,41,0
16848ref2,10089,10280,JUNC00000173,2,+,10089,10280,255;0;0,2,48,103,0,88,10137,10177,40,0
16848ref2,1899,2228,JUNC00000046,68,-,1899,2228,255;0;0,2,148,142,0,187,2047,2086,39,0
16848ref2,5591,5924,JUNC00000118,52,+,5591,5924,255;0;0,2,145,149,0,184,5736,5775,39,0
16848ref2,5808,6143,JUNC00000121,6,-,5808,6143,255;0;0,2,147,150,0,185,5955,5993,38,0
16848ref2,622,828,JUNC00000005,11,-,622,828,255;0;0,2,22,148,0,58,644,680,36,0
16848ref2,2238,2574,JUNC00000053,41,-,2238,2574,255;0;0,2,150,150,0,186,2388,2424,36,0
16848ref2,7512,7767,JUNC00000144,3,+,7512,7767,255;0;0,2,148,71,0,184,7660,7696,36,0
16848ref2,7611,7818,JUNC00000143,3,+,7611,7818,255;0;0,2,25,147,0,60,7636,7671,35,0
16848ref2,2657,2988,JUNC00000070,8,+,2657,2988,255;0;0,2,149,148,0,183,2806,2840,34,0
16848ref2,945,1276,JUNC00000029,16,+,945,1276,255;0;0,2,150,148,0,183,1095,1128,33,0
16848ref2,2706,2939,JUNC00000067,24,-,2706,2939,255;0;0,2,50,150,0,83,2756,2789,33,0
16848ref2,5825,6157,JUNC00000122,13,+,5825,6157,255;0;0,2,149,150,0,182,5974,6007,33,0
16848ref2,729,1058,JUNC00000021,121,+,729,1058,255;0;0,2,149,148,0,181,878,910,32,0
16848ref2,5834,6157,JUNC00000123,13,+,5834,6157,255;0;0,2,142,150,0,173,5976,6007,31,0
16848ref2,5836,6105,JUNC00000124,16,-,5836,6105,255;0;0,2,145,93,0,176,5981,6012,31,0
16848ref2,7711,8037,JUNC00000151,52,+,7711,8037,255;0;0,2,146,149,0,177,7857,7888,31,0
16848ref2,979,1234,JUNC00000036,92,-,979,1234,255;0;0,2,149,76,0,179,1128,1158,30,0
16848ref2,4182,4511,JUNC00000096,16,+,4182,4511,255;0;0,2,149,150,0,179,4331,4361,30,0
16848ref2,4194,4522,JUNC00000098,3,+,4194,4522,255;0;0,2,148,150,0,178,4342,4372,30,0
16848ref2,4256,4531,JUNC00000099,41,-,4256,4531,255;0;0,2,96,149,0,126,4352,4382,30,0
16848ref2,4226,4426,JUNC00000100,21,+,4226,4426,255;0;0,2,149,21,0,179,4375,4405,30,0
16848ref2,716,930,JUNC00000013,129,+,716,930,255;0;0,2,48,137,0,77,764,793,29,0
16848ref2,884,1064,JUNC00000027,2,+,884,1064,255;0;0,2,118,33,0,147,1002,1031,29,0
16848ref2,7869,8052,JUNC00000156,26,+,7869,8052,255;0;0,2,146,8,0,175,8015,8044,29,0
16848ref2,2957,3195,JUNC00000077,15,+,2957,3195,255;0;0,2,62,148,0,90,3019,3047,28,0
16848ref2,620,843,JUNC00000007,22,+,620,843,255;0;0,2,47,149,0,74,667,694,27,0
16848ref2,3184,3433,JUNC00000082,40,-,3184,3433,255;0;0,2,73,149,0,100,3257,3284,27,0
16848ref2,3756,4043,JUNC00000085,286,+,3756,4043,255;0;0,2,111,149,0,138,3867,3894,27,0
16848ref2,965,1287,JUNC00000030,5,+,965,1287,255;0;0,2,146,150,0,172,1111,1137,26,0
16848ref2,3022,3344,JUNC00000079,161,+,3022,3344,255;0;0,2,149,148,0,174,3171,3196,25,0
16848ref2,6569,6892,JUNC00000128,22,-,6569,6892,255;0;0,2,148,150,0,173,6717,6742,25,0
16848ref2,4847,5165,JUNC00000113,2,+,4847,5165,255;0;0,2,146,148,0,170,4993,5017,24,0
16848ref2,5571,5775,JUNC00000117,37,-,5571,5775,255;0;0,2,33,147,0,57,5604,5628,24,0
16848ref2,6963,7284,JUNC00000133,7,+,6963,7284,255;0;0,2,147,150,0,171,7110,7134,24,0
16848ref2,6967,7287,JUNC00000134,33,-,6967,7287,255;0;0,2,148,148,0,172,7115,7139,24,0
16848ref2,6973,7188,JUNC00000131,13,-,6973,7188,255;0;0,2,44,148,0,67,7017,7040,23,0
16848ref2,4091,4411,JUNC00000094,9,-,4091,4411,255;0;0,2,148,150,0,170,4239,4261,22,0
16848ref2,7718,7913,JUNC00000152,13,+,7718,7913,255;0;0,2,148,25,0,170,7866,7888,22,0
16848ref2,2483,2802,JUNC00000065,9,+,2483,2802,255;0;0,2,148,150,0,169,2631,2652,21,0
16848ref2,977,1293,JUNC00000035,70,+,977,1293,255;0;0,2,150,146,0,170,1127,1147,20,0
16848ref2,2170,2488,JUNC00000051,25,-,2170,2488,255;0;0,2,149,149,0,169,2319,2339,20,0
16848ref2,2253,2493,JUNC00000052,98,+,2253,2493,255;0;0,2,74,146,0,94,2327,2347,20,0
16848ref2,824,1137,JUNC00000025,28,+,824,1137,255;0;0,2,145,149,0,164,969,988,19,0
16848ref2,6946,7262,JUNC00000132,6,-,6946,7262,255;0;0,2,149,150,0,166,7095,7112,17,0
16848ref2,826,1135,JUNC00000024,43,+,826,1135,255;0;0,2,143,150,0,159,969,985,16,0
16848ref2,8785,9079,JUNC00000161,44,-,8785,9079,255;0;0,2,132,146,0,148,8917,8933,16,0
16848ref2,1244,1558,JUNC00000040,6,+,1244,1558,255;0;0,2,149,150,0,164,1393,1408,15,0
16848ref2,2438,2749,JUNC00000061,12,+,2438,2749,255;0;0,2,146,150,0,161,2584,2599,15,0
16848ref2,2449,2762,JUNC00000064,26,+,2449,2762,255;0;0,2,149,149,0,164,2598,2613,15,0
16848ref2,2681,2994,JUNC00000071,63,+,2681,2994,255;0;0,2,149,149,0,164,2830,2845,15,0
16848ref2,4107,4418,JUNC00000095,11,+,4107,4418,255;0;0,2,150,147,0,164,4257,4271,14,0
16848ref2,7009,7321,JUNC00000137,4,-,7009,7321,255;0;0,2,149,149,0,163,7158,7172,14,0
16848ref2,7783,8072,JUNC00000154,571,+,7783,8072,255;0;0,2,125,150,0,139,7908,7922,14,0
16848ref2,8301,8613,JUNC00000159,47,+,8301,8613,255;0;0,2,148,150,0,162,8449,8463,14,0
16848ref2,3926,4097,JUNC00000089,86,-,3926,4097,255;0;0,2,9,149,0,22,3935,3948,13,0
16848ref2,5693,5979,JUNC00000120,105,+,5693,5979,255;0;0,2,148,125,0,161,5841,5854,13,0
16848ref2,788,1012,JUNC00000018,18,+,788,1012,255;0;0,2,64,148,0,76,852,864,12,0
16848ref2,819,1024,JUNC00000020,19,+,819,1024,255;0;0,2,48,146,0,59,867,878,11,0
16848ref2,1991,2295,JUNC00000047,10,+,1991,2295,255;0;0,2,145,148,0,156,2136,2147,11,0
16848ref2,4382,4647,JUNC00000105,174,-,4382,4647,255;0;0,2,104,150,0,115,4486,4497,11,0
16848ref2,7343,7534,JUNC00000140,31,+,7343,7534,255;0;0,2,31,149,0,42,7374,7385,11,0
16848ref2,2786,2963,JUNC00000069,29,+,2786,2963,255;0;0,2,20,147,0,30,2806,2816,10,0
16848ref2,2697,2865,JUNC00000073,35,+,2697,2865,255;0;0,2,149,9,0,159,2846,2856,10,0
16848ref2,9484,9787,JUNC00000170,1829,+,9484,9787,255;0;0,2,143,150,0,153,9627,9637,10,0
16848ref2,10134,10443,JUNC00000175,131,+,10134,10443,255;0;0,2,149,150,0,159,10283,10293,10,0
16848ref2,1240,1545,JUNC00000039,5,-,1240,1545,255;0;0,2,146,150,0,155,1386,1395,9,0
16848ref2,3036,3342,JUNC00000080,46,+,3036,3342,255;0;0,2,148,149,0,157,3184,3193,9,0
16848ref2,9033,9212,JUNC00000167,7,+,9033,9212,255;0;0,2,146,24,0,155,9179,9188,9,0
16848ref2,1002,1307,JUNC00000037,88,-,1002,1307,255;0;0,2,148,149,0,156,1150,1158,8,0
16848ref2,2034,2238,JUNC00000048,7,+,2034,2238,255;0;0,2,126,70,0,134,2160,2168,8,0
16848ref2,2666,2959,JUNC00000068,3,+,2666,2959,255;0;0,2,140,145,0,148,2806,2814,8,0
16848ref2,824,1125,JUNC00000023,126,+,824,1125,255;0;0,2,145,149,0,152,969,976,7,0
16848ref2,3050,3212,JUNC00000081,25,-,3050,3212,255;0;0,2,147,8,0,154,3197,3204,7,0
16848ref2,4194,4499,JUNC00000097,3,-,4194,4499,255;0;0,2,148,150,0,155,4342,4349,7,0
16848ref2,8284,8587,JUNC00000158,194,+,8284,8587,255;0;0,2,147,149,0,154,8431,8438,7,0
16848ref2,498,779,JUNC00000002,48,+,498,779,255;0;0,2,129,146,0,135,627,633,6,0
16848ref2,900,1098,JUNC00000022,93,+,900,1098,255;0;0,2,43,149,0,49,943,949,6,0
16848ref2,973,1274,JUNC00000032,2,+,973,1274,255;0;0,2,149,146,0,155,1122,1128,6,0
16848ref2,1761,1994,JUNC00000043,69,+,1761,1994,255;0;0,2,79,148,0,85,1840,1846,6,0
16848ref2,4232,4414,JUNC00000102,254,-,4232,4414,255;0;0,2,150,26,0,156,4382,4388,6,0
16848ref2,5018,5250,JUNC00000116,54,-,5018,5250,255;0;0,2,79,147,0,85,5097,5103,6,0
16848ref2,9094,9310,JUNC00000166,2,+,9094,9310,255;0;0,2,62,148,0,68,9156,9162,6,0
16848ref2,9869,10108,JUNC00000172,2,-,9869,10108,255;0;0,2,147,86,0,153,10016,10022,6,0
16848ref2,707,1008,JUNC00000019,14,-,707,1008,255;0;0,2,148,148,0,153,855,860,5,0
16848ref2,2349,2560,JUNC00000054,32,-,2349,2560,255;0;0,2,57,149,0,62,2406,2411,5,0
16848ref2,4264,4568,JUNC00000103,180,-,4264,4568,255;0;0,2,149,150,0,154,4413,4418,5,0
16848ref2,5955,6256,JUNC00000125,13,+,5955,6256,255;0;0,2,150,146,0,155,6105,6110,5,0
16848ref2,6902,7120,JUNC00000129,2,+,6902,7120,255;0;0,2,64,149,0,69,6966,6971,5,0
16848ref2,6988,7291,JUNC00000136,87,+,6988,7291,255;0;0,2,149,149,0,154,7137,7142,5,0
16848ref2,7423,7655,JUNC00000142,11,-,7423,7655,255;0;0,2,150,77,0,155,7573,7578,5,0
16848ref2,7725,7931,JUNC00000153,16,-,7725,7931,255;0;0,2,150,51,0,155,7875,7880,5,0
16848ref2,8816,9078,JUNC00000163,2451,+,8816,9078,255;0;0,2,107,150,0,112,8923,8928,5,0
16918ref1,524,870,JUNC00000001,318,+,524,870,255;0;0,2,150,125,0,221,674,745,71,0
16918ref1,654,1079,JUNC00000002,54,-,654,1079,255;0;0,2,78,147,0,278,732,932,200,0
16918ref1,726,969,JUNC00000003,178,+,726,969,255;0;0,2,67,143,0,100,793,826,33,0
16918ref1,781,1008,JUNC00000004,394,-,781,1008,255;0;0,2,52,148,0,79,833,860,27,0
16918ref1,829,1149,JUNC00000005,9,+,829,1149,255;0;0,2,49,147,0,173,878,1002,124,0
16918ref1,823,1097,JUNC00000006,94,+,823,1097,255;0;0,2,115,148,0,126,938,949,11,0
16918ref1,840,1097,JUNC00000007,168,+,840,1097,255;0;0,2,103,148,0,109,943,949,6,0
16918ref1,877,1035,JUNC00000008,195,+,877,1035,255;0;0,2,81,20,0,138,958,1015,57,0
16918ref1,825,1126,JUNC00000009,59,+,825,1126,255;0;0,2,144,150,0,151,969,976,7,0
16918ref1,826,1168,JUNC00000010,8,+,826,1168,255;0;0,2,143,146,0,196,969,1022,53,0
16918ref1,911,1035,JUNC00000011,1,+,911,1035,255;0;0,2,67,50,0,74,978,985,7,0
16918ref1,969,1232,JUNC00000012,4,+,969,1232,255;0;0,2,27,148,0,115,996,1084,88,0
16918ref1,924,9024,JUNC00000013,26,+,924,9024,255;0;0,2,72,68,0,8032,996,8956,7960,0
16918ref1,955,1307,JUNC00000014,564,-,955,1307,255;0;0,2,146,149,0,203,1101,1158,57,0
16918ref1,973,1282,JUNC00000015,5,+,973,1282,255;0;0,2,143,149,0,160,1116,1133,17,0
16918ref1,972,1276,JUNC00000016,12,+,972,1276,255;0;0,2,150,148,0,156,1122,1128,6,0
16918ref1,972,1297,JUNC00000017,187,+,972,1297,255;0;0,2,150,150,0,175,1122,1147,25,0
16918ref1,979,1141,JUNC00000018,37,-,979,1141,255;0;0,2,149,8,0,154,1128,1133,5,0
16918ref1,978,1210,JUNC00000019,43,-,978,1210,255;0;0,2,150,73,0,159,1128,1137,9,0
16918ref1,1454,1705,JUNC00000020,1,+,1454,1705,255;0;0,2,11,140,0,111,1465,1565,100,0
16918ref1,1539,1865,JUNC00000021,243,-,1539,1865,255;0;0,2,150,150,0,176,1689,1715,26,0
16918ref1,1565,1941,JUNC00000022,172,+,1565,1941,255;0;0,2,145,148,0,228,1710,1793,83,0
16918ref1,1690,1863,JUNC00000023,2,+,1690,1863,255;0;0,2,103,48,0,125,1793,1815,22,0
16918ref1,1723,2062,JUNC00000024,232,-,1723,2062,255;0;0,2,103,150,0,189,1826,1912,86,0
16918ref1,1976,2299,JUNC00000025,3,-,1976,2299,255;0;0,2,149,149,0,174,2125,2150,25,0
16918ref1,2359,2650,JUNC00000026,31,+,2359,2650,255;0;0,2,50,149,0,142,2409,2501,92,0
16918ref1,2502,2723,JUNC00000027,85,+,2502,2723,255;0;0,2,63,145,0,76,2565,2578,13,0
16918ref1,2449,2763,JUNC00000028,36,+,2449,2763,255;0;0,2,149,150,0,164,2598,2613,15,0
16918ref1,2595,2779,JUNC00000029,7,+,2595,2779,255;0;0,2,19,150,0,34,2614,2629,15,0
16918ref1,2656,2988,JUNC00000030,641,+,2656,2988,255;0;0,2,150,148,0,184,2806,2840,34,0
16918ref1,2680,2994,JUNC00000031,50,+,2680,2994,255;0;0,2,150,149,0,165,2830,2845,15,0
16918ref1,2867,3094,JUNC00000032,2,-,2867,3094,255;0;0,2,37,145,0,82,2904,2949,45,0
16918ref1,2886,3120,JUNC00000033,2,+,2886,3120,255;0;0,2,56,88,0,146,2942,3032,90,0
16918ref1,2954,3187,JUNC00000034,71,+,2954,3187,255;0;0,2,56,150,0,83,3010,3037,27,0
16918ref1,2889,3232,JUNC00000035,5,+,2889,3232,255;0;0,2,144,146,0,197,3033,3086,53,0
16918ref1,3107,3434,JUNC00000036,30,-,3107,3434,255;0;0,2,150,150,0,177,3257,3284,27,0
16918ref1,3717,4044,JUNC00000037,3752,+,3717,4044,255;0;0,2,150,150,0,177,3867,3894,27,0
16918ref1,4107,4418,JUNC00000038,21,+,4107,4418,255;0;0,2,150,147,0,164,4257,4271,14,0
16918ref1,4182,4511,JUNC00000039,51,+,4182,4511,255;0;0,2,149,150,0,179,4331,4361,30,0
16918ref1,4193,4522,JUNC00000040,7,+,4193,4522,255;0;0,2,149,150,0,179,4342,4372,30,0
16918ref1,4280,4531,JUNC00000041,119,-,4280,4531,255;0;0,2,72,149,0,102,4352,4382,30,0
16918ref1,4229,4532,JUNC00000042,2,-,4229,4532,255;0;0,2,146,150,0,153,4375,4382,7,0
16918ref1,4393,4666,JUNC00000043,249,-,4393,4666,255;0;0,2,104,111,0,162,4497,4555,58,0
16918ref1,4432,4817,JUNC00000044,46,-,4432,4817,255;0;0,2,100,150,0,235,4532,4667,135,0
16918ref1,4394,4824,JUNC00000045,85,-,4394,4824,255;0;0,2,145,150,0,280,4539,4674,135,0
16918ref1,4843,5165,JUNC00000046,6,-,4843,5165,255;0;0,2,150,150,0,172,4993,5015,22,0
16918ref1,4959,5301,JUNC00000047,81,+,4959,5301,255;0;0,2,150,149,0,193,5109,5152,43,0
16918ref1,5491,6103,JUNC00000048,12,-,5491,6103,255;0;0,2,64,150,0,462,5555,5953,398,0
16918ref1,5806,7714,JUNC00000049,454,-,5806,7714,255;0;0,2,147,140,0,1768,5953,7574,1621,0
16918ref1,5808,6143,JUNC00000050,10,-,5808,6143,255;0;0,2,147,150,0,185,5955,5993,38,0
16918ref1,5955,6125,JUNC00000051,5,+,5955,6125,255;0;0,2,150,15,0,155,6105,6110,5,0
16918ref1,7423,7728,JUNC00000052,18,-,7423,7728,255;0;0,2,150,150,0,155,7573,7578,5,0
16918ref1,7511,7763,JUNC00000053,4,+,7511,7763,255;0;0,2,149,67,0,185,7660,7696,36,0
16918ref1,7552,10111,JUNC00000054,435,+,7552,10111,255;0;0,2,149,150,0,2409,7701,9961,2260,0
16918ref1,7797,7973,JUNC00000055,48,-,7797,7973,255;0;0,2,9,146,0,30,7806,7827,21,0
16918ref1,7819,8038,JUNC00000056,204,+,7819,8038,255;0;0,2,38,150,0,69,7857,7888,31,0
16918ref1,7842,8157,JUNC00000057,641,+,7842,8157,255;0;0,2,80,150,0,165,7922,8007,85,0
16918ref1,7962,8278,JUNC00000058,575,-,7962,8278,255;0;0,2,150,149,0,167,8112,8129,17,0
16918ref1,8332,9020,JUNC00000059,1,-,8332,9020,255;0;0,2,8,143,0,545,8340,8877,537,0
16918ref1,8804,8888,JUNC00000060,1,+,8804,8888,255;0;0,2,18,33,0,51,8822,8855,33,0
16918ref1,8804,9078,JUNC00000061,51,-,8804,9078,255;0;0,2,113,145,0,129,8917,8933,16,0
16918ref1,8779,9078,JUNC00000062,1918,+,8779,9078,255;0;0,2,144,150,0,149,8923,8928,5,0
16918ref1,8833,9104,JUNC00000063,8,+,8833,9104,255;0;0,2,118,148,0,123,8951,8956,5,0
16918ref1,9012,9214,JUNC00000064,2,-,9012,9214,255;0;0,2,62,82,0,120,9074,9132,58,0
16918ref1,8986,9299,JUNC00000065,656,+,8986,9299,255;0;0,2,150,148,0,165,9136,9151,15,0
16918ref1,9489,9796,JUNC00000066,321,+,9489,9796,255;0;0,2,150,150,0,157,9639,9646,7,0
17165ref2,304,537,JUNC00000001,4,+,304,537,255;0;0,2,150,74,0,159,454,463,9,0
17165ref2,385,835,JUNC00000002,42,+,385,835,255;0;0,2,143,147,0,303,528,688,160,0
17165ref2,452,836,JUNC00000003,28,+,452,836,255;0;0,2,82,142,0,242,534,694,160,0
17165ref2,510,771,JUNC00000004,59,+,510,771,255;0;0,2,26,149,0,112,536,622,86,0
17165ref2,541,862,JUNC00000005,161,+,541,862,255;0;0,2,8,147,0,174,549,715,166,0
17165ref2,617,829,JUNC00000006,13,-,617,829,255;0;0,2,35,149,0,63,652,680,28,0
17165ref2,618,843,JUNC00000007,39,+,618,843,255;0;0,2,49,149,0,76,667,694,27,0
17165ref2,518,871,JUNC00000008,120,+,518,871,255;0;0,2,149,150,0,203,667,721,54,0
17165ref2,650,1025,JUNC00000009,14,+,650,1025,255;0;0,2,24,147,0,228,674,878,204,0
17165ref2,684,1013,JUNC00000010,15,+,684,1013,255;0;0,2,26,149,0,180,710,864,154,0
17165ref2,662,1020,JUNC00000011,55,+,662,1020,255;0;0,2,55,149,0,209,717,871,154,0
17165ref2,622,854,JUNC00000012,301,+,622,854,255;0;0,2,142,61,0,171,764,793,29,0
17165ref2,732,4975,JUNC00000013,1008,-,732,4975,255;0;0,2,53,150,0,4093,785,4825,4040,0
17165ref2,751,982,JUNC00000014,94,+,751,982,255;0;0,2,44,150,0,81,795,832,37,0
17165ref2,751,1091,JUNC00000015,88,+,751,1091,255;0;0,2,75,76,0,264,826,1015,189,0
17165ref2,698,1020,JUNC00000016,15,+,698,1020,255;0;0,2,148,149,0,173,846,871,25,0
17165ref2,707,1027,JUNC00000017,155,-,707,1027,255;0;0,2,148,149,0,171,855,878,23,0
17165ref2,801,5278,JUNC00000018,107,-,801,5278,255;0;0,2,59,92,0,4385,860,5186,4326,0
17165ref2,721,1024,JUNC00000019,68,+,721,1024,255;0;0,2,146,146,0,157,867,878,11,0
17165ref2,824,1123,JUNC00000020,16,+,824,1123,255;0;0,2,145,147,0,152,969,976,7,0
17165ref2,826,1170,JUNC00000021,12,+,826,1170,255;0;0,2,143,148,0,196,969,1022,53,0
17165ref2,968,1234,JUNC00000022,14,+,968,1234,255;0;0,2,34,144,0,122,1002,1090,88,0
17165ref2,950,1271,JUNC00000023,3,-,950,1271,255;0;0,2,149,147,0,174,1099,1124,25,0
17165ref2,952,1292,JUNC00000024,2,-,952,1292,255;0;0,2,147,147,0,193,1099,1145,46,0
17165ref2,955,1308,JUNC00000025,763,-,955,1308,255;0;0,2,146,150,0,203,1101,1158,57,0
17165ref2,970,1269,JUNC00000026,25,+,970,1269,255;0;0,2,144,149,0,150,1114,1120,6,0
17165ref2,965,1275,JUNC00000027,3,+,965,1275,255;0;0,2,149,147,0,163,1114,1128,14,0
17165ref2,974,1276,JUNC00000028,6,+,974,1276,255;0;0,2,148,148,0,154,1122,1128,6,0
17165ref2,978,1292,JUNC00000029,19,+,978,1292,255;0;0,2,149,145,0,169,1127,1147,20,0
17165ref2,1142,1304,JUNC00000030,63,-,1142,1304,255;0;0,2,8,149,0,13,1150,1155,5,0
17165ref2,1005,1308,JUNC00000031,102,-,1005,1308,255;0;0,2,145,150,0,153,1150,1158,8,0
17165ref2,1546,1869,JUNC00000032,12,+,1546,1869,255;0;0,2,22,150,0,173,1568,1719,151,0
17165ref2,1534,1760,JUNC00000033,50,+,1534,1760,255;0;0,2,58,149,0,77,1592,1611,19,0
17165ref2,1476,1777,JUNC00000034,42,+,1476,1777,255;0;0,2,148,144,0,157,1624,1633,9,0
17165ref2,1598,1793,JUNC00000035,73,+,1598,1793,255;0;0,2,31,150,0,45,1629,1643,14,0
17165ref2,1606,1942,JUNC00000036,50,+,1606,1942,255;0;0,2,62,149,0,187,1668,1793,125,0
17165ref2,1691,1971,JUNC00000037,119,-,1691,1971,255;0;0,2,60,145,0,135,1751,1826,75,0
17165ref2,1603,1986,JUNC00000038,3,-,1603,1986,255;0;0,2,148,148,0,235,1751,1838,87,0
17165ref2,1726,2062,JUNC00000039,340,-,1726,2062,255;0;0,2,100,150,0,186,1826,1912,86,0
17165ref2,1761,1947,JUNC00000040,8,+,1761,1947,255;0;0,2,89,29,0,157,1850,1918,68,0
17165ref2,1953,2143,JUNC00000041,1,-,1953,2143,255;0;0,2,94,57,0,133,2047,2086,39,0
17165ref2,2105,2473,JUNC00000042,127,+,2105,2473,255;0;0,2,120,146,0,222,2225,2327,102,0
17165ref2,2239,2572,JUNC00000043,15,-,2239,2572,255;0;0,2,149,148,0,185,2388,2424,36,0
17165ref2,2375,2557,JUNC00000044,42,+,2375,2557,255;0;0,2,21,150,0,32,2396,2407,11,0
17165ref2,2391,2839,JUNC00000045,150,+,2391,2839,255;0;0,2,27,124,0,324,2418,2715,297,0
17165ref2,2328,2800,JUNC00000046,114,+,2328,2800,255;0;0,2,147,148,0,324,2475,2652,177,0
17165ref2,2353,2777,JUNC00000047,14,+,2353,2777,255;0;0,2,148,148,0,276,2501,2629,128,0
17165ref2,2494,2850,JUNC00000048,225,+,2494,2850,255;0;0,2,71,146,0,210,2565,2704,139,0
17165ref2,2568,2779,JUNC00000049,8,+,2568,2779,255;0;0,2,21,150,0,61,2589,2629,40,0
17165ref2,2450,2780,JUNC00000050,176,-,2450,2780,255;0;0,2,148,147,0,183,2598,2633,35,0
17165ref2,2483,2784,JUNC00000051,8,+,2483,2784,255;0;0,2,148,148,0,153,2631,2636,5,0
17165ref2,2482,2787,JUNC00000052,8,+,2482,2787,255;0;0,2,149,149,0,156,2631,2638,7,0
17165ref2,2633,2756,JUNC00000053,1,-,2633,2756,255;0;0,2,10,75,0,48,2643,2681,38,0
17165ref2,2655,2952,JUNC00000054,3,+,2655,2952,255;0;0,2,27,149,0,148,2682,2803,121,0
17165ref2,2646,2978,JUNC00000055,54,-,2646,2978,255;0;0,2,91,146,0,186,2737,2832,95,0
17165ref2,2738,2946,JUNC00000056,72,+,2738,2946,255;0;0,2,49,148,0,60,2787,2798,11,0
17165ref2,2758,2988,JUNC00000057,103,+,2758,2988,255;0;0,2,48,148,0,82,2806,2840,34,0
17165ref2,2670,3124,JUNC00000058,9,-,2670,3124,255;0;0,2,146,143,0,311,2816,2981,165,0
17165ref2,2670,2990,JUNC00000059,25,-,2670,2990,255;0;0,2,150,150,0,170,2820,2840,20,0
17165ref2,2670,3004,JUNC00000060,10,-,2670,3004,255;0;0,2,150,146,0,188,2820,2858,38,0
17165ref2,2964,3150,JUNC00000061,23,+,2964,3150,255;0;0,2,48,103,0,83,3012,3047,35,0
17165ref2,3107,3434,JUNC00000062,31,-,3107,3434,255;0;0,2,150,150,0,177,3257,3284,27,0
17165ref2,3495,4175,JUNC00000063,543,+,3495,4175,255;0;0,2,150,150,0,530,3645,4025,380,0
17165ref2,3612,3818,JUNC00000064,523,-,3612,3818,255;0;0,2,150,27,0,179,3762,3791,29,0
17165ref2,3807,4062,JUNC00000065,1,-,3807,4062,255;0;0,2,47,104,0,151,3854,3958,104,0
17165ref2,3859,4110,JUNC00000066,181,+,3859,4110,255;0;0,2,35,144,0,107,3894,3966,72,0
17165ref2,4019,4238,JUNC00000067,130,+,4019,4238,255;0;0,2,62,150,0,69,4081,4088,7,0
17165ref2,4155,4446,JUNC00000068,21,-,4155,4446,255;0;0,2,39,148,0,143,4194,4298,104,0
17165ref2,4091,4363,JUNC00000069,110,+,4091,4363,255;0;0,2,121,146,0,126,4212,4217,5,0
17165ref2,4230,4418,JUNC00000070,2,+,4230,4418,255;0;0,2,27,147,0,41,4257,4271,14,0
17165ref2,4309,4563,JUNC00000071,12,+,4309,4563,255;0;0,2,53,149,0,105,4362,4414,52,0
17165ref2,4290,4554,JUNC00000072,4,+,4290,4554,255;0;0,2,85,149,0,115,4375,4405,30,0
17165ref2,4373,4563,JUNC00000073,4,+,4373,4563,255;0;0,2,20,149,0,41,4393,4414,21,0
17165ref2,4400,4674,JUNC00000074,1353,-,4400,4674,255;0;0,2,97,119,0,155,4497,4555,58,0
17165ref2,4411,4697,JUNC00000075,1,-,4411,4697,255;0;0,2,128,23,0,263,4539,4674,135,0
17165ref2,4530,4816,JUNC00000076,2,-,4530,4816,255;0;0,2,14,137,0,149,4544,4679,135,0
17165ref2,4607,4765,JUNC00000077,1,+,4607,4765,255;0;0,2,106,45,0,113,4713,4720,7,0
17165ref2,4583,4892,JUNC00000078,3,+,4583,4892,255;0;0,2,145,148,0,161,4728,4744,16,0
17165ref2,4617,4926,JUNC00000079,146,+,4617,4926,255;0;0,2,148,143,0,166,4765,4783,18,0
17165ref2,4715,5236,JUNC00000080,99,-,4715,5236,255;0;0,2,148,149,0,372,4863,5087,224,0
17165ref2,4992,5124,JUNC00000081,1,+,4992,5124,255;0;0,2,18,11,0,121,5010,5113,103,0
17165ref2,4983,5280,JUNC00000082,3,-,4983,5280,255;0;0,2,147,33,0,264,5130,5247,117,0
17165ref2,5010,5705,JUNC00000083,43,+,5010,5705,255;0;0,2,144,74,0,621,5154,5631,477,0
17165ref2,5129,5791,JUNC00000084,184,-,5129,5791,255;0;0,2,37,148,0,514,5166,5643,477,0
17165ref2,5521,5780,JUNC00000085,59,-,5521,5780,255;0;0,2,79,147,0,112,5600,5633,33,0
17165ref2,5589,5924,JUNC00000086,30,+,5589,5924,255;0;0,2,147,149,0,186,5736,5775,39,0
17165ref2,5633,6007,JUNC00000087,26,-,5633,6007,255;0;0,2,143,150,0,224,5776,5857,81,0
17165ref2,5681,6011,JUNC00000088,2,+,5681,6011,255;0;0,2,149,145,0,185,5830,5866,36,0
17165ref2,5914,6147,JUNC00000089,2,+,5914,6147,255;0;0,2,29,125,0,108,5943,6022,79,0
17165ref2,5918,6106,JUNC00000090,1,-,5918,6106,255;0;0,2,126,25,0,163,6044,6081,37,0
17165ref2,6023,6366,JUNC00000091,25,-,6023,6366,255;0;0,2,145,150,0,193,6168,6216,48,0
17165ref2,6425,6637,JUNC00000092,3,+,6425,6637,255;0;0,2,59,146,0,66,6484,6491,7,0
17165ref2,6621,6905,JUNC00000093,2,+,6621,6905,255;0;0,2,128,150,0,134,6749,6755,6,0
17165ref2,6735,9645,JUNC00000094,1,+,6735,9645,255;0;0,2,139,8,0,2902,6874,9637,2763,0
17165ref2,6745,9755,JUNC00000095,295,-,6745,9755,255;0;0,2,147,100,0,2910,6892,9655,2763,0
17165ref2,6794,7123,JUNC00000096,6,-,6794,7123,255;0;0,2,148,150,0,179,6942,6973,31,0
17165ref2,7134,7437,JUNC00000097,281,-,7134,7437,255;0;0,2,79,150,0,153,7213,7287,74,0
17165ref2,7158,7437,JUNC00000098,111,-,7158,7437,255;0;0,2,103,150,0,129,7261,7287,26,0
17165ref2,7290,7526,JUNC00000099,113,-,7290,7526,255;0;0,2,35,150,0,86,7325,7376,51,0
17165ref2,7419,7698,JUNC00000100,17,+,7419,7698,255;0;0,2,75,145,0,134,7494,7553,59,0
17165ref2,7364,7626,JUNC00000101,67,-,7364,7626,255;0;0,2,147,48,0,214,7511,7578,67,0
17165ref2,7424,7621,JUNC00000102,3,-,7424,7621,255;0;0,2,149,43,0,154,7573,7578,5,0
17165ref2,7516,7708,JUNC00000103,2,+,7516,7708,255;0;0,2,144,12,0,180,7660,7696,36,0
17165ref2,7567,8035,JUNC00000104,86,+,7567,8035,255;0;0,2,132,147,0,321,7699,7888,189,0
17165ref2,7807,7890,JUNC00000105,9,+,7807,7890,255;0;0,2,25,10,0,73,7832,7880,48,0
17165ref2,7736,8014,JUNC00000106,2,+,7736,8014,255;0;0,2,121,150,0,128,7857,7864,7,0
17165ref2,7805,8064,JUNC00000107,34,-,7805,8064,255;0;0,2,52,148,0,111,7857,7916,59,0
17165ref2,7718,7881,JUNC00000108,21,+,7718,7881,255;0;0,2,148,8,0,155,7866,7873,7,0
17165ref2,7848,8035,JUNC00000109,22,+,7848,8035,255;0;0,2,25,147,0,40,7873,7888,15,0
17165ref2,7727,8005,JUNC00000110,8,-,7727,8005,255;0;0,2,148,125,0,153,7875,7880,5,0
17165ref2,7884,8229,JUNC00000111,1,-,7884,8229,255;0;0,2,32,104,0,241,7916,8125,209,0
17165ref2,7980,8199,JUNC00000112,72,+,7980,8199,255;0;0,2,27,148,0,71,8007,8051,44,0
17165ref2,7888,8193,JUNC00000113,20,+,7888,8193,255;0;0,2,146,149,0,156,8034,8044,10,0
17165ref2,7888,8326,JUNC00000114,598,+,7888,8326,255;0;0,2,146,150,0,288,8034,8176,142,0
17165ref2,7965,8277,JUNC00000115,91,-,7965,8277,255;0;0,2,147,148,0,164,8112,8129,17,0
17165ref2,8288,8651,JUNC00000116,2144,+,8288,8651,255;0;0,2,150,150,0,213,8438,8501,63,0
17165ref2,8369,8578,JUNC00000117,1,+,8369,8578,255;0;0,2,119,32,0,177,8488,8546,58,0
17165ref2,8773,9078,JUNC00000118,2037,+,8773,9078,255;0;0,2,150,150,0,155,8923,8928,5,0
17165ref2,8969,9296,JUNC00000119,3,+,8969,9296,255;0;0,2,61,145,0,182,9030,9151,121,0
17165ref2,9629,9806,JUNC00000120,1,-,9629,9806,255;0;0,2,26,104,0,73,9655,9702,47,0
17165ref2,9678,9991,JUNC00000121,3,-,9678,9991,255;0;0,2,146,146,0,167,9824,9845,21,0
17165ref2,9692,10013,JUNC00000122,113,-,9692,10013,255;0;0,2,144,150,0,171,9836,9863,27,0
17165ref2,9884,10207,JUNC00000123,201,+,9884,10207,255;0;0,2,69,150,0,173,9953,10057,104,0
18317ref1,907,6695,JUNC00000024,4,-,907,6695,255;0;0,2,9,142,0,5646,916,6553,5637,0
18317ref1,4389,7572,JUNC00000086,56,-,4389,7572,255;0;0,2,97,149,0,3034,4486,7423,2937,0
18317ref1,5605,8069,JUNC00000100,2,+,5605,8069,255;0;0,2,26,62,0,2402,5631,8007,2376,0
18317ref1,6173,8056,JUNC00000104,294,-,6173,8056,255;0;0,2,150,150,0,1733,6323,7906,1583,0
18317ref1,7723,8535,JUNC00000119,1181,+,7723,8535,255;0;0,2,150,143,0,669,7873,8392,519,0
18317ref1,267,1026,JUNC00000003,653,+,267,1026,255;0;0,2,150,148,0,611,417,878,461,0
18317ref1,3609,4175,JUNC00000073,16,+,3609,4175,255;0;0,2,36,150,0,416,3645,4025,380,0
18317ref1,516,1133,JUNC00000010,6,+,516,1133,255;0;0,2,111,131,0,486,627,1002,375,0
18317ref1,1248,1757,JUNC00000034,1,+,1248,1757,255;0;0,2,72,79,0,430,1320,1678,358,0
18317ref1,8430,8965,JUNC00000125,2,+,8430,8965,255;0;0,2,116,124,0,411,8546,8841,295,0
18317ref1,619,1125,JUNC00000016,89,+,619,1125,255;0;0,2,145,110,0,396,764,1015,251,0
18317ref1,4713,5236,JUNC00000093,280,-,4713,5236,255;0;0,2,150,149,0,374,4863,5087,224,0
18317ref1,1607,2120,JUNC00000038,99,+,1607,2120,255;0;0,2,142,148,0,365,1749,1972,223,0
18317ref1,7881,8269,JUNC00000120,45,-,7881,8269,255;0;0,2,35,144,0,244,7916,8125,209,0
18317ref1,6120,6357,JUNC00000103,1,-,6120,6357,255;0;0,2,24,27,0,210,6144,6330,186,0
18317ref1,416,818,JUNC00000005,96,-,416,818,255;0;0,2,93,149,0,253,509,669,160,0
18317ref1,621,1020,JUNC00000015,83,+,621,1020,255;0;0,2,96,149,0,250,717,871,154,0
18317ref1,7690,8056,JUNC00000115,27,-,7690,8056,255;0;0,2,62,150,0,216,7752,7906,154,0
18317ref1,203,455,JUNC00000001,4,-,203,455,255;0;0,2,28,71,0,181,231,384,153,0
18317ref1,7259,7605,JUNC00000108,41,-,7259,7605,255;0;0,2,150,45,0,301,7409,7560,151,0
18317ref1,2675,2988,JUNC00000058,23,+,2675,2988,255;0;0,2,22,148,0,165,2697,2840,143,0
18317ref1,2319,2755,JUNC00000048,21,+,2319,2755,255;0;0,2,148,149,0,287,2467,2606,139,0
18317ref1,513,940,JUNC00000011,108,+,513,940,255;0;0,2,143,147,0,280,656,793,137,0
18317ref1,4498,4673,JUNC00000088,87,+,4498,4673,255;0;0,2,31,9,0,166,4529,4664,135,0
18317ref1,4498,4817,JUNC00000089,405,-,4498,4817,255;0;0,2,34,150,0,169,4532,4667,135,0
18317ref1,4430,4824,JUNC00000090,241,-,4430,4824,255;0;0,2,109,150,0,244,4539,4674,135,0
18317ref1,4430,4829,JUNC00000091,94,-,4430,4829,255;0;0,2,114,150,0,249,4544,4679,135,0
18317ref1,2212,2636,JUNC00000045,6,-,2212,2636,255;0;0,2,146,150,0,274,2358,2486,128,0
18317ref1,2346,2672,JUNC00000049,12,-,2346,2672,255;0;0,2,147,56,0,270,2493,2616,123,0
18317ref1,2560,2952,JUNC00000057,9,+,2560,2952,255;0;0,2,122,149,0,243,2682,2803,121,0
18317ref1,1885,2175,JUNC00000043,266,+,1885,2175,255;0;0,2,149,25,0,265,2034,2150,116,0
18317ref1,4296,4577,JUNC00000083,153,+,4296,4577,255;0;0,2,27,142,0,139,4323,4435,112,0
18317ref1,704,1098,JUNC00000021,50,+,704,1098,255;0;0,2,142,149,0,245,846,949,103,0
18317ref1,2634,2803,JUNC00000056,46,-,2634,2803,255;0;0,2,36,30,0,139,2670,2773,103,0
18317ref1,2374,2636,JUNC00000047,47,+,2374,2636,255;0;0,2,19,146,0,116,2393,2490,97,0
18317ref1,454,845,JUNC00000009,20,-,454,845,255;0;0,2,149,149,0,242,603,696,93,0
18317ref1,670,1027,JUNC00000018,120,-,670,1027,255;0;0,2,115,149,0,208,785,878,93,0
18317ref1,7685,8065,JUNC00000117,22,-,7685,8065,255;0;0,2,144,149,0,231,7829,7916,87,0
18317ref1,7788,8070,JUNC00000118,3,-,7788,8070,255;0;0,2,47,148,0,134,7835,7922,87,0
18317ref1,1783,2055,JUNC00000040,62,-,1783,2055,255;0;0,2,43,143,0,129,1826,1912,86,0
18317ref1,1564,1942,JUNC00000037,246,+,1564,1942,255;0;0,2,146,149,0,229,1710,1793,83,0
18317ref1,4058,4372,JUNC00000079,206,-,4058,4372,255;0;0,2,82,150,0,164,4140,4222,82,0
18317ref1,8891,9098,JUNC00000127,1,+,8891,9098,255;0;0,2,24,101,0,106,8915,8997,82,0
18317ref1,554,818,JUNC00000008,21,-,554,818,255;0;0,2,41,149,0,115,595,669,74,0
18317ref1,3686,3907,JUNC00000075,44,-,3686,3907,255;0;0,2,8,144,0,77,3694,3763,69,0
18317ref1,2747,3109,JUNC00000066,10,+,2747,3109,255;0;0,2,146,148,0,214,2893,2961,68,0
18317ref1,544,767,JUNC00000007,74,+,544,767,255;0;0,2,8,148,0,75,552,619,67,0
18317ref1,5181,5398,JUNC00000097,1,+,5181,5398,255;0;0,2,24,127,0,90,5205,5271,66,0
18317ref1,7462,7700,JUNC00000109,6,+,7462,7700,255;0;0,2,23,149,0,89,7485,7551,66,0
18317ref1,1756,1888,JUNC00000039,33,+,1756,1888,255;0;0,2,24,44,0,88,1780,1844,64,0
18317ref1,2955,3167,JUNC00000068,1,+,2955,3167,255;0;0,2,92,59,0,153,3047,3108,61,0
18317ref1,9770,10035,JUNC00000131,75,+,9770,10035,255;0;0,2,56,148,0,117,9826,9887,61,0
18317ref1,2533,2763,JUNC00000051,11,+,2533,2763,255;0;0,2,20,150,0,80,2553,2613,60,0
18317ref1,4387,4705,JUNC00000087,927,-,4387,4705,255;0;0,2,110,150,0,168,4497,4555,58,0
18317ref1,8550,8907,JUNC00000126,7,+,8550,8907,255;0;0,2,150,149,0,208,8700,8758,58,0
18317ref1,955,1308,JUNC00000030,1010,-,955,1308,255;0;0,2,146,150,0,203,1101,1158,57,0
18317ref1,5892,6129,JUNC00000101,2,+,5892,6129,255;0;0,2,73,107,0,130,5965,6022,57,0
18317ref1,649,878,JUNC00000014,23,+,649,878,255;0;0,2,25,148,0,81,674,730,56,0
18317ref1,6552,6886,JUNC00000106,64,-,6552,6886,255;0;0,2,142,144,0,190,6694,6742,48,0
18317ref1,8234,8468,JUNC00000124,22,+,8234,8468,255;0;0,2,46,147,0,87,8280,8321,41,0
18317ref1,2565,2779,JUNC00000052,9,+,2565,2779,255;0;0,2,24,150,0,64,2589,2629,40,0
18317ref1,3049,3386,JUNC00000070,431,+,3049,3386,255;0;0,2,147,150,0,187,3196,3236,40,0
18317ref1,2729,3061,JUNC00000065,28,-,2729,3061,255;0;0,2,144,149,0,183,2873,2912,39,0
18317ref1,2880,3196,JUNC00000067,192,+,2880,3196,255;0;0,2,130,149,0,167,3010,3047,37,0
18317ref1,2148,2473,JUNC00000044,127,+,2148,2473,255;0;0,2,143,146,0,179,2291,2327,36,0
18317ref1,2238,2573,JUNC00000046,9,-,2238,2573,255;0;0,2,150,149,0,186,2388,2424,36,0
18317ref1,7541,7833,JUNC00000112,127,-,7541,7833,255;0;0,2,108,148,0,144,7649,7685,36,0
18317ref1,2389,2719,JUNC00000050,8,-,2389,2719,255;0;0,2,147,148,0,182,2536,2571,35,0
18317ref1,2449,2783,JUNC00000054,118,-,2449,2783,255;0;0,2,149,150,0,184,2598,2633,35,0
18317ref1,1035,1277,JUNC00000029,44,+,1035,1277,255;0;0,2,60,149,0,93,1095,1128,33,0
18317ref1,5455,5779,JUNC00000098,13,-,5455,5779,255;0;0,2,145,146,0,178,5600,5633,33,0
18317ref1,305,632,JUNC00000004,12,+,305,632,255;0;0,2,149,147,0,180,454,485,31,0
18317ref1,4226,4414,JUNC00000085,8,+,4226,4414,255;0;0,2,149,9,0,179,4375,4405,30,0
18317ref1,982,1184,JUNC00000028,2,-,982,1184,255;0;0,2,25,150,0,52,1007,1034,27,0
18317ref1,2669,2992,JUNC00000061,6,-,2669,2992,255;0;0,2,147,149,0,174,2816,2843,27,0
18317ref1,3208,3434,JUNC00000071,26,-,3208,3434,255;0;0,2,49,150,0,76,3257,3284,27,0
18317ref1,9524,9848,JUNC00000130,9,+,9524,9848,255;0;0,2,149,148,0,176,9673,9700,27,0
18317ref1,1263,1459,JUNC00000036,2,+,1263,1459,255;0;0,2,148,22,0,174,1411,1437,26,0
18317ref1,818,1020,JUNC00000020,10,+,818,1020,255;0;0,2,28,149,0,53,846,871,25,0
18317ref1,3022,3210,JUNC00000069,50,+,3022,3210,255;0;0,2,149,14,0,174,3171,3196,25,0
18317ref1,982,1178,JUNC00000027,2,-,982,1178,255;0;0,2,25,147,0,49,1007,1031,24,0
18317ref1,3725,4043,JUNC00000076,149,+,3725,4043,255;0;0,2,145,149,0,169,3870,3894,24,0
18317ref1,5454,5774,JUNC00000099,99,-,5454,5774,255;0;0,2,150,146,0,174,5604,5628,24,0
18317ref1,7428,7745,JUNC00000111,30,+,7428,7745,255;0;0,2,148,145,0,172,7576,7600,24,0
18317ref1,649,844,JUNC00000013,95,+,649,844,255;0;0,2,25,148,0,47,674,696,22,0
18317ref1,761,976,JUNC00000019,107,+,761,976,255;0;0,2,43,150,0,65,804,826,22,0
18317ref1,700,1019,JUNC00000022,27,+,700,1019,255;0;0,2,149,148,0,171,849,871,22,0
18317ref1,1860,2053,JUNC00000042,2,+,1860,2053,255;0;0,2,147,24,0,169,2007,2029,22,0
18317ref1,3630,3830,JUNC00000074,21,+,3630,3830,255;0;0,2,30,148,0,52,3660,3682,22,0
18317ref1,4936,5165,JUNC00000096,2,-,4936,5165,255;0;0,2,57,150,0,79,4993,5015,22,0
18317ref1,4914,5125,JUNC00000095,4,-,4914,5125,255;0;0,2,42,148,0,63,4956,4977,21,0
18317ref1,7797,7973,JUNC00000116,79,-,7797,7973,255;0;0,2,9,146,0,30,7806,7827,21,0
18317ref1,649,841,JUNC00000012,19,+,649,841,255;0;0,2,25,147,0,45,674,694,20,0
18317ref1,911,1138,JUNC00000026,66,+,911,1138,255;0;0,2,58,150,0,77,969,988,19,0
18317ref1,452,700,JUNC00000006,76,-,452,700,255;0;0,2,84,146,0,102,536,554,18,0
18317ref1,4615,4933,JUNC00000092,1960,+,4615,4933,255;0;0,2,150,150,0,168,4765,4783,18,0
18317ref1,5825,6142,JUNC00000102,58,+,5825,6142,255;0;0,2,149,150,0,167,5974,5992,18,0
18317ref1,4028,4298,JUNC00000078,726,+,4028,4298,255;0;0,2,104,149,0,121,4132,4149,17,0
18317ref1,7963,8278,JUNC00000123,98,-,7963,8278,255;0;0,2,149,149,0,166,8112,8129,17,0
18317ref1,2668,2858,JUNC00000060,6,-,2668,2858,255;0;0,2,148,26,0,164,2816,2832,16,0
18317ref1,2699,3009,JUNC00000063,11,+,2699,3009,255;0;0,2,147,147,0,163,2846,2862,16,0
18317ref1,2715,3005,JUNC00000064,23,+,2715,3005,255;0;0,2,150,124,0,166,2865,2881,16,0
18317ref1,3555,3765,JUNC00000072,4,+,3555,3765,255;0;0,2,47,147,0,63,3602,3618,16,0
18317ref1,2449,2763,JUNC00000053,9,+,2449,2763,255;0;0,2,149,150,0,164,2598,2613,15,0
18317ref1,2588,2779,JUNC00000055,6,+,2588,2779,255;0;0,2,26,150,0,41,2614,2629,15,0
18317ref1,4020,4192,JUNC00000077,41,-,4020,4192,255;0;0,2,8,149,0,23,4028,4043,15,0
18317ref1,7552,7853,JUNC00000114,94,+,7552,7853,255;0;0,2,147,139,0,162,7699,7714,15,0
18317ref1,2757,2966,JUNC00000059,75,-,2757,2966,255;0;0,2,45,150,0,59,2802,2816,14,0
18317ref1,4107,4418,JUNC00000082,11,+,4107,4418,255;0;0,2,150,147,0,164,4257,4271,14,0
18317ref1,7271,7534,JUNC00000107,182,+,7271,7534,255;0;0,2,100,149,0,114,7371,7385,14,0
18317ref1,194,501,JUNC00000002,26,+,194,501,255;0;0,2,150,144,0,163,344,357,13,0
18317ref1,2731,2848,JUNC00000062,1,+,2731,2848,255;0;0,2,96,8,0,109,2827,2840,13,0
18317ref1,741,931,JUNC00000017,28,+,741,931,255;0;0,2,29,150,0,40,770,781,11,0
18317ref1,4224,4407,JUNC00000081,6,-,4224,4407,255;0;0,2,22,150,0,33,4246,4257,11,0
18317ref1,4785,4991,JUNC00000094,512,+,4785,4991,255;0;0,2,150,47,0,159,4935,4944,9,0
18317ref1,1003,1308,JUNC00000033,100,-,1003,1308,255;0;0,2,147,150,0,155,1150,1158,8,0
18317ref1,8006,8261,JUNC00000122,41,+,8006,8261,255;0;0,2,98,149,0,106,8104,8112,8,0
18317ref1,823,1125,JUNC00000025,104,+,823,1125,255;0;0,2,146,149,0,153,969,976,7,0
18317ref1,1858,2163,JUNC00000041,15,+,1858,2163,255;0;0,2,149,149,0,156,2007,2014,7,0
18317ref1,4331,4403,JUNC00000084,7,-,4331,4403,255;0;0,2,44,21,0,51,4375,4382,7,0
18317ref1,6365,6633,JUNC00000105,3,+,6365,6633,255;0;0,2,119,142,0,126,6484,6491,7,0
18317ref1,7541,7844,JUNC00000113,2,+,7541,7844,255;0;0,2,148,148,0,155,7689,7696,7,0
18317ref1,7955,8113,JUNC00000121,2,-,7955,8113,255;0;0,2,30,121,0,37,7985,7992,7,0
18317ref1,9017,9322,JUNC00000129,5,+,9017,9322,255;0;0,2,149,149,0,156,9166,9173,7,0
18317ref1,965,1265,JUNC00000031,2,+,965,1265,255;0;0,2,149,145,0,155,1114,1120,6,0
18317ref1,709,1008,JUNC00000023,24,-,709,1008,255;0;0,2,146,148,0,151,855,860,5,0
18317ref1,1000,1301,JUNC00000032,4,-,1000,1301,255;0;0,2,150,146,0,155,1150,1155,5,0
18317ref1,1246,1468,JUNC00000035,16,+,1246,1468,255;0;0,2,147,70,0,152,1393,1398,5,0
18317ref1,4108,4259,JUNC00000080,140,+,4108,4259,255;0;0,2,104,42,0,109,4212,4217,5,0
18317ref1,7423,7727,JUNC00000110,4,-,7423,7727,255;0;0,2,150,149,0,155,7573,7578,5,0
18317ref1,8791,9078,JUNC00000128,2011,+,8791,9078,255;0;0,2,132,150,0,137,8923,8928,5,0
17067ref1,2644,10014,JUNC00000050,7,-,2644,10014,255;0;0,2,148,147,0,7223,2792,9867,7075,0
17067ref1,2129,3510,JUNC00000034,42,-,2129,3510,255;0;0,2,147,150,0,1231,2276,3360,1084,0
17067ref1,546,1056,JUNC00000004,101,+,546,1056,255;0;0,2,110,41,0,469,656,1015,359,0
17067ref1,5298,5891,JUNC00000076,112,+,5298,5891,255;0;0,2,120,143,0,450,5418,5748,330,0
17067ref1,851,1311,JUNC00000020,38,-,851,1311,255;0;0,2,145,22,0,438,996,1289,293,0
17067ref1,871,1452,JUNC00000021,61,+,871,1452,255;0;0,2,144,144,0,437,1015,1308,293,0
17067ref1,1528,1976,JUNC00000029,2,+,1528,1976,255;0;0,2,64,91,0,357,1592,1885,293,0
17067ref1,7031,7485,JUNC00000090,2,+,7031,7485,255;0;0,2,97,83,0,371,7128,7402,274,0
17067ref1,7289,7739,JUNC00000092,2,+,7289,7739,255;0;0,2,33,149,0,301,7322,7590,268,0
17067ref1,2225,2786,JUNC00000035,742,+,2225,2786,255;0;0,2,150,150,0,411,2375,2636,261,0
17067ref1,9677,10231,JUNC00000116,99,-,9677,10231,255;0;0,2,149,150,0,404,9826,10081,255,0
17067ref1,5169,5690,JUNC00000074,1359,+,5169,5690,255;0;0,2,150,127,0,394,5319,5563,244,0
17067ref1,5316,5640,JUNC00000075,1,+,5316,5640,255;0;0,2,8,72,0,252,5324,5568,244,0
17067ref1,696,1225,JUNC00000013,6,+,696,1225,255;0;0,2,147,146,0,383,843,1079,236,0
17067ref1,4351,4730,JUNC00000066,9,-,4351,4730,255;0;0,2,24,149,0,230,4375,4581,206,0
17067ref1,7404,7764,JUNC00000095,7,-,7404,7764,255;0;0,2,23,150,0,210,7427,7614,187,0
17067ref1,7406,7772,JUNC00000096,3,-,7406,7772,255;0;0,2,30,149,0,217,7436,7623,187,0
17067ref1,620,1100,JUNC00000012,22,-,620,1100,255;0;0,2,150,147,0,333,770,953,183,0
17067ref1,694,1025,JUNC00000009,9,+,694,1025,255;0;0,2,16,150,0,181,710,875,165,0
17067ref1,451,814,JUNC00000002,60,-,451,814,255;0;0,2,58,145,0,218,509,669,160,0
17067ref1,507,834,JUNC00000003,2,+,507,834,255;0;0,2,21,146,0,181,528,688,160,0
17067ref1,722,1038,JUNC00000010,14,+,722,1038,255;0;0,2,10,148,0,168,732,890,158,0
17067ref1,2633,2988,JUNC00000049,11,+,2633,2988,255;0;0,2,64,148,0,207,2697,2840,143,0
17067ref1,2238,2676,JUNC00000038,32,+,2238,2676,255;0;0,2,150,146,0,292,2388,2530,142,0
17067ref1,5237,5451,JUNC00000073,1,-,5237,5451,255;0;0,2,29,43,0,171,5266,5408,142,0
17067ref1,5695,6126,JUNC00000080,17,+,5695,6126,255;0;0,2,149,146,0,285,5844,5980,136,0
17067ref1,4480,4763,JUNC00000069,208,-,4480,4763,255;0;0,2,52,96,0,187,4532,4667,135,0
17067ref1,2243,2670,JUNC00000037,2,-,2243,2670,255;0;0,2,145,149,0,278,2388,2521,133,0
17067ref1,6758,7182,JUNC00000088,108,-,6758,7182,255;0;0,2,148,147,0,277,6906,7035,129,0
17067ref1,718,1028,JUNC00000011,2,-,718,1028,255;0;0,2,39,150,0,160,757,878,121,0
17067ref1,2343,2738,JUNC00000042,4,+,2343,2738,255;0;0,2,150,125,0,270,2493,2613,120,0
17067ref1,2434,2771,JUNC00000045,3,+,2434,2771,255;0;0,2,144,76,0,261,2578,2695,117,0
17067ref1,7120,7390,JUNC00000089,43,+,7120,7390,255;0;0,2,8,150,0,120,7128,7240,112,0
17067ref1,2725,3127,JUNC00000055,28,-,2725,3127,255;0;0,2,148,149,0,253,2873,2978,105,0
17067ref1,1399,1709,JUNC00000028,122,+,1399,1709,255;0;0,2,66,144,0,166,1465,1565,100,0
17067ref1,1680,2057,JUNC00000032,53,-,1680,2057,255;0;0,2,146,145,0,232,1826,1912,86,0
17067ref1,1770,2006,JUNC00000030,1,+,1770,2006,255;0;0,2,30,121,0,115,1800,1885,85,0
17067ref1,8907,9140,JUNC00000111,1,+,8907,9140,255;0;0,2,8,143,0,90,8915,8997,82,0
17067ref1,7843,8072,JUNC00000105,1,-,7843,8072,255;0;0,2,121,30,0,199,7964,8042,78,0
17067ref1,630,851,JUNC00000008,1,+,630,851,255;0;0,2,44,106,0,115,674,745,71,0
17067ref1,7362,7629,JUNC00000098,69,-,7362,7629,255;0;0,2,149,51,0,216,7511,7578,67,0
17067ref1,713,1070,JUNC00000015,83,-,713,1070,255;0;0,2,147,147,0,210,860,923,63,0
17067ref1,4409,4693,JUNC00000068,116,-,4409,4693,255;0;0,2,88,138,0,146,4497,4555,58,0
17067ref1,8389,8695,JUNC00000110,4,+,8389,8695,255;0;0,2,99,149,0,157,8488,8546,58,0
17067ref1,955,1306,JUNC00000022,984,-,955,1306,255;0;0,2,146,148,0,203,1101,1158,57,0
17067ref1,630,876,JUNC00000007,11,+,630,876,255;0;0,2,44,146,0,100,674,730,56,0
17067ref1,9069,9274,JUNC00000113,1,-,9069,9274,255;0;0,2,9,142,0,63,9078,9132,54,0
17067ref1,926,1171,JUNC00000019,3,+,926,1171,255;0;0,2,43,149,0,96,969,1022,53,0
17067ref1,1793,1996,JUNC00000033,3,-,1793,1996,255;0;0,2,67,84,0,119,1860,1912,52,0
17067ref1,5496,5797,JUNC00000077,27,+,5496,5797,255;0;0,2,104,145,0,156,5600,5652,52,0
17067ref1,7723,8065,JUNC00000104,64,-,7723,8065,255;0;0,2,143,149,0,193,7866,7916,50,0
17067ref1,5681,6028,JUNC00000079,7,+,5681,6028,255;0;0,2,149,149,0,198,5830,5879,49,0
17067ref1,6686,6886,JUNC00000084,5,-,6686,6886,255;0;0,2,8,144,0,56,6694,6742,48,0
17067ref1,7966,8311,JUNC00000108,3,-,7966,8311,255;0;0,2,149,150,0,195,8115,8161,46,0
17067ref1,2428,2652,JUNC00000041,14,+,2428,2652,255;0;0,2,34,145,0,79,2462,2507,45,0
17067ref1,2873,3162,JUNC00000056,105,-,2873,3162,255;0;0,2,99,148,0,141,2972,3014,42,0
17067ref1,2416,2682,JUNC00000044,3,+,2416,2682,255;0;0,2,149,76,0,190,2565,2606,41,0
17067ref1,2566,2779,JUNC00000047,6,+,2566,2779,255;0;0,2,23,150,0,63,2589,2629,40,0
17067ref1,6749,6966,JUNC00000086,4,-,6749,6966,255;0;0,2,29,148,0,69,6778,6818,40,0
17067ref1,5589,5902,JUNC00000078,4,+,5589,5902,255;0;0,2,147,127,0,186,5736,5775,39,0
17067ref1,4107,4444,JUNC00000065,6,+,4107,4444,255;0;0,2,150,149,0,188,4257,4295,38,0
17067ref1,7965,8293,JUNC00000107,81,-,7965,8293,255;0;0,2,147,143,0,185,8112,8150,38,0
17067ref1,2238,2572,JUNC00000036,25,-,2238,2572,255;0;0,2,150,148,0,186,2388,2424,36,0
17067ref1,2394,2727,JUNC00000043,2,-,2394,2727,255;0;0,2,150,147,0,186,2544,2580,36,0
17067ref1,2450,2781,JUNC00000048,114,-,2450,2781,255;0;0,2,148,148,0,183,2598,2633,35,0
17067ref1,2659,2987,JUNC00000051,10,+,2659,2987,255;0;0,2,147,147,0,181,2806,2840,34,0
17067ref1,174,506,JUNC00000001,344,+,174,506,255;0;0,2,150,149,0,183,324,357,33,0
17067ref1,729,1058,JUNC00000017,14,+,729,1058,255;0;0,2,149,148,0,181,878,910,32,0
17067ref1,5827,6157,JUNC00000081,2,+,5827,6157,255;0;0,2,149,150,0,180,5976,6007,31,0
17067ref1,3932,4136,JUNC00000061,24,+,3932,4136,255;0;0,2,24,150,0,54,3956,3986,30,0
17067ref1,4009,4297,JUNC00000062,147,+,4009,4297,255;0;0,2,111,148,0,140,4120,4149,29,0
17067ref1,1283,1516,JUNC00000027,5,+,1283,1516,255;0;0,2,128,77,0,156,1411,1439,28,0
17067ref1,3206,3426,JUNC00000057,4,-,3206,3426,255;0;0,2,51,142,0,78,3257,3284,27,0
17067ref1,3470,3793,JUNC00000058,129,-,3470,3793,255;0;0,2,150,146,0,177,3620,3647,27,0
17067ref1,9835,10070,JUNC00000117,28,+,9835,10070,255;0;0,2,63,145,0,90,9898,9925,27,0
17067ref1,7433,7610,JUNC00000099,1,-,7433,7610,255;0;0,2,97,54,0,123,7530,7556,26,0
17067ref1,699,1019,JUNC00000014,29,+,699,1019,255;0;0,2,147,148,0,172,846,871,25,0
17067ref1,4132,4332,JUNC00000063,150,+,4132,4332,255;0;0,2,26,149,0,51,4158,4183,25,0
17067ref1,3617,3879,JUNC00000059,1352,-,3617,3879,255;0;0,2,150,88,0,174,3767,3791,24,0
17067ref1,7426,7746,JUNC00000101,22,+,7426,7746,255;0;0,2,150,146,0,174,7576,7600,24,0
17067ref1,969,1286,JUNC00000024,2,+,969,1286,255;0;0,2,147,147,0,170,1116,1139,23,0
17067ref1,2671,2993,JUNC00000053,70,-,2671,2993,255;0;0,2,149,150,0,172,2820,2843,23,0
17067ref1,7363,7661,JUNC00000097,4,-,7363,7661,255;0;0,2,126,149,0,149,7489,7512,23,0
17067ref1,652,844,JUNC00000006,88,+,652,844,255;0;0,2,22,148,0,44,674,696,22,0
17067ref1,5058,5230,JUNC00000072,2,-,5058,5230,255;0;0,2,8,143,0,29,5066,5087,21,0
17067ref1,6224,6545,JUNC00000083,39,-,6224,6545,255;0;0,2,150,150,0,171,6374,6395,21,0
17067ref1,652,838,JUNC00000005,12,+,652,838,255;0;0,2,22,144,0,42,674,694,20,0
17067ref1,2671,2990,JUNC00000052,20,-,2671,2990,255;0;0,2,149,150,0,169,2820,2840,20,0
17067ref1,4687,4926,JUNC00000070,4,+,4687,4926,255;0;0,2,78,143,0,96,4765,4783,18,0
17067ref1,7964,8191,JUNC00000106,69,-,7964,8191,255;0;0,2,148,62,0,165,8112,8129,17,0
17067ref1,9596,9732,JUNC00000115,163,-,9596,9732,255;0;0,2,59,60,0,76,9655,9672,17,0
17067ref1,2716,2949,JUNC00000054,15,+,2716,2949,255;0;0,2,149,68,0,165,2865,2881,16,0
17067ref1,2435,2747,JUNC00000046,7,+,2435,2747,255;0;0,2,149,148,0,164,2584,2599,15,0
17067ref1,3800,4013,JUNC00000060,29,-,3800,4013,255;0;0,2,54,144,0,69,3854,3869,15,0
17067ref1,4107,4418,JUNC00000064,10,+,4107,4418,255;0;0,2,150,147,0,164,4257,4271,14,0
17067ref1,7358,7572,JUNC00000094,26,-,7358,7572,255;0;0,2,51,149,0,65,7409,7423,14,0
17067ref1,7285,7515,JUNC00000093,4,-,7285,7515,255;0;0,2,71,146,0,84,7356,7369,13,0
17067ref1,6849,7047,JUNC00000087,8,+,6849,7047,255;0;0,2,38,148,0,50,6887,6899,12,0
17067ref1,822,1022,JUNC00000016,37,+,822,1022,255;0;0,2,45,144,0,56,867,878,11,0
17067ref1,1261,1544,JUNC00000026,19,-,1261,1544,255;0;0,2,125,149,0,134,1386,1395,9,0
17067ref1,4785,5020,JUNC00000071,440,+,4785,5020,255;0;0,2,150,76,0,159,4935,4944,9,0
17067ref1,1001,1306,JUNC00000025,117,-,1001,1306,255;0;0,2,149,148,0,157,1150,1158,8,0
17067ref1,825,1123,JUNC00000018,14,+,825,1123,255;0;0,2,144,147,0,151,969,976,7,0
17067ref1,1660,1862,JUNC00000031,2,-,1660,1862,255;0;0,2,149,46,0,156,1809,1816,7,0
17067ref1,7540,7845,JUNC00000102,3,+,7540,7845,255;0;0,2,149,149,0,156,7689,7696,7,0
17067ref1,7717,7958,JUNC00000103,21,+,7717,7958,255;0;0,2,149,85,0,156,7866,7873,7,0
17067ref1,965,1269,JUNC00000023,6,+,965,1269,255;0;0,2,149,149,0,155,1114,1120,6,0
17067ref1,6037,6229,JUNC00000082,2,-,6037,6229,255;0;0,2,45,141,0,51,6082,6088,6,0
17067ref1,6616,6773,JUNC00000085,1,+,6616,6773,255;0;0,2,133,18,0,139,6749,6755,6,0
17067ref1,2362,2560,JUNC00000039,23,-,2362,2560,255;0;0,2,44,149,0,49,2406,2411,5,0
17067ref1,2287,2588,JUNC00000040,4,+,2287,2588,255;0;0,2,149,147,0,154,2436,2441,5,0
17067ref1,4264,4568,JUNC00000067,70,-,4264,4568,255;0;0,2,149,150,0,154,4413,4418,5,0
17067ref1,6990,7290,JUNC00000091,28,+,6990,7290,255;0;0,2,147,148,0,152,7137,7142,5,0
17067ref1,7423,7677,JUNC00000100,9,-,7423,7677,255;0;0,2,150,99,0,155,7573,7578,5,0
17067ref1,8130,8339,JUNC00000109,584,+,8130,8339,255;0;0,2,54,150,0,59,8184,8189,5,0
17067ref1,8784,9078,JUNC00000112,888,+,8784,9078,255;0;0,2,139,150,0,144,8923,8928,5,0
17067ref1,9477,9779,JUNC00000114,139,+,9477,9779,255;0;0,2,150,147,0,155,9627,9632,5,0
24449ref3,6287,9236,JUNC00000027,1,+,6287,9236,255;0;0,2,23,128,0,2821,6310,9108,2798,0
24449ref3,6487,7597,JUNC00000028,1,+,6487,7597,255;0;0,2,128,23,0,1087,6615,7574,959,0
24449ref3,6965,7849,JUNC00000030,234,+,6965,7849,255;0;0,2,150,150,0,734,7115,7699,584,0
24449ref3,1315,1884,JUNC00000011,16,-,1315,1884,255;0;0,2,143,10,0,559,1458,1874,416,0
24449ref3,8627,9107,JUNC00000039,30,-,8627,9107,255;0;0,2,120,67,0,413,8747,9040,293,0
24449ref3,2446,2815,JUNC00000017,1,+,2446,2815,255;0;0,2,55,44,0,325,2501,2771,270,0
24449ref3,2426,2839,JUNC00000018,2,-,2426,2839,255;0;0,2,128,23,0,390,2554,2816,262,0
24449ref3,2196,2509,JUNC00000015,1,-,2196,2509,255;0;0,2,23,32,0,281,2219,2477,258,0
24449ref3,7313,7711,JUNC00000031,3,+,7313,7711,255;0;0,2,9,143,0,255,7322,7568,246,0
24449ref3,7552,7997,JUNC00000035,2,+,7552,7997,255;0;0,2,147,109,0,336,7699,7888,189,0
24449ref3,9671,9958,JUNC00000046,1,-,9671,9958,255;0;0,2,17,134,0,153,9688,9824,136,0
24449ref3,2238,2657,JUNC00000016,57,+,2238,2657,255;0;0,2,150,148,0,271,2388,2509,121,0
24449ref3,4770,5033,JUNC00000025,2,+,4770,5033,255;0;0,2,45,106,0,157,4815,4927,112,0
24449ref3,9021,9275,JUNC00000041,25,+,9021,9275,255;0;0,2,9,145,0,109,9030,9130,100,0
24449ref3,1781,2026,JUNC00000012,3,-,1781,2026,255;0;0,2,45,114,0,131,1826,1912,86,0
24449ref3,2901,3129,JUNC00000021,1,+,2901,3129,255;0;0,2,69,82,0,146,2970,3047,77,0
24449ref3,6814,7040,JUNC00000029,3,-,6814,7040,255;0;0,2,147,9,0,217,6961,7031,70,0
24449ref3,1778,1951,JUNC00000013,2,+,1778,1951,255;0;0,2,72,33,0,140,1850,1918,68,0
24449ref3,7361,7637,JUNC00000032,186,-,7361,7637,255;0;0,2,150,59,0,217,7511,7578,67,0
24449ref3,8288,8651,JUNC00000037,1429,+,8288,8651,255;0;0,2,150,150,0,213,8438,8501,63,0
24449ref3,951,1167,JUNC00000004,9,-,951,1167,255;0;0,2,148,9,0,207,1099,1158,59,0
24449ref3,3005,3151,JUNC00000022,1,+,3005,3151,255;0;0,2,42,45,0,101,3047,3106,59,0
24449ref3,4465,4682,JUNC00000024,2,-,4465,4682,255;0;0,2,32,127,0,90,4497,4555,58,0
24449ref3,8380,8643,JUNC00000038,2,+,8380,8643,255;0;0,2,108,97,0,166,8488,8546,58,0
24449ref3,8934,9149,JUNC00000042,3,-,8934,9149,255;0;0,2,140,17,0,198,9074,9132,58,0
24449ref3,9035,9245,JUNC00000044,3,+,9035,9245,255;0;0,2,144,8,0,202,9179,9237,58,0
24449ref3,955,1247,JUNC00000005,329,-,955,1247,255;0;0,2,146,89,0,203,1101,1158,57,0
24449ref3,825,1171,JUNC00000003,13,+,825,1171,255;0;0,2,144,149,0,197,969,1022,53,0
24449ref3,1720,1927,JUNC00000014,2,-,1720,1927,255;0;0,2,140,15,0,192,1860,1912,52,0
24449ref3,10047,10244,JUNC00000048,1,+,10047,10244,255;0;0,2,99,52,0,145,10146,10192,46,0
24449ref3,7637,7824,JUNC00000033,1,+,7637,7824,255;0;0,2,23,128,0,59,7660,7696,36,0
24449ref3,9866,10053,JUNC00000047,1,-,9866,10053,255;0;0,2,84,67,0,120,9950,9986,36,0
24449ref3,2673,3005,JUNC00000020,1343,+,2673,3005,255;0;0,2,150,147,0,185,2823,2858,35,0
24449ref3,8990,9315,JUNC00000043,11,-,8990,9315,255;0;0,2,146,147,0,178,9136,9168,32,0
24449ref3,7620,7792,JUNC00000034,1,+,7620,7792,255;0;0,2,54,96,0,76,7674,7696,22,0
24449ref3,1162,1394,JUNC00000007,7,-,1162,1394,255;0;0,2,62,149,0,83,1224,1245,21,0
24449ref3,1119,1420,JUNC00000008,3,+,1119,1420,255;0;0,2,130,150,0,151,1249,1270,21,0
24449ref3,7962,8279,JUNC00000036,117,-,7962,8279,255;0;0,2,150,150,0,167,8112,8129,17,0
24449ref3,5900,6216,JUNC00000026,302,+,5900,6216,255;0;0,2,150,150,0,166,6050,6066,16,0
24449ref3,2596,2638,JUNC00000019,1,+,2596,2638,255;0;0,2,18,9,0,33,2614,2629,15,0
24449ref3,4128,4421,JUNC00000023,37,+,4128,4421,255;0;0,2,129,150,0,143,4257,4271,14,0
24449ref3,304,613,JUNC00000001,179,+,304,613,255;0;0,2,150,150,0,159,454,463,9,0
24449ref3,1003,1305,JUNC00000006,108,-,1003,1305,255;0;0,2,147,147,0,155,1150,1158,8,0
24449ref3,824,1126,JUNC00000002,150,+,824,1126,255;0;0,2,145,150,0,152,969,976,7,0
24449ref3,1289,1595,JUNC00000010,22,-,1289,1595,255;0;0,2,149,150,0,156,1438,1445,7,0
24449ref3,1265,1566,JUNC00000009,80,+,1265,1566,255;0;0,2,146,150,0,151,1411,1416,5,0
24449ref3,8773,9078,JUNC00000040,15972,+,8773,9078,255;0;0,2,150,150,0,155,8923,8928,5,0
24449ref3,9514,9780,JUNC00000045,3,+,9514,9780,255;0;0,2,113,148,0,118,9627,9632,5,0
16767ref2,584,877,JUNC00000001,200,+,584,877,255;0;0,2,72,147,0,146,656,730,74,0
16767ref2,583,1134,JUNC00000002,128,+,583,1134,255;0;0,2,73,119,0,432,656,1015,359,0
16767ref2,710,934,JUNC00000003,2,+,710,934,255;0;0,2,54,122,0,102,764,812,48,0
16767ref2,648,969,JUNC00000004,189,+,648,969,255;0;0,2,145,143,0,178,793,826,33,0
16767ref2,669,968,JUNC00000005,111,+,669,968,255;0;0,2,124,33,0,266,793,935,142,0
16767ref2,663,982,JUNC00000006,123,+,663,982,255;0;0,2,132,150,0,169,795,832,37,0
16767ref2,702,1016,JUNC00000007,120,+,702,1016,255;0;0,2,144,145,0,169,846,871,25,0
16767ref2,732,1058,JUNC00000008,41,+,732,1058,255;0;0,2,146,148,0,178,878,910,32,0
16767ref2,832,1085,JUNC00000009,38,+,832,1085,255;0;0,2,98,150,0,103,930,935,5,0
16767ref2,823,1126,JUNC00000010,105,+,823,1126,255;0;0,2,146,150,0,153,969,976,7,0
16767ref2,825,1138,JUNC00000011,21,+,825,1138,255;0;0,2,144,150,0,163,969,988,19,0
16767ref2,955,1185,JUNC00000012,367,-,955,1185,255;0;0,2,146,27,0,203,1101,1158,57,0
16767ref2,971,1295,JUNC00000013,21,+,971,1295,255;0;0,2,140,150,0,174,1111,1145,34,0
16767ref2,979,1141,JUNC00000014,67,-,979,1141,255;0;0,2,149,8,0,154,1128,1133,5,0
16767ref2,979,1167,JUNC00000015,140,-,979,1167,255;0;0,2,149,9,0,179,1128,1158,30,0
16767ref2,1002,1256,JUNC00000016,58,-,1002,1256,255;0;0,2,148,98,0,156,1150,1158,8,0
16767ref2,1362,1760,JUNC00000017,11,-,1362,1760,255;0;0,2,149,149,0,249,1511,1611,100,0
16767ref2,1741,2012,JUNC00000018,1,+,1741,2012,255;0;0,2,8,40,0,231,1749,1972,223,0
16767ref2,1601,1973,JUNC00000019,1887,-,1601,1973,255;0;0,2,150,147,0,225,1751,1826,75,0
16767ref2,1767,2004,JUNC00000020,2,-,1767,2004,255;0;0,2,59,92,0,145,1826,1912,86,0
16767ref2,2289,2608,JUNC00000021,19,-,2289,2608,255;0;0,2,75,144,0,175,2364,2464,100,0
16767ref2,2375,2634,JUNC00000022,3,+,2375,2634,255;0;0,2,18,144,0,115,2393,2490,97,0
16767ref2,2501,2749,JUNC00000023,23,+,2501,2749,255;0;0,2,64,143,0,105,2565,2606,41,0
16767ref2,2436,2748,JUNC00000024,6,+,2436,2748,255;0;0,2,148,149,0,163,2584,2599,15,0
16767ref2,2449,2763,JUNC00000025,7,+,2449,2763,255;0;0,2,149,150,0,164,2598,2613,15,0
16767ref2,2449,2781,JUNC00000026,169,-,2449,2781,255;0;0,2,149,148,0,184,2598,2633,35,0
16767ref2,2474,2784,JUNC00000027,9,+,2474,2784,255;0;0,2,147,114,0,196,2621,2670,49,0
16767ref2,2680,2964,JUNC00000028,41,+,2680,2964,255;0;0,2,126,148,0,136,2806,2816,10,0
16767ref2,2680,2995,JUNC00000029,414,+,2680,2995,255;0;0,2,150,150,0,165,2830,2845,15,0
16767ref2,2680,5940,JUNC00000030,78,+,2680,5940,255;0;0,2,150,149,0,3111,2830,5791,2961,0
16767ref2,2800,7954,JUNC00000031,2,+,2800,7954,255;0;0,2,119,32,0,5122,2919,7922,5003,0
16767ref2,2964,3115,JUNC00000032,6,+,2964,3115,255;0;0,2,8,135,0,16,2972,2980,8,0
16767ref2,3047,3365,JUNC00000033,59,-,3047,3365,255;0;0,2,150,150,0,168,3197,3215,18,0
16767ref2,3248,3433,JUNC00000034,5,-,3248,3433,255;0;0,2,9,149,0,36,3257,3284,27,0
16767ref2,3566,3938,JUNC00000035,5259,-,3566,3938,255;0;0,2,150,150,0,222,3716,3788,72,0
16767ref2,3573,3931,JUNC00000036,484,-,3573,3931,255;0;0,2,150,149,0,209,3723,3782,59,0
16767ref2,3831,4115,JUNC00000037,12,-,3831,4115,255;0;0,2,149,126,0,158,3980,3989,9,0
16767ref2,4108,4335,JUNC00000038,2,+,4108,4335,255;0;0,2,28,148,0,79,4136,4187,51,0
16767ref2,4092,4415,JUNC00000039,3,-,4092,4415,255;0;0,2,150,150,0,173,4242,4265,23,0
16767ref2,4295,7695,JUNC00000040,3,+,4295,7695,255;0;0,2,44,107,0,3293,4339,7588,3249,0
16767ref2,4208,4523,JUNC00000041,49,-,4208,4523,255;0;0,2,144,149,0,166,4352,4374,22,0
16767ref2,4226,4443,JUNC00000042,14,+,4226,4443,255;0;0,2,149,38,0,179,4375,4405,30,0
16767ref2,4298,4646,JUNC00000043,37,-,4298,4646,255;0;0,2,139,149,0,199,4437,4497,60,0
16767ref2,4369,4705,JUNC00000044,480,-,4369,4705,255;0;0,2,128,150,0,186,4497,4555,58,0
16767ref2,4380,4658,JUNC00000045,11,+,4380,4658,255;0;0,2,149,109,0,169,4529,4549,20,0
16767ref2,4412,4824,JUNC00000046,53,-,4412,4824,255;0;0,2,127,150,0,262,4539,4674,135,0
16767ref2,4914,5158,JUNC00000047,5,-,4914,5158,255;0;0,2,51,146,0,98,4965,5012,47,0
16767ref2,4846,5165,JUNC00000048,5,-,4846,5165,255;0;0,2,147,150,0,169,4993,5015,22,0
16767ref2,4889,7708,JUNC00000049,25,+,4889,7708,255;0;0,2,143,9,0,2810,5032,7699,2667,0
16767ref2,4922,5237,JUNC00000050,66,-,4922,5237,255;0;0,2,144,150,0,165,5066,5087,21,0
16767ref2,5894,6107,JUNC00000051,737,+,5894,6107,255;0;0,2,150,41,0,172,6044,6066,22,0
16767ref2,5916,6231,JUNC00000052,375,-,5916,6231,255;0;0,2,150,150,0,165,6066,6081,15,0
16767ref2,6093,8510,JUNC00000053,5,-,6093,8510,255;0;0,2,143,149,0,2268,6236,8361,2125,0
16767ref2,6785,7109,JUNC00000054,48,-,6785,7109,255;0;0,2,149,150,0,174,6934,6959,25,0
16767ref2,7380,7701,JUNC00000055,8,-,7380,7701,255;0;0,2,150,150,0,171,7530,7551,21,0
16767ref2,7423,7655,JUNC00000056,21,-,7423,7655,255;0;0,2,150,77,0,155,7573,7578,5,0
16767ref2,7511,7845,JUNC00000057,24,+,7511,7845,255;0;0,2,149,149,0,185,7660,7696,36,0
16767ref2,7707,8036,JUNC00000058,440,+,7707,8036,255;0;0,2,150,148,0,181,7857,7888,31,0
16767ref2,7962,8278,JUNC00000059,564,-,7962,8278,255;0;0,2,150,149,0,167,8112,8129,17,0
16767ref2,8231,8518,JUNC00000060,2,+,8231,8518,255;0;0,2,27,124,0,163,8258,8394,136,0
16767ref2,8281,8646,JUNC00000061,271,+,8281,8646,255;0;0,2,150,150,0,215,8431,8496,65,0
16767ref2,8294,8639,JUNC00000062,2,+,8294,8639,255;0;0,2,150,147,0,198,8444,8492,48,0
16767ref2,8380,8696,JUNC00000063,136,+,8380,8696,255;0;0,2,108,150,0,166,8488,8546,58,0
16767ref2,8773,9078,JUNC00000064,2359,+,8773,9078,255;0;0,2,150,150,0,155,8923,8928,5,0
31711ref2,1261,9941,JUNC00000027,1,+,1261,9941,255;0;0,2,9,142,0,8538,1270,9799,8529,0
31711ref2,2648,9296,JUNC00000063,2,+,2648,9296,255;0;0,2,22,145,0,6503,2670,9151,6481,0
31711ref2,2659,9321,JUNC00000065,9,+,2659,9321,255;0;0,2,147,91,0,6571,2806,9230,6424,0
31711ref2,4700,10269,JUNC00000088,1,+,4700,10269,255;0;0,2,24,127,0,5442,4724,10142,5418,0
31711ref2,2518,7768,JUNC00000061,2,+,2518,7768,255;0;0,2,129,46,0,5204,2647,7722,5075,0
31711ref2,4555,9081,JUNC00000086,4,+,4555,9081,255;0;0,2,11,141,0,4385,4566,8940,4374,0
31711ref2,4541,8907,JUNC00000085,7,+,4541,8907,255;0;0,2,25,22,0,4344,4566,8885,4319,0
31711ref2,4420,8918,JUNC00000084,22,+,4420,8918,255;0;0,2,146,143,0,4355,4566,8775,4209,0
31711ref2,2423,6250,JUNC00000053,746,+,2423,6250,255;0;0,2,8,150,0,3677,2431,6100,3669,0
31711ref2,2629,6039,JUNC00000064,28,+,2629,6039,255;0;0,2,142,96,0,3314,2771,5943,3172,0
31711ref2,3079,6248,JUNC00000073,2,+,3079,6248,255;0;0,2,57,142,0,3027,3136,6106,2970,0
31711ref2,4576,7650,JUNC00000087,8,+,4576,7650,255;0;0,2,148,67,0,3007,4724,7583,2859,0
31711ref2,585,2487,JUNC00000007,80,-,585,2487,255;0;0,2,53,148,0,1754,638,2339,1701,0
31711ref2,6117,7948,JUNC00000099,7,-,6117,7948,255;0;0,2,9,142,0,1689,6126,7806,1680,0
31711ref2,7466,9272,JUNC00000111,10,-,7466,9272,255;0;0,2,150,150,0,1656,7616,9122,1506,0
31711ref2,9126,9971,JUNC00000144,2,+,9126,9971,255;0;0,2,66,8,0,837,9192,9963,771,0
31711ref2,9078,10062,JUNC00000146,22,+,9078,10062,255;0;0,2,144,69,0,915,9222,9993,771,0
31711ref2,4579,5247,JUNC00000089,11,+,4579,5247,255;0;0,2,149,104,0,564,4728,5143,415,0
31711ref2,4584,5180,JUNC00000090,11,+,4584,5180,255;0;0,2,150,31,0,565,4734,5149,415,0
31711ref2,8505,9041,JUNC00000131,2,+,8505,9041,255;0;0,2,107,44,0,492,8612,8997,385,0
31711ref2,4645,5144,JUNC00000092,1,+,4645,5144,255;0;0,2,120,31,0,468,4765,5113,348,0
31711ref2,2337,2832,JUNC00000054,2,-,2337,2832,255;0;0,2,127,24,0,471,2464,2808,344,0
31711ref2,534,1133,JUNC00000010,10,+,534,1133,255;0;0,2,140,118,0,481,674,1015,341,0
31711ref2,7214,7770,JUNC00000105,279,-,7214,7770,255;0;0,2,73,145,0,411,7287,7625,338,0
31711ref2,2358,2819,JUNC00000051,160,+,2358,2819,255;0;0,2,8,149,0,312,2366,2670,304,0
31711ref2,5685,6263,JUNC00000096,2,-,5685,6263,255;0;0,2,145,132,0,446,5830,6131,301,0
31711ref2,972,1453,JUNC00000018,17,+,972,1453,255;0;0,2,43,145,0,336,1015,1308,293,0
31711ref2,7727,8311,JUNC00000119,119,-,7727,8311,255;0;0,2,148,150,0,434,7875,8161,286,0
31711ref2,1171,1603,JUNC00000028,1,+,1171,1603,255;0;0,2,113,38,0,394,1284,1565,281,0
31711ref2,1544,2031,JUNC00000038,47,+,1544,2031,255;0;0,2,99,108,0,379,1643,1923,280,0
31711ref2,2698,3110,JUNC00000067,59,+,2698,3110,255;0;0,2,150,8,0,404,2848,3102,254,0
31711ref2,9876,10238,JUNC00000150,1,+,9876,10238,255;0;0,2,24,86,0,276,9900,10152,252,0
31711ref2,738,1133,JUNC00000013,26,+,738,1133,255;0;0,2,26,118,0,277,764,1015,251,0
31711ref2,4765,5235,JUNC00000093,3,-,4765,5235,255;0;0,2,98,148,0,322,4863,5087,224,0
31711ref2,8006,8517,JUNC00000124,25,+,8006,8517,255;0;0,2,150,142,0,369,8156,8375,219,0
31711ref2,7686,8194,JUNC00000116,11,+,7686,8194,255;0;0,2,146,147,0,361,7832,8047,215,0
31711ref2,2686,3175,JUNC00000066,2,+,2686,3175,255;0;0,2,144,143,0,346,2830,3032,202,0
31711ref2,460,807,JUNC00000003,1,+,460,807,255;0;0,2,74,77,0,270,534,730,196,0
31711ref2,607,1088,JUNC00000012,6,-,607,1088,255;0;0,2,150,148,0,333,757,940,183,0
31711ref2,624,1099,JUNC00000014,60,-,624,1099,255;0;0,2,146,146,0,329,770,953,183,0
31711ref2,78,411,JUNC00000001,1,+,78,411,255;0;0,2,39,112,0,221,117,299,182,0
31711ref2,756,1084,JUNC00000015,1,+,756,1084,255;0;0,2,122,29,0,299,878,1055,177,0
31711ref2,2228,2630,JUNC00000050,3969,+,2228,2630,255;0;0,2,99,129,0,273,2327,2501,174,0
31711ref2,7554,8003,JUNC00000115,7,+,7554,8003,255;0;0,2,145,136,0,313,7699,7867,168,0
31711ref2,4133,4449,JUNC00000077,1,+,4133,4449,255;0;0,2,25,126,0,190,4158,4323,165,0
31711ref2,4878,5296,JUNC00000094,18,+,4878,5296,255;0;0,2,105,149,0,269,4983,5147,164,0
31711ref2,2503,2857,JUNC00000062,10,+,2503,2857,255;0;0,2,149,43,0,311,2652,2814,162,0
31711ref2,8870,9233,JUNC00000133,3283,+,8870,9233,255;0;0,2,51,150,0,213,8921,9083,162,0
31711ref2,8896,9279,JUNC00000137,2,+,8896,9279,255;0;0,2,74,149,0,234,8970,9130,160,0
31711ref2,595,960,JUNC00000009,35,+,595,960,255;0;0,2,61,148,0,217,656,812,156,0
31711ref2,9312,9680,JUNC00000147,137,+,9312,9680,255;0;0,2,66,150,0,218,9378,9530,152,0
31711ref2,510,762,JUNC00000004,6,-,510,762,255;0;0,2,28,86,0,166,538,676,138,0
31711ref2,2343,2779,JUNC00000055,9,+,2343,2779,255;0;0,2,148,150,0,286,2491,2629,138,0
31711ref2,1263,1606,JUNC00000033,35,+,1263,1606,255;0;0,2,148,58,0,285,1411,1548,137,0
31711ref2,8367,8804,JUNC00000129,1632,+,8367,8804,255;0;0,2,150,150,0,287,8517,8654,137,0
31711ref2,9581,9868,JUNC00000148,2,-,9581,9868,255;0;0,2,107,44,0,243,9688,9824,136,0
31711ref2,4395,4793,JUNC00000083,17,-,4395,4793,255;0;0,2,144,119,0,279,4539,4674,135,0
31711ref2,7450,7735,JUNC00000106,1,-,7450,7735,255;0;0,2,10,141,0,144,7460,7594,134,0
31711ref2,4086,4389,JUNC00000075,2,-,4086,4389,255;0;0,2,21,149,0,154,4107,4240,133,0
31711ref2,1124,1436,JUNC00000026,12,+,1124,1436,255;0;0,2,146,34,0,278,1270,1402,132,0
31711ref2,1709,1989,JUNC00000044,1,-,1709,1989,255;0;0,2,117,34,0,246,1826,1955,129,0
31711ref2,1948,2234,JUNC00000048,541,+,1948,2234,255;0;0,2,86,84,0,202,2034,2150,116,0
31711ref2,4274,4563,JUNC00000080,32,+,4274,4563,255;0;0,2,49,128,0,161,4323,4435,112,0
31711ref2,6972,7368,JUNC00000103,5,+,6972,7368,255;0;0,2,143,147,0,249,7115,7221,106,0
31711ref2,7798,8052,JUNC00000121,6,+,7798,8052,255;0;0,2,144,8,0,246,7942,8044,102,0
31711ref2,1346,1647,JUNC00000035,2,+,1346,1647,255;0;0,2,119,82,0,219,1465,1565,100,0
31711ref2,9021,9275,JUNC00000139,87,+,9021,9275,255;0;0,2,9,145,0,109,9030,9130,100,0
31711ref2,4242,4496,JUNC00000078,2,-,4242,4496,255;0;0,2,8,147,0,107,4250,4349,99,0
31711ref2,1357,1710,JUNC00000036,2,+,1357,1710,255;0;0,2,114,145,0,208,1471,1565,94,0
31711ref2,4032,4272,JUNC00000076,1,-,4032,4272,255;0;0,2,101,50,0,190,4133,4222,89,0
31711ref2,8817,9199,JUNC00000135,4,-,8817,9199,255;0;0,2,148,145,0,237,8965,9054,89,0
31711ref2,1261,1642,JUNC00000032,137,+,1261,1642,255;0;0,2,150,143,0,238,1411,1499,88,0
31711ref2,1683,2007,JUNC00000043,5,-,1683,2007,255;0;0,2,143,95,0,229,1826,1912,86,0
31711ref2,7783,8156,JUNC00000120,27,+,7783,8156,255;0;0,2,139,149,0,224,7922,8007,85,0
31711ref2,1362,1608,JUNC00000034,2,+,1362,1608,255;0;0,2,103,60,0,186,1465,1548,83,0
31711ref2,8775,9137,JUNC00000132,7,+,8775,9137,255;0;0,2,140,140,0,222,8915,8997,82,0
31711ref2,1674,1971,JUNC00000039,4,-,1674,1971,255;0;0,2,77,145,0,152,1751,1826,75,0
31711ref2,621,846,JUNC00000008,1,+,621,846,255;0;0,2,35,116,0,109,656,730,74,0
31711ref2,664,889,JUNC00000011,1,+,664,889,255;0;0,2,74,77,0,148,738,812,74,0
31711ref2,8955,9326,JUNC00000141,20,+,8955,9326,255;0;0,2,149,148,0,223,9104,9178,74,0
31711ref2,1444,1665,JUNC00000037,1,+,1444,1665,255;0;0,2,104,47,0,174,1548,1618,70,0
31711ref2,1779,2027,JUNC00000041,2,-,1779,2027,255;0;0,2,36,142,0,106,1815,1885,70,0
31711ref2,9116,9326,JUNC00000145,2,+,9116,9326,255;0;0,2,98,42,0,168,9214,9284,70,0
31711ref2,1678,1897,JUNC00000040,1,-,1678,1897,255;0;0,2,91,59,0,160,1769,1838,69,0
31711ref2,2887,3110,JUNC00000069,2,+,2887,3110,255;0;0,2,146,8,0,215,3033,3102,69,0
31711ref2,1723,1942,JUNC00000045,1,+,1723,1942,255;0;0,2,127,24,0,195,1850,1918,68,0
31711ref2,8290,8650,JUNC00000127,556,+,8290,8650,255;0;0,2,148,144,0,216,8438,8506,68,0
31711ref2,7362,7595,JUNC00000109,225,-,7362,7595,255;0;0,2,149,17,0,216,7511,7578,67,0
31711ref2,7401,7707,JUNC00000107,13,+,7401,7707,255;0;0,2,93,147,0,159,7494,7560,66,0
31711ref2,440,680,JUNC00000002,14,+,440,680,255;0;0,2,31,146,0,94,471,534,63,0
31711ref2,1220,1441,JUNC00000029,83,-,1220,1441,255;0;0,2,147,11,0,210,1367,1430,63,0
31711ref2,8290,8569,JUNC00000126,568,+,8290,8569,255;0;0,2,148,68,0,211,8438,8501,63,0
31711ref2,507,758,JUNC00000006,6,-,507,758,255;0;0,2,51,139,0,112,558,619,61,0
31711ref2,2941,3153,JUNC00000070,1,+,2941,3153,255;0;0,2,106,45,0,167,3047,3108,61,0
31711ref2,4360,4695,JUNC00000082,15,-,4360,4695,255;0;0,2,137,140,0,195,4497,4555,58,0
31711ref2,8375,8584,JUNC00000128,2,+,8375,8584,255;0;0,2,113,38,0,171,8488,8546,58,0
31711ref2,955,1307,JUNC00000019,1165,-,955,1307,255;0;0,2,146,149,0,203,1101,1158,57,0
31711ref2,5997,6231,JUNC00000100,3,-,5997,6231,255;0;0,2,147,33,0,201,6144,6198,54,0
31711ref2,8940,9145,JUNC00000140,1,-,8940,9145,255;0;0,2,138,13,0,192,9078,9132,54,0
31711ref2,825,1169,JUNC00000017,37,+,825,1169,255;0;0,2,144,147,0,197,969,1022,53,0
31711ref2,9021,9228,JUNC00000138,197,+,9021,9228,255;0;0,2,9,145,0,62,9030,9083,53,0
31711ref2,1806,2061,JUNC00000046,4,-,1806,2061,255;0;0,2,54,149,0,106,1860,1912,52,0
31711ref2,7742,7965,JUNC00000118,32,-,7742,7965,255;0;0,2,124,49,0,174,7866,7916,50,0
31711ref2,9698,9967,JUNC00000149,2,+,9698,9967,255;0;0,2,77,144,0,125,9775,9823,48,0
31711ref2,7437,7617,JUNC00000108,1,-,7437,7617,255;0;0,2,74,61,0,119,7511,7556,45,0
31711ref2,2807,3145,JUNC00000068,52,+,2807,3145,255;0;0,2,149,149,0,189,2956,2996,40,0
31711ref2,5927,6138,JUNC00000097,2,-,5927,6138,255;0;0,2,26,145,0,66,5953,5993,40,0
31711ref2,7512,7744,JUNC00000113,2,+,7512,7744,255;0;0,2,148,45,0,187,7660,7699,39,0
31711ref2,2238,2572,JUNC00000052,8,-,2238,2572,255;0;0,2,150,148,0,186,2388,2424,36,0
31711ref2,7515,7756,JUNC00000112,8,+,7515,7756,255;0;0,2,145,60,0,181,7660,7696,36,0
31711ref2,1850,2034,JUNC00000047,29,+,1850,2034,255;0;0,2,139,12,0,172,1989,2022,33,0
31711ref2,2919,3132,JUNC00000072,5,-,2919,3132,255;0;0,2,146,35,0,178,3065,3097,32,0
31711ref2,7708,8035,JUNC00000117,16,+,7708,8035,255;0;0,2,149,147,0,180,7857,7888,31,0
31711ref2,6105,6294,JUNC00000102,3,+,6105,6294,255;0;0,2,150,10,0,179,6255,6284,29,0
31711ref2,7869,8053,JUNC00000122,5,+,7869,8053,255;0;0,2,146,9,0,175,8015,8044,29,0
31711ref2,2539,2718,JUNC00000057,1,+,2539,2718,255;0;0,2,8,143,0,36,2547,2575,28,0
31711ref2,2432,2625,JUNC00000059,2,+,2432,2625,255;0;0,2,148,17,0,176,2580,2608,28,0
31711ref2,4231,4492,JUNC00000081,17,+,4231,4492,255;0;0,2,149,84,0,177,4380,4408,28,0
31711ref2,10040,10236,JUNC00000151,2,+,10040,10236,255;0;0,2,124,44,0,152,10164,10192,28,0
31711ref2,3223,3434,JUNC00000074,1138,-,3223,3434,255;0;0,2,34,150,0,61,3257,3284,27,0
31711ref2,8413,8732,JUNC00000130,7,-,8413,8732,255;0;0,2,147,147,0,172,8560,8585,25,0
31711ref2,974,1286,JUNC00000020,5,+,974,1286,255;0;0,2,142,147,0,165,1116,1139,23,0
31711ref2,2963,3109,JUNC00000071,2,-,2963,3109,255;0;0,2,102,22,0,124,3065,3087,22,0
31711ref2,977,1291,JUNC00000022,394,+,977,1291,255;0;0,2,150,144,0,170,1127,1147,20,0
31711ref2,5004,5221,JUNC00000095,4,+,5004,5221,255;0;0,2,147,50,0,167,5151,5171,20,0
31711ref2,4707,4899,JUNC00000091,3,+,4707,4899,255;0;0,2,58,116,0,76,4765,4783,18,0
31711ref2,7964,8278,JUNC00000123,21,-,7964,8278,255;0;0,2,148,149,0,165,8112,8129,17,0
31711ref2,5951,6215,JUNC00000098,265,+,5951,6215,255;0;0,2,99,149,0,115,6050,6066,16,0
31711ref2,1244,1558,JUNC00000031,15,+,1244,1558,255;0;0,2,149,150,0,164,1393,1408,15,0
31711ref2,2593,2779,JUNC00000060,5,+,2593,2779,255;0;0,2,21,150,0,36,2614,2629,15,0
31711ref2,8989,9298,JUNC00000142,6,+,8989,9298,255;0;0,2,147,147,0,162,9136,9151,15,0
31711ref2,2366,2610,JUNC00000056,4,+,2366,2610,255;0;0,2,147,83,0,161,2513,2527,14,0
31711ref2,4130,4418,JUNC00000079,16,+,4130,4418,255;0;0,2,127,147,0,141,4257,4271,14,0
31711ref2,2445,2609,JUNC00000058,1,+,2445,2609,255;0;0,2,120,31,0,133,2565,2578,13,0
31711ref2,6967,7279,JUNC00000104,11,+,6967,7279,255;0;0,2,150,150,0,162,7117,7129,12,0
31711ref2,2111,2297,JUNC00000049,4,+,2111,2297,255;0;0,2,25,150,0,36,2136,2147,11,0
31711ref2,6063,6224,JUNC00000101,1,-,6063,6224,255;0;0,2,143,8,0,153,6206,6216,10,0
31711ref2,978,1163,JUNC00000023,516,-,978,1163,255;0;0,2,150,26,0,159,1128,1137,9,0
31711ref2,1240,1544,JUNC00000030,6,-,1240,1544,255;0;0,2,146,149,0,155,1386,1395,9,0
31711ref2,9030,9198,JUNC00000143,6,+,9030,9198,255;0;0,2,149,10,0,158,9179,9188,9,0
31711ref2,457,608,JUNC00000005,2,-,457,608,255;0;0,2,86,57,0,94,543,551,8,0
31711ref2,1001,1225,JUNC00000025,750,-,1001,1225,255;0;0,2,149,67,0,157,1150,1158,8,0
31711ref2,824,1126,JUNC00000016,734,+,824,1126,255;0;0,2,145,150,0,152,969,976,7,0
31711ref2,7540,7845,JUNC00000114,4,+,7540,7845,255;0;0,2,149,149,0,156,7689,7696,7,0
31711ref2,8283,8586,JUNC00000125,25,+,8283,8586,255;0;0,2,148,148,0,155,8431,8438,7,0
31711ref2,8928,9127,JUNC00000136,10,+,8928,9127,255;0;0,2,42,150,0,49,8970,8977,7,0
31711ref2,973,1270,JUNC00000021,30,+,973,1270,255;0;0,2,149,142,0,155,1122,1128,6,0
31711ref2,1000,1301,JUNC00000024,2,-,1000,1301,255;0;0,2,150,146,0,155,1150,1155,5,0
31711ref2,1809,1977,JUNC00000042,2,-,1809,1977,255;0;0,2,17,146,0,22,1826,1831,5,0
31711ref2,7447,7596,JUNC00000110,4,-,7447,7596,255;0;0,2,126,18,0,131,7573,7578,5,0
31711ref2,8802,9078,JUNC00000134,44748,+,8802,9078,255;0;0,2,121,150,0,126,8923,8928,5,0
18279ref2,200,431,JUNC00000001,2,-,200,431,255;0;0,2,31,47,0,184,231,384,153,0
18279ref2,256,429,JUNC00000002,6,-,256,429,255;0;0,2,8,148,0,25,264,281,17,0
18279ref2,501,7946,JUNC00000003,117,-,501,7946,255;0;0,2,57,140,0,7305,558,7806,7248,0
18279ref2,631,877,JUNC00000004,32,+,631,877,255;0;0,2,25,147,0,99,656,730,74,0
18279ref2,632,1133,JUNC00000005,21,+,632,1133,255;0;0,2,24,118,0,383,656,1015,359,0
18279ref2,609,1163,JUNC00000006,27,+,609,1163,255;0;0,2,65,148,0,406,674,1015,341,0
18279ref2,723,1030,JUNC00000007,60,-,723,1030,255;0;0,2,9,148,0,159,732,882,150,0
18279ref2,731,870,JUNC00000008,112,+,731,870,255;0;0,2,33,77,0,62,764,793,29,0
18279ref2,705,1021,JUNC00000009,2,+,705,1021,255;0;0,2,121,143,0,173,826,878,52,0
18279ref2,702,1040,JUNC00000010,7,+,702,1040,255;0;0,2,147,150,0,188,849,890,41,0
18279ref2,713,5336,JUNC00000011,2019,-,713,5336,255;0;0,2,147,150,0,4473,860,5186,4326,0
18279ref2,835,1845,JUNC00000012,1,-,835,1845,255;0;0,2,30,121,0,889,865,1724,859,0
18279ref2,823,1125,JUNC00000013,36,+,823,1125,255;0;0,2,146,149,0,153,969,976,7,0
18279ref2,825,1172,JUNC00000014,13,+,825,1172,255;0;0,2,144,150,0,197,969,1022,53,0
18279ref2,925,6591,JUNC00000015,2,+,925,6591,255;0;0,2,44,107,0,5559,969,6484,5515,0
18279ref2,982,1295,JUNC00000016,7,-,982,1295,255;0;0,2,25,150,0,163,1007,1145,138,0
18279ref2,955,1300,JUNC00000017,1043,-,955,1300,255;0;0,2,146,142,0,203,1101,1158,57,0
18279ref2,974,1274,JUNC00000018,5,+,974,1274,255;0;0,2,148,146,0,154,1122,1128,6,0
18279ref2,980,1141,JUNC00000019,33,-,980,1141,255;0;0,2,148,8,0,153,1128,1133,5,0
18279ref2,1000,1300,JUNC00000020,2,-,1000,1300,255;0;0,2,150,145,0,155,1150,1155,5,0
18279ref2,1002,1303,JUNC00000021,91,-,1002,1303,255;0;0,2,148,145,0,156,1150,1158,8,0
18279ref2,1124,1527,JUNC00000022,925,+,1124,1527,255;0;0,2,146,150,0,253,1270,1377,107,0
18279ref2,1243,1558,JUNC00000023,203,+,1243,1558,255;0;0,2,150,150,0,165,1393,1408,15,0
18279ref2,1607,1974,JUNC00000024,75,-,1607,1974,255;0;0,2,144,148,0,219,1751,1826,75,0
18279ref2,1777,1950,JUNC00000025,3,+,1777,1950,255;0;0,2,73,32,0,141,1850,1918,68,0
18279ref2,2162,2474,JUNC00000026,209,+,2162,2474,255;0;0,2,129,147,0,165,2291,2327,36,0
18279ref2,2238,2556,JUNC00000027,35,+,2238,2556,255;0;0,2,150,149,0,169,2388,2407,19,0
18279ref2,2238,2572,JUNC00000028,108,-,2238,2572,255;0;0,2,150,148,0,186,2388,2424,36,0
18279ref2,2390,2638,JUNC00000029,3,+,2390,2638,255;0;0,2,8,148,0,100,2398,2490,92,0
18279ref2,2301,2650,JUNC00000030,103,+,2301,2650,255;0;0,2,108,149,0,200,2409,2501,92,0
18279ref2,2410,2571,JUNC00000031,11,+,2410,2571,255;0;0,2,8,145,0,16,2418,2426,8,0
18279ref2,2342,2779,JUNC00000032,2,+,2342,2779,255;0;0,2,149,150,0,287,2491,2629,138,0
18279ref2,2497,2750,JUNC00000033,23,+,2497,2750,255;0;0,2,68,144,0,109,2565,2606,41,0
18279ref2,2437,2748,JUNC00000034,7,+,2437,2748,255;0;0,2,147,149,0,162,2584,2599,15,0
18279ref2,2449,2763,JUNC00000035,15,+,2449,2763,255;0;0,2,149,150,0,164,2598,2613,15,0
18279ref2,2470,2785,JUNC00000036,10,+,2470,2785,255;0;0,2,149,149,0,166,2619,2636,17,0
18279ref2,2505,3005,JUNC00000037,91,+,2505,3005,255;0;0,2,147,147,0,353,2652,2858,206,0
18279ref2,2661,2989,JUNC00000038,124,+,2661,2989,255;0;0,2,145,149,0,179,2806,2840,34,0
18279ref2,2668,2981,JUNC00000039,118,-,2668,2981,255;0;0,2,148,149,0,164,2816,2832,16,0
18279ref2,2822,2991,JUNC00000040,56,+,2822,2991,255;0;0,2,8,149,0,20,2830,2842,12,0
18279ref2,2792,3019,JUNC00000041,1,-,2792,3019,255;0;0,2,56,70,0,157,2848,2949,101,0
18279ref2,2835,3149,JUNC00000042,15,-,2835,3149,255;0;0,2,42,150,0,164,2877,2999,122,0
18279ref2,2818,8072,JUNC00000043,2331,+,2818,8072,255;0;0,2,101,150,0,5104,2919,7922,5003,0
18279ref2,2782,3140,JUNC00000044,14,+,2782,3140,255;0;0,2,148,146,0,212,2930,2994,64,0
18279ref2,2971,3193,JUNC00000045,2,+,2971,3193,255;0;0,2,60,91,0,131,3031,3102,71,0
18279ref2,2939,3364,JUNC00000046,4,-,2939,3364,255;0;0,2,147,149,0,276,3086,3215,129,0
18279ref2,3009,3358,JUNC00000047,2,+,3009,3358,255;0;0,2,148,150,0,199,3157,3208,51,0
18279ref2,3023,3340,JUNC00000048,40,+,3023,3340,255;0;0,2,150,149,0,168,3173,3191,18,0
18279ref2,3227,3434,JUNC00000049,24,-,3227,3434,255;0;0,2,30,150,0,57,3257,3284,27,0
18279ref2,3549,3917,JUNC00000050,537,-,3549,3917,255;0;0,2,150,150,0,218,3699,3767,68,0
18279ref2,3641,3980,JUNC00000051,90,+,3641,3980,255;0;0,2,145,149,0,190,3786,3831,45,0
18279ref2,3923,4141,JUNC00000052,11,+,3923,4141,255;0;0,2,23,150,0,68,3946,3991,45,0
18279ref2,3869,4211,JUNC00000053,45,-,3869,4211,255;0;0,2,148,150,0,192,4017,4061,44,0
18279ref2,3960,4326,JUNC00000054,21,-,3960,4326,255;0;0,2,149,150,0,216,4109,4176,67,0
18279ref2,3971,4280,JUNC00000055,159,+,3971,4280,255;0;0,2,149,150,0,159,4120,4130,10,0
18279ref2,4282,4459,JUNC00000056,25,+,4282,4459,255;0;0,2,23,149,0,28,4305,4310,5,0
18279ref2,4336,4560,JUNC00000057,48,+,4336,4560,255;0;0,2,26,148,0,76,4362,4412,50,0
18279ref2,4225,4426,JUNC00000058,16,+,4225,4426,255;0;0,2,150,21,0,180,4375,4405,30,0
18279ref2,4439,4696,JUNC00000059,155,-,4439,4696,255;0;0,2,58,141,0,116,4497,4555,58,0
18279ref2,4357,4728,JUNC00000060,3,-,4357,4728,255;0;0,2,149,118,0,253,4506,4610,104,0
18279ref2,4381,4702,JUNC00000061,5,+,4381,4702,255;0;0,2,148,38,0,283,4529,4664,135,0
18279ref2,4397,4769,JUNC00000062,4,-,4397,4769,255;0;0,2,142,95,0,277,4539,4674,135,0
18279ref2,4412,4716,JUNC00000063,13,+,4412,4716,255;0;0,2,145,150,0,154,4557,4566,9,0
18279ref2,4680,5073,JUNC00000064,411,+,4680,5073,255;0;0,2,129,146,0,247,4809,4927,118,0
18279ref2,5450,5781,JUNC00000065,23,-,5450,5781,255;0;0,2,150,148,0,183,5600,5633,33,0
18279ref2,5749,5938,JUNC00000066,159,+,5749,5938,255;0;0,2,26,147,0,42,5775,5791,16,0
18279ref2,5756,6054,JUNC00000067,3,+,5756,6054,255;0;0,2,94,145,0,153,5850,5909,59,0
18279ref2,5805,6141,JUNC00000068,2,-,5805,6141,255;0;0,2,148,148,0,188,5953,5993,40,0
18279ref2,5808,6142,JUNC00000069,3,-,5808,6142,255;0;0,2,147,149,0,185,5955,5993,38,0
18279ref2,5825,6162,JUNC00000070,14,-,5825,6162,255;0;0,2,147,150,0,187,5972,6012,40,0
18279ref2,5834,6159,JUNC00000071,13,-,5834,6159,255;0;0,2,147,150,0,175,5981,6009,28,0
18279ref2,6411,6523,JUNC00000072,2,+,6411,6523,255;0;0,2,73,32,0,80,6484,6491,7,0
18279ref2,6711,6890,JUNC00000073,33,+,6711,6890,255;0;0,2,9,148,0,31,6720,6742,22,0
18279ref2,6638,6980,JUNC00000074,3,-,6638,6980,255;0;0,2,148,147,0,195,6786,6833,47,0
18279ref2,6883,7046,JUNC00000075,46,-,6883,7046,255;0;0,2,9,143,0,20,6892,6903,11,0
18279ref2,6745,7107,JUNC00000076,169,-,6745,7107,255;0;0,2,147,145,0,217,6892,6962,70,0
18279ref2,6963,7191,JUNC00000077,100,+,6963,7191,255;0;0,2,63,148,0,80,7026,7043,17,0
18279ref2,6895,7164,JUNC00000078,7,+,6895,7164,255;0;0,2,149,98,0,171,7044,7066,22,0
18279ref2,6968,7262,JUNC00000079,129,+,6968,7262,255;0;0,2,147,67,0,227,7115,7195,80,0
18279ref2,7277,7480,JUNC00000080,77,-,7277,7480,255;0;0,2,10,147,0,56,7287,7333,46,0
18279ref2,7321,7506,JUNC00000081,5,-,7321,7506,255;0;0,2,22,150,0,35,7343,7356,13,0
18279ref2,7247,7578,JUNC00000082,9,+,7247,7578,255;0;0,2,147,145,0,186,7394,7433,39,0
18279ref2,7393,7764,JUNC00000083,14,-,7393,7764,255;0;0,2,34,150,0,221,7427,7614,187,0
18279ref2,7289,7772,JUNC00000084,29,-,7289,7772,255;0;0,2,147,149,0,334,7436,7623,187,0
18279ref2,7381,7701,JUNC00000085,5,-,7381,7701,255;0;0,2,149,150,0,170,7530,7551,21,0
18279ref2,7440,7628,JUNC00000086,10,-,7440,7628,255;0;0,2,133,50,0,138,7573,7578,5,0
18279ref2,7512,7767,JUNC00000087,35,+,7512,7767,255;0;0,2,148,56,0,199,7660,7711,51,0
18279ref2,7525,7839,JUNC00000088,11,+,7525,7839,255;0;0,2,149,149,0,165,7674,7690,16,0
18279ref2,7539,7844,JUNC00000089,2,+,7539,7844,255;0;0,2,150,148,0,157,7689,7696,7,0
18279ref2,7551,7918,JUNC00000090,23,+,7551,7918,255;0;0,2,148,146,0,221,7699,7772,73,0
18279ref2,7797,7973,JUNC00000091,51,-,7797,7973,255;0;0,2,9,146,0,30,7806,7827,21,0
18279ref2,7694,8035,JUNC00000092,39,+,7694,8035,255;0;0,2,146,150,0,191,7840,7885,45,0
18279ref2,7717,7916,JUNC00000093,14,+,7717,7916,255;0;0,2,149,43,0,156,7866,7873,7,0
18279ref2,7723,8066,JUNC00000094,52,-,7723,8066,255;0;0,2,143,150,0,193,7866,7916,50,0
18279ref2,7909,8143,JUNC00000095,4,+,7909,8143,255;0;0,2,15,149,0,85,7924,7994,70,0
18279ref2,7962,8276,JUNC00000096,825,-,7962,8276,255;0;0,2,150,147,0,167,8112,8129,17,0
18279ref2,8772,9099,JUNC00000097,33,+,8772,9099,255;0;0,2,149,150,0,177,8921,8949,28,0
18279ref2,8773,9078,JUNC00000098,1788,+,8773,9078,255;0;0,2,150,150,0,155,8923,8928,5,0
18279ref2,9054,9253,JUNC00000099,2,-,9054,9253,255;0;0,2,24,121,0,78,9078,9132,54,0
18279ref2,8963,9378,JUNC00000100,42,-,8963,9378,255;0;0,2,148,144,0,271,9111,9234,123,0
18279ref2,9360,9677,JUNC00000101,2,+,9360,9677,255;0;0,2,18,147,0,170,9378,9530,152,0
18279ref2,9803,10109,JUNC00000102,35,-,9803,10109,255;0;0,2,150,150,0,156,9953,9959,6,0
18279ref2,10051,10264,JUNC00000103,1,+,10051,10264,255;0;0,2,141,10,0,203,10192,10254,62,0
18279ref2,10137,10327,JUNC00000104,105,+,10137,10327,255;0;0,2,149,34,0,156,10286,10293,7,0
16351ref2,625,7709,JUNC00000015,28,+,625,7709,255;0;0,2,148,149,0,6935,773,7560,6787,0
16351ref2,2498,9418,JUNC00000058,779,+,2498,9418,255;0;0,2,80,150,0,6770,2578,9268,6690,0
16351ref2,2238,9091,JUNC00000048,75,+,2238,9091,255;0;0,2,150,149,0,6704,2388,8942,6554,0
16351ref2,1166,7828,JUNC00000031,3,-,1166,7828,255;0;0,2,8,143,0,6519,1174,7685,6511,0
16351ref2,1081,7700,JUNC00000032,13,+,1081,7700,255;0;0,2,140,149,0,6470,1221,7551,6330,0
16351ref2,2417,8824,JUNC00000057,1314,+,2417,8824,255;0;0,2,148,150,0,6257,2565,8674,6109,0
16351ref2,2786,8016,JUNC00000070,527,+,2786,8016,255;0;0,2,133,94,0,5136,2919,7922,5003,0
16351ref2,1846,7027,JUNC00000042,11,-,1846,7027,255;0;0,2,149,149,0,5032,1995,6878,4883,0
16351ref2,518,5576,JUNC00000006,54,+,518,5576,255;0;0,2,149,150,0,4908,667,5426,4759,0
16351ref2,4103,9065,JUNC00000096,28,-,4103,9065,255;0;0,2,145,148,0,4814,4248,8917,4669,0
16351ref2,4782,9158,JUNC00000105,10,-,4782,9158,255;0;0,2,43,147,0,4229,4825,9011,4186,0
16351ref2,3926,7979,JUNC00000090,34,+,3926,7979,255;0;0,2,149,106,0,3947,4075,7873,3798,0
16351ref2,3930,8025,JUNC00000091,38,-,3930,8025,255;0;0,2,147,150,0,3945,4077,7875,3798,0
16351ref2,603,4647,JUNC00000013,1585,+,603,4647,255;0;0,2,127,150,0,3894,730,4497,3767,0
16351ref2,3801,7712,JUNC00000085,3,+,3801,7712,255;0;0,2,150,147,0,3764,3951,7565,3614,0
16351ref2,1873,5539,JUNC00000043,74,+,1873,5539,255;0;0,2,150,150,0,3516,2023,5389,3366,0
16351ref2,4984,8531,JUNC00000108,104,-,4984,8531,255;0;0,2,146,148,0,3399,5130,8383,3253,0
16351ref2,2629,6088,JUNC00000065,389,+,2629,6088,255;0;0,2,142,145,0,3314,2771,5943,3172,0
16351ref2,5140,8095,JUNC00000111,5,-,5140,8095,255;0;0,2,117,62,0,2893,5257,8033,2776,0
16351ref2,3958,6783,JUNC00000092,11,-,3958,6783,255;0;0,2,149,25,0,2800,4107,6758,2651,0
16351ref2,3960,6910,JUNC00000093,41,-,3960,6910,255;0;0,2,149,150,0,2800,4109,6760,2651,0
16351ref2,5708,7703,JUNC00000116,1,+,5708,7703,255;0;0,2,40,111,0,1884,5748,7592,1844,0
16351ref2,5413,7042,JUNC00000112,1048,+,5413,7042,255;0;0,2,150,130,0,1499,5563,6912,1349,0
16351ref2,9093,10164,JUNC00000171,8,+,9093,10164,255;0;0,2,144,22,0,1049,9237,10142,905,0
16351ref2,8289,9315,JUNC00000161,379,+,8289,9315,255;0;0,2,149,144,0,882,8438,9171,733,0
16351ref2,6926,7641,JUNC00000129,296,+,6926,7641,255;0;0,2,147,147,0,568,7073,7494,421,0
16351ref2,7213,7734,JUNC00000131,39,+,7213,7734,255;0;0,2,8,144,0,377,7221,7590,369,0
16351ref2,588,1138,JUNC00000004,20,+,588,1138,255;0;0,2,68,123,0,427,656,1015,359,0
16351ref2,551,1138,JUNC00000010,20,+,551,1138,255;0;0,2,123,123,0,464,674,1015,341,0
16351ref2,5751,6282,JUNC00000118,5,-,5751,6282,255;0;0,2,150,46,0,485,5901,6236,335,0
16351ref2,449,1066,JUNC00000003,17,-,449,1066,255;0;0,2,149,149,0,468,598,917,319,0
16351ref2,7121,7641,JUNC00000130,53,+,7121,7641,255;0;0,2,64,147,0,373,7185,7494,309,0
16351ref2,878,1453,JUNC00000022,31,+,878,1453,255;0;0,2,137,145,0,430,1015,1308,293,0
16351ref2,5863,6252,JUNC00000122,2,+,5863,6252,255;0;0,2,149,21,0,368,6012,6231,219,0
16351ref2,8813,9277,JUNC00000164,44,+,8813,9277,255;0;0,2,102,145,0,319,8915,9132,217,0
16351ref2,7228,7648,JUNC00000133,41,+,7228,7648,255;0;0,2,146,65,0,355,7374,7583,209,0
16351ref2,9744,10175,JUNC00000177,3,+,9744,10175,255;0;0,2,150,76,0,355,9894,10099,205,0
16351ref2,8770,9101,JUNC00000163,1,+,8770,9101,255;0;0,2,74,77,0,254,8844,9024,180,0
16351ref2,7551,8007,JUNC00000144,6,+,7551,8007,255;0;0,2,148,134,0,322,7699,7873,174,0
16351ref2,7553,7922,JUNC00000143,9,+,7553,7922,255;0;0,2,146,55,0,314,7699,7867,168,0
16351ref2,2507,2861,JUNC00000063,16,+,2507,2861,255;0;0,2,145,47,0,307,2652,2814,162,0
16351ref2,5584,6041,JUNC00000115,28,+,5584,6041,255;0;0,2,149,150,0,307,5733,5891,158,0
16351ref2,3775,4190,JUNC00000083,17,+,3775,4190,255;0;0,2,127,148,0,267,3902,4042,140,0
16351ref2,1264,1696,JUNC00000037,181,+,1264,1696,255;0;0,2,147,148,0,284,1411,1548,137,0
16351ref2,4427,4773,JUNC00000102,2,-,4427,4773,255;0;0,2,112,99,0,247,4539,4674,135,0
16351ref2,8903,9102,JUNC00000166,9,+,8903,9102,255;0;0,2,67,8,0,191,8970,9094,124,0
16351ref2,7435,7806,JUNC00000136,2,+,7435,7806,255;0;0,2,141,107,0,264,7576,7699,123,0
16351ref2,2344,2763,JUNC00000054,10,+,2344,2763,255;0;0,2,149,150,0,269,2493,2613,120,0
16351ref2,2373,2662,JUNC00000049,13,+,2373,2662,255;0;0,2,25,150,0,139,2398,2512,114,0
16351ref2,4702,5073,JUNC00000104,35,+,4702,5073,255;0;0,2,113,146,0,225,4815,4927,112,0
16351ref2,746,1078,JUNC00000016,79,+,746,1078,255;0;0,2,80,143,0,189,826,935,109,0
16351ref2,3499,3884,JUNC00000078,11,+,3499,3884,255;0;0,2,132,150,0,235,3631,3734,103,0
16351ref2,6628,7030,JUNC00000127,13,-,6628,7030,255;0;0,2,150,149,0,253,6778,6881,103,0
16351ref2,7551,7949,JUNC00000142,48,+,7551,7949,255;0;0,2,148,148,0,250,7699,7801,102,0
16351ref2,8136,8530,JUNC00000159,1396,+,8136,8530,255;0;0,2,150,149,0,245,8286,8381,95,0
16351ref2,486,806,JUNC00000002,37,-,486,806,255;0;0,2,83,148,0,172,569,658,89,0
16351ref2,1741,2062,JUNC00000040,601,-,1741,2062,255;0;0,2,85,150,0,171,1826,1912,86,0
16351ref2,5826,6131,JUNC00000120,3,-,5826,6131,255;0;0,2,146,73,0,232,5972,6058,86,0
16351ref2,7801,8154,JUNC00000154,20,+,7801,8154,255;0;0,2,121,147,0,206,7922,8007,85,0
16351ref2,5005,5383,JUNC00000110,264,+,5005,5383,255;0;0,2,149,150,0,228,5154,5233,79,0
16351ref2,2941,3187,JUNC00000071,14,-,2941,3187,255;0;0,2,19,150,0,96,2960,3037,77,0
16351ref2,2537,2908,JUNC00000064,30,+,2537,2908,255;0;0,2,148,148,0,223,2685,2760,75,0
16351ref2,2434,2801,JUNC00000060,61,+,2434,2801,255;0;0,2,146,149,0,218,2580,2652,72,0
16351ref2,9022,9239,JUNC00000168,19,+,9022,9239,255;0;0,2,60,91,0,126,9082,9148,66,0
16351ref2,6486,6845,JUNC00000125,4,-,6486,6845,255;0;0,2,146,150,0,209,6632,6695,63,0
16351ref2,923,1281,JUNC00000023,3,+,923,1281,255;0;0,2,148,148,0,210,1071,1133,62,0
16351ref2,8912,9184,JUNC00000167,36,+,8912,9184,255;0;0,2,65,147,0,125,8977,9037,60,0
16351ref2,7472,7699,JUNC00000135,7,+,7472,7699,255;0;0,2,22,146,0,81,7494,7553,59,0
16351ref2,4388,4705,JUNC00000101,1263,-,4388,4705,255;0;0,2,109,150,0,167,4497,4555,58,0
16351ref2,955,1300,JUNC00000024,896,-,955,1300,255;0;0,2,146,142,0,203,1101,1158,57,0
16351ref2,3784,4043,JUNC00000081,8,-,3784,4043,255;0;0,2,53,149,0,110,3837,3894,57,0
16351ref2,541,877,JUNC00000009,33,+,541,877,255;0;0,2,133,147,0,189,674,730,56,0
16351ref2,2657,3010,JUNC00000067,157,+,2657,3010,255;0;0,2,149,148,0,205,2806,2862,56,0
16351ref2,7808,8040,JUNC00000148,14,-,7808,8040,255;0;0,2,27,149,0,83,7835,7891,56,0
16351ref2,825,1170,JUNC00000021,18,+,825,1170,255;0;0,2,144,148,0,197,969,1022,53,0
16351ref2,5452,5800,JUNC00000113,172,+,5452,5800,255;0;0,2,148,148,0,200,5600,5652,52,0
16351ref2,9959,10198,JUNC00000179,228,+,9959,10198,255;0;0,2,144,43,0,196,10103,10155,52,0
16351ref2,3787,4043,JUNC00000082,7,-,3787,4043,255;0;0,2,56,149,0,107,3843,3894,51,0
16351ref2,7723,8065,JUNC00000152,19,-,7723,8065,255;0;0,2,143,149,0,193,7866,7916,50,0
16351ref2,7909,8258,JUNC00000155,61,-,7909,8258,255;0;0,2,149,150,0,199,8058,8108,50,0
16351ref2,2554,2776,JUNC00000059,9,+,2554,2776,255;0;0,2,26,147,0,75,2580,2629,49,0
16351ref2,630,919,JUNC00000014,458,+,630,919,255;0;0,2,134,107,0,182,764,812,48,0
16351ref2,526,764,JUNC00000008,11,+,526,764,255;0;0,2,148,43,0,195,674,721,47,0
16351ref2,2507,2753,JUNC00000055,19,+,2507,2753,255;0;0,2,49,150,0,96,2556,2603,47,0
16351ref2,4030,4253,JUNC00000088,9,-,4030,4253,255;0;0,2,26,150,0,73,4056,4103,47,0
16351ref2,7708,8036,JUNC00000151,9,+,7708,8036,255;0;0,2,149,133,0,195,7857,7903,46,0
16351ref2,3639,3980,JUNC00000080,156,+,3639,3980,255;0;0,2,147,149,0,192,3786,3831,45,0
16351ref2,4245,4586,JUNC00000099,2,+,4245,4586,255;0;0,2,148,148,0,193,4393,4438,45,0
16351ref2,9687,9944,JUNC00000175,43,+,9687,9944,255;0;0,2,64,149,0,108,9751,9795,44,0
16351ref2,7657,7995,JUNC00000146,26,-,7657,7995,255;0;0,2,149,146,0,192,7806,7849,43,0
16351ref2,2556,2749,JUNC00000056,13,+,2556,2749,255;0;0,2,9,143,0,50,2565,2606,41,0
16351ref2,5804,6141,JUNC00000119,2,-,5804,6141,255;0;0,2,149,148,0,189,5953,5993,40,0
16351ref2,6723,6965,JUNC00000126,22,-,6723,6965,255;0;0,2,55,147,0,95,6778,6818,40,0
16351ref2,3699,3912,JUNC00000079,13,+,3699,3912,255;0;0,2,24,150,0,63,3723,3762,39,0
16351ref2,4372,4564,JUNC00000098,131,-,4372,4564,255;0;0,2,10,143,0,49,4382,4421,39,0
16351ref2,2674,3007,JUNC00000069,6,-,2674,3007,255;0;0,2,146,149,0,184,2820,2858,38,0
16351ref2,4091,4427,JUNC00000095,3,-,4091,4427,255;0;0,2,148,150,0,186,4239,4277,38,0
16351ref2,7497,7835,JUNC00000138,7,+,7497,7835,255;0;0,2,150,150,0,188,7647,7685,38,0
16351ref2,9047,9382,JUNC00000170,32,+,9047,9382,255;0;0,2,150,148,0,187,9197,9234,37,0
16351ref2,7517,7714,JUNC00000139,8,+,7517,7714,255;0;0,2,143,18,0,179,7660,7696,36,0
16351ref2,9008,9254,JUNC00000169,31,-,9008,9254,255;0;0,2,150,60,0,186,9158,9194,36,0
16351ref2,2337,2643,JUNC00000051,4,+,2337,2643,255;0;0,2,125,146,0,160,2462,2497,35,0
16351ref2,2444,2776,JUNC00000061,6,-,2444,2776,255;0;0,2,150,147,0,185,2594,2629,35,0
16351ref2,2451,2780,JUNC00000062,160,-,2451,2780,255;0;0,2,147,147,0,182,2598,2633,35,0
16351ref2,3990,4241,JUNC00000087,62,-,3990,4241,255;0;0,2,66,150,0,101,4056,4091,35,0
16351ref2,3990,4250,JUNC00000089,46,+,3990,4250,255;0;0,2,78,147,0,113,4068,4103,35,0
16351ref2,965,1295,JUNC00000025,7,+,965,1295,255;0;0,2,146,150,0,180,1111,1145,34,0
16351ref2,2657,2988,JUNC00000066,55,+,2657,2988,255;0;0,2,149,148,0,183,2806,2840,34,0
16351ref2,3502,3814,JUNC00000077,7,+,3502,3814,255;0;0,2,129,149,0,163,3631,3665,34,0
16351ref2,1241,1566,JUNC00000033,5,+,1241,1566,255;0;0,2,142,150,0,175,1383,1416,33,0
16351ref2,8007,8339,JUNC00000158,123,+,8007,8339,255;0;0,2,149,150,0,182,8156,8189,33,0
16351ref2,2135,2462,JUNC00000047,10,-,2135,2462,255;0;0,2,146,150,0,177,2281,2312,31,0
16351ref2,5838,6157,JUNC00000121,17,-,5838,6157,255;0;0,2,143,145,0,174,5981,6012,31,0
16351ref2,980,1169,JUNC00000029,41,-,980,1169,255;0;0,2,148,11,0,178,1128,1158,30,0
16351ref2,518,845,JUNC00000005,17,+,518,845,255;0;0,2,149,149,0,178,667,696,29,0
16351ref2,3139,3341,JUNC00000073,12,+,3139,3341,255;0;0,2,23,150,0,52,3162,3191,29,0
16351ref2,4847,5170,JUNC00000107,15,+,4847,5170,255;0;0,2,146,148,0,175,4993,5022,29,0
16351ref2,6106,6434,JUNC00000124,66,+,6106,6434,255;0;0,2,149,150,0,178,6255,6284,29,0
16351ref2,7963,8291,JUNC00000156,83,-,7963,8291,255;0;0,2,149,150,0,178,8112,8141,29,0
16351ref2,2112,2316,JUNC00000046,50,+,2112,2316,255;0;0,2,26,150,0,54,2138,2166,28,0
16351ref2,7706,7885,JUNC00000145,1,-,7706,7885,255;0;0,2,25,126,0,53,7731,7759,28,0
16351ref2,3207,3433,JUNC00000076,7,-,3207,3433,255;0;0,2,50,149,0,77,3257,3284,27,0
16351ref2,9760,10013,JUNC00000176,97,-,9760,10013,255;0;0,2,76,150,0,103,9836,9863,27,0
16351ref2,6807,7125,JUNC00000128,60,-,6807,7125,255;0;0,2,144,148,0,170,6951,6977,26,0
16351ref2,570,895,JUNC00000012,21,-,570,895,255;0;0,2,150,150,0,175,720,745,25,0
16351ref2,1724,2034,JUNC00000041,6,+,1724,2034,255;0;0,2,148,137,0,173,1872,1897,25,0
16351ref2,1977,2299,JUNC00000044,2,-,1977,2299,255;0;0,2,148,149,0,173,2125,2150,25,0
16351ref2,3022,3346,JUNC00000074,96,+,3022,3346,255;0;0,2,149,150,0,174,3171,3196,25,0
16351ref2,7527,7783,JUNC00000141,9,+,7527,7783,255;0;0,2,147,84,0,172,7674,7699,25,0
16351ref2,5454,5776,JUNC00000114,843,-,5454,5776,255;0;0,2,150,148,0,174,5604,5628,24,0
16351ref2,7694,8013,JUNC00000149,8,+,7694,8013,255;0;0,2,146,149,0,170,7840,7864,24,0
16351ref2,9993,10234,JUNC00000181,10,-,9993,10234,255;0;0,2,149,68,0,173,10142,10166,24,0
16351ref2,376,698,JUNC00000001,413,-,376,698,255;0;0,2,150,150,0,172,526,548,22,0
16351ref2,2918,3232,JUNC00000072,4,-,2918,3232,255;0;0,2,147,145,0,169,3065,3087,22,0
16351ref2,4091,4411,JUNC00000094,3,-,4091,4411,255;0;0,2,148,150,0,170,4239,4261,22,0
16351ref2,2324,2634,JUNC00000052,51,+,2324,2634,255;0;0,2,143,146,0,164,2467,2488,21,0
16351ref2,527,840,JUNC00000007,16,+,527,840,255;0;0,2,147,146,0,167,674,694,20,0
16351ref2,5001,5321,JUNC00000109,13,+,5001,5321,255;0;0,2,150,150,0,170,5151,5171,20,0
16351ref2,8300,8619,JUNC00000162,47,+,8300,8619,255;0;0,2,149,150,0,169,8449,8469,20,0
16351ref2,4615,4926,JUNC00000103,88,+,4615,4926,255;0;0,2,150,143,0,168,4765,4783,18,0
16351ref2,5986,6249,JUNC00000123,51,+,5986,6249,255;0;0,2,96,149,0,114,6082,6100,18,0
16351ref2,7683,7998,JUNC00000147,9,+,7683,7998,255;0;0,2,149,149,0,166,7832,7849,17,0
16351ref2,746,1057,JUNC00000018,5,-,746,1057,255;0;0,2,148,147,0,164,894,910,16,0
16351ref2,2344,2659,JUNC00000053,10,+,2344,2659,255;0;0,2,149,150,0,165,2493,2509,16,0
16351ref2,2667,2979,JUNC00000068,8,-,2667,2979,255;0;0,2,149,147,0,165,2816,2832,16,0
16351ref2,7200,7426,JUNC00000132,22,-,7200,7426,255;0;0,2,61,149,0,77,7261,7277,16,0
16351ref2,1367,1555,JUNC00000036,7,+,1367,1555,255;0;0,2,26,147,0,41,1393,1408,15,0
16351ref2,9705,9894,JUNC00000174,31,+,9705,9894,255;0;0,2,25,149,0,40,9730,9745,15,0
16351ref2,9968,10152,JUNC00000180,106,+,9968,10152,255;0;0,2,147,22,0,162,10115,10130,15,0
16351ref2,4111,4417,JUNC00000097,16,+,4111,4417,255;0;0,2,146,146,0,160,4257,4271,14,0
16351ref2,7985,8293,JUNC00000157,35,+,7985,8293,255;0;0,2,144,150,0,158,8129,8143,14,0
16351ref2,2279,2467,JUNC00000050,15,+,2279,2467,255;0;0,2,149,26,0,162,2428,2441,13,0
16351ref2,3838,4097,JUNC00000084,178,-,3838,4097,255;0;0,2,97,149,0,110,3935,3948,13,0
16351ref2,701,871,JUNC00000011,265,+,701,871,255;0;0,2,9,150,0,20,710,721,11,0
16351ref2,721,1024,JUNC00000017,424,+,721,1024,255;0;0,2,146,146,0,157,867,878,11,0
16351ref2,2010,2297,JUNC00000045,12,+,2010,2297,255;0;0,2,126,150,0,137,2136,2147,11,0
16351ref2,9184,9492,JUNC00000172,4,-,9184,9492,255;0;0,2,149,148,0,160,9333,9344,11,0
16351ref2,7712,8017,JUNC00000150,3,+,7712,8017,255;0;0,2,145,150,0,155,7857,7867,10,0
16351ref2,979,1287,JUNC00000028,13,-,979,1287,255;0;0,2,149,150,0,158,1128,1137,9,0
16351ref2,1240,1544,JUNC00000034,5,-,1240,1544,255;0;0,2,146,149,0,155,1386,1395,9,0
16351ref2,4828,5090,JUNC00000106,57,+,4828,5090,255;0;0,2,107,146,0,116,4935,4944,9,0
16351ref2,968,1271,JUNC00000026,5,+,968,1271,255;0;0,2,146,149,0,154,1114,1122,8,0
16351ref2,1002,1294,JUNC00000030,211,-,1002,1294,255;0;0,2,148,136,0,156,1150,1158,8,0
16351ref2,7569,7646,JUNC00000137,162,+,7569,7646,255;0;0,2,23,46,0,31,7592,7600,8,0
16351ref2,7524,7831,JUNC00000140,3,+,7524,7831,255;0;0,2,150,149,0,158,7674,7682,8,0
16351ref2,824,1125,JUNC00000020,31,+,824,1125,255;0;0,2,145,149,0,152,969,976,7,0
16351ref2,1367,1550,JUNC00000035,5,+,1367,1550,255;0;0,2,26,150,0,33,1393,1400,7,0
16351ref2,1288,1595,JUNC00000038,22,-,1288,1595,255;0;0,2,150,150,0,157,1438,1445,7,0
16351ref2,4447,4647,JUNC00000100,1161,+,4447,4647,255;0;0,2,43,150,0,50,4490,4497,7,0
16351ref2,8284,8585,JUNC00000160,146,+,8284,8585,255;0;0,2,147,147,0,154,8431,8438,7,0
16351ref2,974,1276,JUNC00000027,7,+,974,1276,255;0;0,2,148,148,0,154,1122,1128,6,0
16351ref2,3210,3399,JUNC00000075,49,+,3210,3399,255;0;0,2,33,150,0,39,3243,3249,6,0
16351ref2,5729,6032,JUNC00000117,3,+,5729,6032,255;0;0,2,149,148,0,155,5878,5884,6,0
16351ref2,7277,7580,JUNC00000134,9,-,7277,7580,255;0;0,2,150,147,0,156,7427,7433,6,0
16351ref2,9810,10110,JUNC00000178,36,+,9810,10110,255;0;0,2,147,147,0,153,9957,9963,6,0
16351ref2,781,1083,JUNC00000019,13,+,781,1083,255;0;0,2,149,148,0,154,930,935,5,0
16351ref2,1663,1916,JUNC00000039,2,-,1663,1916,255;0;0,2,100,148,0,105,1763,1768,5,0
16351ref2,4001,4182,JUNC00000086,164,-,4001,4182,255;0;0,2,27,149,0,32,4028,4033,5,0
16351ref2,7725,7934,JUNC00000153,27,-,7725,7934,255;0;0,2,150,54,0,155,7875,7880,5,0
16351ref2,8781,9078,JUNC00000165,1385,+,8781,9078,255;0;0,2,142,150,0,147,8923,8928,5,0
16351ref2,9477,9780,JUNC00000173,279,+,9477,9780,255;0;0,2,150,148,0,155,9627,9632,5,0
17086ref1,451,720,JUNC00000001,81,-,451,720,255;0;0,2,87,44,0,225,538,676,138,0
17086ref1,469,889,JUNC00000002,77,-,469,889,255;0;0,2,100,149,0,271,569,740,171,0
17086ref1,699,1055,JUNC00000003,16,-,699,1055,255;0;0,2,24,150,0,206,723,905,182,0
17086ref1,722,906,JUNC00000004,74,+,722,906,255;0;0,2,8,148,0,36,730,758,28,0
17086ref1,700,1028,JUNC00000005,97,+,700,1028,255;0;0,2,143,150,0,178,843,878,35,0
17086ref1,708,1008,JUNC00000006,83,-,708,1008,255;0;0,2,147,148,0,152,855,860,5,0
17086ref1,712,1014,JUNC00000007,33,-,712,1014,255;0;0,2,148,148,0,154,860,866,6,0
17086ref1,824,1126,JUNC00000008,101,+,824,1126,255;0;0,2,145,150,0,152,969,976,7,0
17086ref1,825,1171,JUNC00000009,25,+,825,1171,255;0;0,2,144,149,0,197,969,1022,53,0
17086ref1,962,4894,JUNC00000010,1,+,962,4894,255;0;0,2,34,117,0,3815,996,4777,3781,0
17086ref1,950,4405,JUNC00000011,61,-,950,4405,255;0;0,2,74,132,0,3323,1024,4273,3249,0
17086ref1,966,1287,JUNC00000012,12,+,966,1287,255;0;0,2,145,150,0,171,1111,1137,26,0
17086ref1,976,1287,JUNC00000013,11,+,976,1287,255;0;0,2,140,150,0,161,1116,1137,21,0
17086ref1,978,1293,JUNC00000014,16,+,978,1293,255;0;0,2,149,146,0,169,1127,1147,20,0
17086ref1,979,1221,JUNC00000015,63,-,979,1221,255;0;0,2,149,63,0,179,1128,1158,30,0
17086ref1,1000,1254,JUNC00000016,4,-,1000,1254,255;0;0,2,150,99,0,155,1150,1155,5,0
17086ref1,1002,1235,JUNC00000017,92,-,1002,1235,255;0;0,2,148,77,0,156,1150,1158,8,0
17086ref1,1075,9286,JUNC00000018,4,+,1075,9286,255;0;0,2,149,149,0,8062,1224,9137,7913,0
17086ref1,1318,1715,JUNC00000019,1005,+,1318,1715,255;0;0,2,147,150,0,247,1465,1565,100,0
17086ref1,1499,1812,JUNC00000020,29,-,1499,1812,255;0;0,2,148,150,0,163,1647,1662,15,0
17086ref1,1739,1977,JUNC00000021,15,-,1739,1977,255;0;0,2,30,146,0,92,1769,1831,62,0
17086ref1,1753,2019,JUNC00000022,4,-,1753,2019,255;0;0,2,73,107,0,159,1826,1912,86,0
17086ref1,1725,1984,JUNC00000023,2,+,1725,1984,255;0;0,2,125,66,0,193,1850,1918,68,0
17086ref1,1715,2014,JUNC00000024,2,+,1715,2014,255;0;0,2,145,148,0,151,1860,1866,6,0
17086ref1,1918,2298,JUNC00000025,3,+,1918,2298,255;0;0,2,149,148,0,232,2067,2150,83,0
17086ref1,1975,2299,JUNC00000026,5,-,1975,2299,255;0;0,2,150,149,0,175,2125,2150,25,0
17086ref1,2152,2473,JUNC00000027,31,+,2152,2473,255;0;0,2,73,146,0,175,2225,2327,102,0
17086ref1,2238,2573,JUNC00000028,68,-,2238,2573,255;0;0,2,150,149,0,186,2388,2424,36,0
17086ref1,2261,2655,JUNC00000029,10,+,2261,2655,255;0;0,2,148,148,0,246,2409,2507,98,0
17086ref1,2318,6215,JUNC00000030,46,+,2318,6215,255;0;0,2,94,149,0,3748,2412,6066,3654,0
17086ref1,2403,2643,JUNC00000031,3,+,2403,2643,255;0;0,2,59,146,0,94,2462,2497,35,0
17086ref1,2394,2777,JUNC00000032,39,-,2394,2777,255;0;0,2,142,148,0,235,2536,2629,93,0
17086ref1,2523,2797,JUNC00000033,29,-,2523,2797,255;0;0,2,13,145,0,129,2536,2652,116,0
17086ref1,2556,2750,JUNC00000034,17,+,2556,2750,255;0;0,2,9,144,0,50,2565,2606,41,0
17086ref1,2539,2851,JUNC00000035,189,+,2539,2851,255;0;0,2,26,147,0,165,2565,2704,139,0
17086ref1,2431,2632,JUNC00000036,34,+,2431,2632,255;0;0,2,149,24,0,177,2580,2608,28,0
17086ref1,2440,2776,JUNC00000037,3,+,2440,2776,255;0;0,2,149,147,0,189,2589,2629,40,0
17086ref1,2449,2763,JUNC00000038,12,+,2449,2763,255;0;0,2,149,150,0,164,2598,2613,15,0
17086ref1,2450,2797,JUNC00000039,15,-,2450,2797,255;0;0,2,148,148,0,199,2598,2649,51,0
17086ref1,2566,2988,JUNC00000040,18,+,2566,2988,255;0;0,2,131,148,0,274,2697,2840,143,0
17086ref1,2660,2986,JUNC00000041,73,+,2660,2986,255;0;0,2,146,146,0,180,2806,2840,34,0
17086ref1,2667,2852,JUNC00000042,90,-,2667,2852,255;0;0,2,149,20,0,165,2816,2832,16,0
17086ref1,2802,2988,JUNC00000043,30,+,2802,2988,255;0;0,2,21,148,0,38,2823,2840,17,0
17086ref1,2819,3032,JUNC00000044,71,+,2819,3032,255;0;0,2,11,148,0,65,2830,2884,54,0
17086ref1,2697,2864,JUNC00000045,40,+,2697,2864,255;0;0,2,149,8,0,159,2846,2856,10,0
17086ref1,2697,3009,JUNC00000046,10,+,2697,3009,255;0;0,2,149,147,0,165,2846,2862,16,0
17086ref1,2699,2912,JUNC00000047,6,+,2699,2912,255;0;0,2,149,48,0,165,2848,2864,16,0
17086ref1,2849,7076,JUNC00000048,4,-,2849,7076,255;0;0,2,24,135,0,4092,2873,6941,4068,0
17086ref1,2875,3061,JUNC00000049,108,-,2875,3061,255;0;0,2,74,47,0,139,2949,3014,65,0
17086ref1,2818,3166,JUNC00000050,1,-,2818,3166,255;0;0,2,131,20,0,328,2949,3146,197,0
17086ref1,2845,3131,JUNC00000051,43,-,2845,3131,255;0;0,2,127,147,0,139,2972,2984,12,0
17086ref1,2929,3088,JUNC00000052,2,-,2929,3088,255;0;0,2,43,46,0,113,2972,3042,70,0
17086ref1,2932,6831,JUNC00000053,81,+,2932,6831,255;0;0,2,87,149,0,3750,3019,6682,3663,0
17086ref1,3022,3342,JUNC00000054,72,+,3022,3342,255;0;0,2,149,146,0,174,3171,3196,25,0
17086ref1,3154,3434,JUNC00000055,28,-,3154,3434,255;0;0,2,103,150,0,130,3257,3284,27,0
17086ref1,3762,4064,JUNC00000056,2,-,3762,4064,255;0;0,2,147,150,0,152,3909,3914,5,0
17086ref1,3919,4141,JUNC00000057,21,+,3919,4141,255;0;0,2,27,150,0,72,3946,3991,45,0
17086ref1,3830,4147,JUNC00000058,4,+,3830,4147,255;0;0,2,149,150,0,167,3979,3997,18,0
17086ref1,4034,4224,JUNC00000059,9,+,4034,4224,255;0;0,2,27,149,0,41,4061,4075,14,0
17086ref1,3958,7700,JUNC00000060,12,-,3958,7700,255;0;0,2,149,149,0,3593,4107,7551,3444,0
17086ref1,3961,7703,JUNC00000061,9,-,3961,7703,255;0;0,2,148,150,0,3592,4109,7553,3444,0
17086ref1,3968,4283,JUNC00000062,112,-,3968,4283,255;0;0,2,149,145,0,170,4117,4138,21,0
17086ref1,4092,4411,JUNC00000063,4,-,4092,4411,255;0;0,2,147,150,0,169,4239,4261,22,0
17086ref1,4109,4418,JUNC00000064,12,+,4109,4418,255;0;0,2,148,147,0,162,4257,4271,14,0
17086ref1,4215,5791,JUNC00000065,47,-,4215,5791,255;0;0,2,61,148,0,1428,4276,5643,1367,0
17086ref1,4225,4440,JUNC00000066,26,+,4225,4440,255;0;0,2,150,35,0,180,4375,4405,30,0
17086ref1,4233,4414,JUNC00000067,237,-,4233,4414,255;0;0,2,149,26,0,155,4382,4388,6,0
17086ref1,4414,4700,JUNC00000068,230,-,4414,4700,255;0;0,2,83,145,0,141,4497,4555,58,0
17086ref1,4484,4812,JUNC00000069,33,-,4484,4812,255;0;0,2,48,145,0,183,4532,4667,135,0
17086ref1,4395,4824,JUNC00000070,89,-,4395,4824,255;0;0,2,144,150,0,279,4539,4674,135,0
17086ref1,4992,5316,JUNC00000071,4,+,4992,5316,255;0;0,2,150,145,0,179,5142,5171,29,0
17086ref1,5123,5652,JUNC00000072,1,+,5123,5652,255;0;0,2,41,29,0,500,5164,5623,459,0
17086ref1,5266,5554,JUNC00000073,2,+,5266,5554,255;0;0,2,110,66,0,222,5376,5488,112,0
17086ref1,5774,6119,JUNC00000074,44,+,5774,6119,255;0;0,2,76,148,0,197,5850,5971,121,0
17086ref1,6062,6294,JUNC00000075,4,+,6062,6294,255;0;0,2,144,17,0,215,6206,6277,71,0
17086ref1,6234,9213,JUNC00000076,2,+,6234,9213,255;0;0,2,71,98,0,2881,6305,9115,2810,0
17086ref1,6189,7721,JUNC00000077,7,-,6189,7721,255;0;0,2,150,147,0,1385,6339,7574,1235,0
17086ref1,6516,6697,JUNC00000078,1,-,6516,6697,255;0;0,2,113,31,0,150,6629,6666,37,0
17086ref1,6572,6892,JUNC00000079,31,-,6572,6892,255;0;0,2,145,150,0,170,6717,6742,25,0
17086ref1,6795,7120,JUNC00000080,2,-,6795,7120,255;0;0,2,147,147,0,178,6942,6973,31,0
17086ref1,6928,7529,JUNC00000081,191,+,6928,7529,255;0;0,2,145,35,0,566,7073,7494,421,0
17086ref1,7009,7363,JUNC00000082,9,-,7009,7363,255;0;0,2,149,149,0,205,7158,7214,56,0
17086ref1,7153,7488,JUNC00000083,82,-,7153,7488,255;0;0,2,148,146,0,189,7301,7342,41,0
17086ref1,7361,7726,JUNC00000084,115,-,7361,7726,255;0;0,2,150,148,0,217,7511,7578,67,0
17086ref1,7400,7577,JUNC00000085,2,-,7400,7577,255;0;0,2,130,21,0,156,7530,7556,26,0
17086ref1,7453,7712,JUNC00000086,19,+,7453,7712,255;0;0,2,89,150,0,109,7542,7562,20,0
17086ref1,7423,7598,JUNC00000087,14,-,7423,7598,255;0;0,2,150,20,0,155,7573,7578,5,0
17086ref1,7579,9078,JUNC00000088,54,+,7579,9078,255;0;0,2,61,150,0,1349,7640,8928,1288,0
17086ref1,7622,7835,JUNC00000089,2,+,7622,7835,255;0;0,2,25,150,0,63,7647,7685,38,0
17086ref1,7540,7839,JUNC00000090,8,+,7540,7839,255;0;0,2,120,143,0,156,7660,7696,36,0
17086ref1,7512,7767,JUNC00000091,13,+,7512,7767,255;0;0,2,148,68,0,187,7660,7699,39,0
17086ref1,7557,8018,JUNC00000092,36,+,7557,8018,255;0;0,2,142,145,0,316,7699,7873,174,0
17086ref1,7698,8037,JUNC00000093,59,+,7698,8037,255;0;0,2,35,149,0,190,7733,7888,155,0
17086ref1,7633,10084,JUNC00000094,2,-,7633,10084,255;0;0,2,143,134,0,2317,7776,9950,2174,0
17086ref1,7728,7969,JUNC00000095,14,+,7728,7969,255;0;0,2,51,149,0,92,7779,7820,41,0
17086ref1,7796,7973,JUNC00000096,52,-,7796,7973,255;0;0,2,10,146,0,31,7806,7827,21,0
17086ref1,7729,8896,JUNC00000097,3,+,7729,8896,255;0;0,2,96,55,0,1112,7825,8841,1016,0
17086ref1,7695,8141,JUNC00000098,35,+,7695,8141,255;0;0,2,142,147,0,299,7837,7994,157,0
17086ref1,7725,7965,JUNC00000099,47,-,7725,7965,255;0;0,2,150,85,0,155,7875,7880,5,0
17086ref1,7963,8278,JUNC00000100,106,-,7963,8278,255;0;0,2,149,149,0,166,8112,8129,17,0
17086ref1,8137,8458,JUNC00000101,5,-,8137,8458,255;0;0,2,145,124,0,197,8282,8334,52,0
17086ref1,8773,9078,JUNC00000102,2167,+,8773,9078,255;0;0,2,150,150,0,155,8923,8928,5,0
17086ref1,8900,9063,JUNC00000103,1,-,8900,9063,255;0;0,2,103,48,0,115,9003,9015,12,0
17086ref1,9008,9344,JUNC00000104,151,-,9008,9344,255;0;0,2,150,150,0,186,9158,9194,36,0
17086ref1,10078,10257,JUNC00000105,1,+,10078,10257,255;0;0,2,86,65,0,114,10164,10192,28,0
17345ref2,414,738,JUNC00000001,4,-,414,738,255;0;0,2,148,147,0,177,562,591,29,0
17345ref2,632,792,JUNC00000002,137,+,632,792,255;0;0,2,24,62,0,98,656,730,74,0
17345ref2,513,1133,JUNC00000003,72,+,513,1133,255;0;0,2,143,118,0,502,656,1015,359,0
17345ref2,599,886,JUNC00000004,323,+,599,886,255;0;0,2,75,141,0,146,674,745,71,0
17345ref2,619,1025,JUNC00000005,212,+,619,1025,255;0;0,2,55,147,0,259,674,878,204,0
17345ref2,599,903,JUNC00000006,248,-,599,903,255;0;0,2,145,118,0,186,744,785,41,0
17345ref2,692,969,JUNC00000007,286,+,692,969,255;0;0,2,101,143,0,134,793,826,33,0
17345ref2,809,1125,JUNC00000008,90,+,809,1125,255;0;0,2,131,149,0,167,940,976,36,0
17345ref2,823,1126,JUNC00000009,117,+,823,1126,255;0;0,2,146,150,0,153,969,976,7,0
17345ref2,825,1170,JUNC00000010,12,+,825,1170,255;0;0,2,144,148,0,197,969,1022,53,0
17345ref2,927,1137,JUNC00000011,15,+,927,1137,255;0;0,2,51,149,0,61,978,988,10,0
17345ref2,955,1292,JUNC00000012,1040,-,955,1292,255;0;0,2,146,134,0,203,1101,1158,57,0
17345ref2,964,1293,JUNC00000013,5,+,964,1293,255;0;0,2,147,148,0,181,1111,1145,34,0
17345ref2,977,1293,JUNC00000014,88,+,977,1293,255;0;0,2,150,146,0,170,1127,1147,20,0
17345ref2,980,1308,JUNC00000015,93,-,980,1308,255;0;0,2,148,150,0,178,1128,1158,30,0
17345ref2,1002,1254,JUNC00000016,115,-,1002,1254,255;0;0,2,148,96,0,156,1150,1158,8,0
17345ref2,1005,7700,JUNC00000017,12,-,1005,7700,255;0;0,2,149,149,0,6546,1154,7551,6397,0
17345ref2,1077,1382,JUNC00000018,105,+,1077,1382,255;0;0,2,147,150,0,155,1224,1232,8,0
17345ref2,1233,1565,JUNC00000019,227,+,1233,1565,255;0;0,2,150,149,0,183,1383,1416,33,0
17345ref2,1261,1671,JUNC00000020,348,+,1261,1671,255;0;0,2,150,150,0,260,1411,1521,110,0
17345ref2,1344,1595,JUNC00000021,1,+,1344,1595,255;0;0,2,121,30,0,221,1465,1565,100,0
17345ref2,1606,1973,JUNC00000022,195,-,1606,1973,255;0;0,2,145,147,0,220,1751,1826,75,0
17345ref2,1808,2055,JUNC00000023,2,+,1808,2055,255;0;0,2,30,149,0,98,1838,1906,68,0
17345ref2,1719,2068,JUNC00000024,11,+,1719,2068,255;0;0,2,131,150,0,199,1850,1918,68,0
17345ref2,1850,2061,JUNC00000025,2,-,1850,2061,255;0;0,2,10,149,0,62,1860,1912,52,0
17345ref2,2146,2474,JUNC00000026,330,+,2146,2474,255;0;0,2,145,147,0,181,2291,2327,36,0
17345ref2,2213,2619,JUNC00000027,26,-,2213,2619,255;0;0,2,149,150,0,256,2362,2469,107,0
17345ref2,2342,2548,JUNC00000028,15,+,2342,2548,255;0;0,2,149,51,0,155,2491,2497,6,0
17345ref2,2535,2994,JUNC00000029,76,+,2535,2994,255;0;0,2,12,149,0,310,2547,2845,298,0
17345ref2,2501,2851,JUNC00000030,210,+,2501,2851,255;0;0,2,64,147,0,203,2565,2704,139,0
17345ref2,2508,2777,JUNC00000031,73,+,2508,2777,255;0;0,2,72,148,0,121,2580,2629,49,0
17345ref2,2546,2776,JUNC00000032,15,+,2546,2776,255;0;0,2,43,147,0,83,2589,2629,40,0
17345ref2,2449,2763,JUNC00000033,19,+,2449,2763,255;0;0,2,149,150,0,164,2598,2613,15,0
17345ref2,2615,6027,JUNC00000034,1,-,2615,6027,255;0;0,2,55,96,0,3316,2670,5931,3261,0
17345ref2,2614,2930,JUNC00000035,2,-,2614,2930,255;0;0,2,147,147,0,169,2761,2783,22,0
17345ref2,2673,9012,JUNC00000036,1,+,2673,9012,255;0;0,2,116,35,0,6304,2789,8977,6188,0
17345ref2,2670,2854,JUNC00000037,102,-,2670,2854,255;0;0,2,146,22,0,162,2816,2832,16,0
17345ref2,2670,3003,JUNC00000038,18,-,2670,3003,255;0;0,2,150,145,0,188,2820,2858,38,0
17345ref2,2680,2994,JUNC00000039,110,+,2680,2994,255;0;0,2,150,149,0,165,2830,2845,15,0
17345ref2,2697,3028,JUNC00000040,22,+,2697,3028,255;0;0,2,149,150,0,181,2846,2878,32,0
17345ref2,2829,3035,JUNC00000041,3,+,2829,3035,255;0;0,2,90,67,0,139,2919,2968,49,0
17345ref2,2834,3187,JUNC00000042,251,-,2834,3187,255;0;0,2,138,145,0,208,2972,3042,70,0
17345ref2,2897,3195,JUNC00000043,474,+,2897,3195,255;0;0,2,143,148,0,150,3040,3047,7,0
17345ref2,2983,3301,JUNC00000044,17,-,2983,3301,255;0;0,2,145,100,0,218,3128,3201,73,0
17345ref2,3021,3349,JUNC00000045,54,-,3021,3349,255;0;0,2,150,148,0,180,3171,3201,30,0
17345ref2,3023,3333,JUNC00000046,311,-,3023,3333,255;0;0,2,150,132,0,178,3173,3201,28,0
17345ref2,3049,3386,JUNC00000047,909,+,3049,3386,255;0;0,2,147,150,0,187,3196,3236,40,0
17345ref2,3179,3434,JUNC00000048,87,-,3179,3434,255;0;0,2,78,150,0,105,3257,3284,27,0
17345ref2,3636,3980,JUNC00000049,143,+,3636,3980,255;0;0,2,150,149,0,195,3786,3831,45,0
17345ref2,3697,4204,JUNC00000050,913,-,3697,4204,255;0;0,2,150,150,0,357,3847,4054,207,0
17345ref2,3895,4139,JUNC00000051,20,+,3895,4139,255;0;0,2,51,150,0,94,3946,3989,43,0
17345ref2,3984,4184,JUNC00000052,35,+,3984,4184,255;0;0,2,9,149,0,51,3993,4035,42,0
17345ref2,3881,4181,JUNC00000053,21,-,3881,4181,255;0;0,2,147,148,0,152,4028,4033,5,0
17345ref2,3959,4310,JUNC00000054,38,-,3959,4310,255;0;0,2,150,150,0,201,4109,4160,51,0
17345ref2,3971,4274,JUNC00000055,18,+,3971,4274,255;0;0,2,149,149,0,154,4120,4125,5,0
17345ref2,3974,4280,JUNC00000056,83,+,3974,4280,255;0;0,2,146,150,0,156,4120,4130,10,0
17345ref2,4206,4417,JUNC00000057,9,+,4206,4417,255;0;0,2,51,146,0,65,4257,4271,14,0
17345ref2,4253,4511,JUNC00000058,43,+,4253,4511,255;0;0,2,78,150,0,108,4331,4361,30,0
17345ref2,4192,4522,JUNC00000059,10,+,4192,4522,255;0;0,2,150,150,0,180,4342,4372,30,0
17345ref2,4268,4531,JUNC00000060,32,-,4268,4531,255;0;0,2,84,149,0,114,4352,4382,30,0
17345ref2,4232,4567,JUNC00000061,50,+,4232,4567,255;0;0,2,148,149,0,186,4380,4418,38,0
17345ref2,4415,4644,JUNC00000062,30,+,4415,4644,255;0;0,2,10,147,0,82,4425,4497,72,0
17345ref2,4317,4625,JUNC00000063,2,-,4317,4625,255;0;0,2,147,147,0,161,4464,4478,14,0
17345ref2,4423,4698,JUNC00000064,200,-,4423,4698,255;0;0,2,74,143,0,132,4497,4555,58,0
17345ref2,4380,4813,JUNC00000065,37,+,4380,4813,255;0;0,2,149,149,0,284,4529,4664,135,0
17345ref2,4393,4817,JUNC00000066,209,-,4393,4817,255;0;0,2,139,150,0,274,4532,4667,135,0
17345ref2,4425,4824,JUNC00000067,127,-,4425,4824,255;0;0,2,114,150,0,249,4539,4674,135,0
17345ref2,4509,6217,JUNC00000068,48,-,4509,6217,255;0;0,2,30,145,0,1563,4539,6072,1533,0
17345ref2,4984,5280,JUNC00000069,2,-,4984,5280,255;0;0,2,146,33,0,263,5130,5247,117,0
17345ref2,5002,5319,JUNC00000070,3,+,5002,5319,255;0;0,2,149,148,0,169,5151,5171,20,0
17345ref2,5571,5776,JUNC00000071,60,-,5571,5776,255;0;0,2,33,148,0,57,5604,5628,24,0
17345ref2,5608,5924,JUNC00000072,60,+,5608,5924,255;0;0,2,128,149,0,167,5736,5775,39,0
17345ref2,5680,6027,JUNC00000073,2,+,5680,6027,255;0;0,2,150,148,0,199,5830,5879,49,0
17345ref2,5694,5953,JUNC00000074,2,+,5694,5953,255;0;0,2,147,99,0,160,5841,5854,13,0
17345ref2,5729,6030,JUNC00000075,11,+,5729,6030,255;0;0,2,149,146,0,155,5878,5884,6,0
17345ref2,5784,6090,JUNC00000076,24,-,5784,6090,255;0;0,2,149,149,0,157,5933,5941,8,0
17345ref2,5785,6183,JUNC00000077,5,-,5785,6183,255;0;0,2,148,148,0,250,5933,6035,102,0
17345ref2,5825,6159,JUNC00000078,118,-,5825,6159,255;0;0,2,149,145,0,189,5974,6014,40,0
17345ref2,6007,7616,JUNC00000079,12,-,6007,7616,255;0;0,2,75,149,0,1460,6082,7467,1385,0
17345ref2,6040,6275,JUNC00000080,3,-,6040,6275,255;0;0,2,75,149,0,86,6115,6126,11,0
17345ref2,5965,9078,JUNC00000081,7,-,5965,9078,255;0;0,2,150,150,0,2963,6115,8928,2813,0
17345ref2,5994,9101,JUNC00000082,18,-,5994,9101,255;0;0,2,150,148,0,2959,6144,8953,2809,0
17345ref2,6098,6413,JUNC00000083,42,+,6098,6413,255;0;0,2,149,144,0,171,6247,6269,22,0
17345ref2,6167,7747,JUNC00000084,49,-,6167,7747,255;0;0,2,82,141,0,1439,6249,7606,1357,0
17345ref2,6917,7106,JUNC00000085,12,-,6917,7106,255;0;0,2,25,147,0,42,6942,6959,17,0
17345ref2,7383,7579,JUNC00000086,1,-,7383,7579,255;0;0,2,128,23,0,173,7511,7556,45,0
17345ref2,7362,7728,JUNC00000087,115,-,7362,7728,255;0;0,2,149,150,0,216,7511,7578,67,0
17345ref2,7383,7581,JUNC00000088,8,-,7383,7581,255;0;0,2,147,25,0,173,7530,7556,26,0
17345ref2,7404,7656,JUNC00000089,70,+,7404,7656,255;0;0,2,150,66,0,186,7554,7590,36,0
17345ref2,7404,7868,JUNC00000090,51,+,7404,7868,255;0;0,2,150,148,0,316,7554,7720,166,0
17345ref2,7423,7728,JUNC00000091,21,-,7423,7728,255;0;0,2,150,150,0,155,7573,7578,5,0
17345ref2,7502,7693,JUNC00000092,2,-,7502,7693,255;0;0,2,147,8,0,183,7649,7685,36,0
17345ref2,7511,7845,JUNC00000093,14,+,7511,7845,255;0;0,2,149,149,0,185,7660,7696,36,0
17345ref2,7582,8034,JUNC00000094,16,+,7582,8034,255;0;0,2,149,149,0,303,7731,7885,154,0
17345ref2,7738,8056,JUNC00000095,4,-,7738,8056,255;0;0,2,14,150,0,168,7752,7906,154,0
17345ref2,7662,7896,JUNC00000096,15,-,7662,7896,255;0;0,2,144,47,0,187,7806,7849,43,0
17345ref2,7702,7884,JUNC00000097,24,-,7702,7884,255;0;0,2,146,9,0,173,7848,7875,27,0
17345ref2,7709,8038,JUNC00000098,114,+,7709,8038,255;0;0,2,148,150,0,179,7857,7888,31,0
17345ref2,7725,8028,JUNC00000099,75,-,7725,8028,255;0;0,2,150,148,0,155,7875,7880,5,0
17345ref2,7983,8197,JUNC00000100,3,+,7983,8197,255;0;0,2,24,146,0,68,8007,8051,44,0
17345ref2,8006,8326,JUNC00000101,9,+,8006,8326,255;0;0,2,148,150,0,170,8154,8176,22,0
17345ref2,8179,8466,JUNC00000102,1,+,8179,8466,255;0;0,2,79,72,0,215,8258,8394,136,0
17345ref2,8299,8601,JUNC00000103,8,+,8299,8601,255;0;0,2,150,147,0,155,8449,8454,5,0
17345ref2,8411,8666,JUNC00000104,2,+,8411,8666,255;0;0,2,108,43,0,212,8519,8623,104,0
17345ref2,8739,8907,JUNC00000105,4,-,8739,8907,255;0;0,2,8,143,0,25,8747,8764,17,0
17345ref2,8625,8925,JUNC00000106,90,+,8625,8925,255;0;0,2,150,40,0,260,8775,8885,110,0
17345ref2,8773,9073,JUNC00000107,2,+,8773,9073,255;0;0,2,142,145,0,155,8915,8928,13,0
17345ref2,8780,9078,JUNC00000108,3324,+,8780,9078,255;0;0,2,143,150,0,148,8923,8928,5,0
17345ref2,9008,9340,JUNC00000109,17,-,9008,9340,255;0;0,2,150,146,0,186,9158,9194,36,0
17345ref2,9845,10152,JUNC00000110,2,+,9845,10152,255;0;0,2,148,105,0,202,9993,10047,54,0
17345ref2,10042,10404,JUNC00000111,777,+,10042,10404,255;0;0,2,150,150,0,212,10192,10254,62,0
17345ref2,10118,10426,JUNC00000112,153,+,10118,10426,255;0;0,2,150,150,0,158,10268,10276,8,0
17560ref1,304,483,JUNC00000001,31,+,304,483,255;0;0,2,150,20,0,159,454,463,9,0
17560ref1,321,821,JUNC00000002,1045,+,321,821,255;0;0,2,150,147,0,353,471,674,203,0
17560ref1,508,767,JUNC00000003,50,+,508,767,255;0;0,2,28,145,0,114,536,622,86,0
17560ref1,480,779,JUNC00000004,43,+,480,779,255;0;0,2,147,146,0,153,627,633,6,0
17560ref1,652,844,JUNC00000005,140,+,652,844,255;0;0,2,22,148,0,44,674,696,22,0
17560ref1,666,864,JUNC00000006,1,+,666,864,255;0;0,2,8,143,0,55,674,721,47,0
17560ref1,694,1020,JUNC00000007,93,+,694,1020,255;0;0,2,23,149,0,177,717,871,154,0
17560ref1,637,1027,JUNC00000008,36,-,637,1027,255;0;0,2,148,149,0,241,785,878,93,0
17560ref1,761,976,JUNC00000009,58,+,761,976,255;0;0,2,43,150,0,65,804,826,22,0
17560ref1,804,1020,JUNC00000010,33,+,804,1020,255;0;0,2,42,149,0,67,846,871,25,0
17560ref1,699,10045,JUNC00000011,18,+,699,10045,255;0;0,2,150,150,0,9196,849,9895,9046,0
17560ref1,710,1008,JUNC00000012,13,-,710,1008,255;0;0,2,145,148,0,150,855,860,5,0
17560ref1,706,1027,JUNC00000013,155,-,706,1027,255;0;0,2,149,149,0,172,855,878,23,0
17560ref1,819,1023,JUNC00000014,8,+,819,1023,255;0;0,2,48,145,0,59,867,878,11,0
17560ref1,824,1125,JUNC00000015,42,+,824,1125,255;0;0,2,145,149,0,152,969,976,7,0
17560ref1,825,1169,JUNC00000016,7,+,825,1169,255;0;0,2,144,147,0,197,969,1022,53,0
17560ref1,871,1449,JUNC00000017,71,+,871,1449,255;0;0,2,144,141,0,437,1015,1308,293,0
17560ref1,955,1307,JUNC00000018,975,-,955,1307,255;0;0,2,146,149,0,203,1101,1158,57,0
17560ref1,1002,1307,JUNC00000019,80,-,1002,1307,255;0;0,2,148,149,0,156,1150,1158,8,0
17560ref1,1144,1424,JUNC00000020,24,+,1144,1424,255;0;0,2,126,47,0,233,1270,1377,107,0
17560ref1,1386,1450,JUNC00000021,2,+,1386,1450,255;0;0,2,25,24,0,40,1411,1426,15,0
17560ref1,1276,1594,JUNC00000022,42,-,1276,1594,255;0;0,2,149,149,0,169,1425,1445,20,0
17560ref1,1493,2838,JUNC00000023,1744,+,1493,2838,255;0;0,2,150,141,0,1204,1643,2697,1054,0
17560ref1,1497,4913,JUNC00000024,625,+,1497,4913,255;0;0,2,150,148,0,3268,1647,4765,3118,0
17560ref1,1601,1972,JUNC00000025,4893,-,1601,1972,255;0;0,2,150,146,0,225,1751,1826,75,0
17560ref1,1748,1975,JUNC00000026,2,-,1748,1975,255;0;0,2,21,149,0,78,1769,1826,57,0
17560ref1,1643,5923,JUNC00000027,7627,+,1643,5923,255;0;0,2,150,148,0,4132,1793,5775,3982,0
17560ref1,1772,1963,JUNC00000028,34,-,1772,1963,255;0;0,2,54,68,0,123,1826,1895,69,0
17560ref1,1804,2058,JUNC00000029,43,-,1804,2058,255;0;0,2,22,146,0,108,1826,1912,86,0
17560ref1,1726,2059,JUNC00000030,22,-,1726,2059,255;0;0,2,134,147,0,186,1860,1912,52,0
17560ref1,1858,2112,JUNC00000031,2,+,1858,2112,255;0;0,2,146,100,0,154,2004,2012,8,0
17560ref1,1980,2298,JUNC00000032,3,-,1980,2298,255;0;0,2,145,148,0,170,2125,2150,25,0
17560ref1,2217,2470,JUNC00000033,1,+,2217,2470,255;0;0,2,8,143,0,110,2225,2327,102,0
17560ref1,2240,2556,JUNC00000034,5,+,2240,2556,255;0;0,2,148,149,0,167,2388,2407,19,0
17560ref1,2239,2572,JUNC00000035,10,-,2239,2572,255;0;0,2,149,148,0,185,2388,2424,36,0
17560ref1,2408,2645,JUNC00000036,9,+,2408,2645,255;0;0,2,54,148,0,89,2462,2497,35,0
17560ref1,2520,2723,JUNC00000037,68,+,2520,2723,255;0;0,2,45,145,0,58,2565,2578,13,0
17560ref1,2520,2851,JUNC00000038,120,+,2520,2851,255;0;0,2,45,147,0,184,2565,2704,139,0
17560ref1,2435,2703,JUNC00000039,1,+,2435,2703,255;0;0,2,143,8,0,260,2578,2695,117,0
17560ref1,2536,2804,JUNC00000040,1,+,2536,2804,255;0;0,2,44,107,0,161,2580,2697,117,0
17560ref1,2432,2778,JUNC00000041,8,+,2432,2778,255;0;0,2,148,53,0,293,2580,2725,145,0
17560ref1,2434,2755,JUNC00000042,17,+,2434,2755,255;0;0,2,150,149,0,172,2584,2606,22,0
17560ref1,2449,2673,JUNC00000043,2,+,2449,2673,255;0;0,2,140,44,0,180,2589,2629,40,0
17560ref1,2444,2776,JUNC00000044,6,-,2444,2776,255;0;0,2,150,147,0,185,2594,2629,35,0
17560ref1,2572,2770,JUNC00000045,13,-,2572,2770,255;0;0,2,26,149,0,49,2598,2621,23,0
17560ref1,2450,2781,JUNC00000046,67,-,2450,2781,255;0;0,2,148,148,0,183,2598,2633,35,0
17560ref1,2470,2785,JUNC00000047,12,+,2470,2785,255;0;0,2,149,149,0,166,2619,2636,17,0
17560ref1,2633,3000,JUNC00000048,6,+,2633,3000,255;0;0,2,19,142,0,225,2652,2858,206,0
17560ref1,2601,2883,JUNC00000049,385,+,2601,2883,255;0;0,2,69,132,0,150,2670,2751,81,0
17560ref1,2657,2990,JUNC00000050,18,+,2657,2990,255;0;0,2,25,150,0,183,2682,2840,158,0
17560ref1,2658,2989,JUNC00000051,175,+,2658,2989,255;0;0,2,148,149,0,182,2806,2840,34,0
17560ref1,2797,2989,JUNC00000052,32,+,2797,2989,255;0;0,2,26,149,0,43,2823,2840,17,0
17560ref1,2704,2990,JUNC00000053,6,+,2704,2990,255;0;0,2,123,150,0,136,2827,2840,13,0
17560ref1,2700,3006,JUNC00000054,22,+,2700,3006,255;0;0,2,146,150,0,156,2846,2856,10,0
17560ref1,2697,3009,JUNC00000055,16,+,2697,3009,255;0;0,2,149,147,0,165,2846,2862,16,0
17560ref1,2699,3127,JUNC00000056,100,+,2699,3127,255;0;0,2,149,147,0,281,2848,2980,132,0
17560ref1,2724,3127,JUNC00000057,34,-,2724,3127,255;0;0,2,149,149,0,254,2873,2978,105,0
17560ref1,2757,3095,JUNC00000058,22,+,2757,3095,255;0;0,2,147,149,0,189,2904,2946,42,0
17560ref1,2885,3108,JUNC00000059,10,+,2885,3108,255;0;0,2,34,147,0,76,2919,2961,42,0
17560ref1,2870,8050,JUNC00000060,365,+,2870,8050,255;0;0,2,49,128,0,5052,2919,7922,5003,0
17560ref1,2857,3301,JUNC00000061,68,+,2857,3301,255;0;0,2,85,69,0,375,2942,3232,290,0
17560ref1,3010,3354,JUNC00000062,3,+,3010,3354,255;0;0,2,147,148,0,196,3157,3206,49,0
17560ref1,3022,3346,JUNC00000063,65,+,3022,3346,255;0;0,2,149,150,0,174,3171,3196,25,0
17560ref1,3024,3351,JUNC00000064,379,-,3024,3351,255;0;0,2,149,150,0,177,3173,3201,28,0
17560ref1,3183,3434,JUNC00000065,31,-,3183,3434,255;0;0,2,74,150,0,101,3257,3284,27,0
17560ref1,3792,4646,JUNC00000066,113,-,3792,4646,255;0;0,2,45,149,0,705,3837,4497,660,0
17560ref1,3861,4445,JUNC00000067,9,+,3861,4445,255;0;0,2,41,150,0,434,3902,4295,393,0
17560ref1,3791,4123,JUNC00000068,37,+,3791,4123,255;0;0,2,148,149,0,183,3939,3974,35,0
17560ref1,3925,4454,JUNC00000069,52,+,3925,4454,255;0;0,2,150,144,0,385,4075,4310,235,0
17560ref1,3963,4267,JUNC00000070,16,-,3963,4267,255;0;0,2,146,149,0,155,4109,4118,9,0
17560ref1,4181,4415,JUNC00000071,3,+,4181,4415,255;0;0,2,25,150,0,84,4206,4265,59,0
17560ref1,4110,4418,JUNC00000072,9,+,4110,4418,255;0;0,2,147,147,0,161,4257,4271,14,0
17560ref1,4179,4576,JUNC00000073,321,+,4179,4576,255;0;0,2,144,141,0,256,4323,4435,112,0
17560ref1,4259,9038,JUNC00000074,2,-,4259,9038,255;0;0,2,83,149,0,4630,4342,8889,4547,0
17560ref1,4331,4560,JUNC00000075,9,+,4331,4560,255;0;0,2,33,148,0,81,4364,4412,48,0
17560ref1,4227,4413,JUNC00000076,7,+,4227,4413,255;0;0,2,148,8,0,178,4375,4405,30,0
17560ref1,4407,4603,JUNC00000077,9,+,4407,4603,255;0;0,2,32,150,0,46,4439,4453,14,0
17560ref1,4444,4670,JUNC00000078,3,+,4444,4670,255;0;0,2,20,148,0,78,4464,4522,58,0
17560ref1,4344,4654,JUNC00000079,6,+,4344,4654,255;0;0,2,149,147,0,163,4493,4507,14,0
17560ref1,4361,4674,JUNC00000080,161,-,4361,4674,255;0;0,2,136,119,0,194,4497,4555,58,0
17560ref1,4741,4924,JUNC00000081,3,+,4741,4924,255;0;0,2,24,141,0,42,4765,4783,18,0
17560ref1,4827,5079,JUNC00000082,4,-,4827,5079,255;0;0,2,18,149,0,103,4845,4930,85,0
17560ref1,4984,5367,JUNC00000083,3,-,4984,5367,255;0;0,2,146,145,0,238,5130,5222,92,0
17560ref1,5008,5391,JUNC00000084,4,+,5008,5391,255;0;0,2,143,148,0,235,5151,5243,92,0
17560ref1,5354,5679,JUNC00000085,43,+,5354,5679,255;0;0,2,149,148,0,177,5503,5531,28,0
17560ref1,5563,5940,JUNC00000086,4,-,5563,5940,255;0;0,2,147,147,0,230,5710,5793,83,0
17560ref1,5687,6120,JUNC00000087,2,+,5687,6120,255;0;0,2,150,149,0,284,5837,5971,134,0
17560ref1,5729,6031,JUNC00000088,3,+,5729,6031,255;0;0,2,149,147,0,155,5878,5884,6,0
17560ref1,5754,6286,JUNC00000089,2,-,5754,6286,255;0;0,2,147,50,0,482,5901,6236,335,0
17560ref1,5808,6105,JUNC00000090,3,-,5808,6105,255;0;0,2,147,125,0,172,5955,5980,25,0
17560ref1,5926,6127,JUNC00000091,2,+,5926,6127,255;0;0,2,132,27,0,174,6058,6100,42,0
17560ref1,6621,6877,JUNC00000092,1,-,6621,6877,255;0;0,2,8,143,0,113,6629,6734,105,0
17560ref1,6567,6880,JUNC00000093,4,-,6567,6880,255;0;0,2,150,150,0,163,6717,6730,13,0
17560ref1,6727,7045,JUNC00000094,5,+,6727,7045,255;0;0,2,147,148,0,170,6874,6897,23,0
17560ref1,6869,7189,JUNC00000095,3,+,6869,7189,255;0;0,2,18,123,0,197,6887,7066,179,0
17560ref1,6814,7123,JUNC00000096,21,-,6814,7123,255;0;0,2,147,150,0,159,6961,6973,12,0
17560ref1,7059,7303,JUNC00000097,29,-,7059,7303,255;0;0,2,84,149,0,95,7143,7154,11,0
17560ref1,7054,7516,JUNC00000098,4,+,7054,7516,255;0;0,2,149,150,0,312,7203,7366,163,0
17560ref1,7314,7733,JUNC00000099,2,+,7314,7733,255;0;0,2,8,143,0,276,7322,7590,268,0
17560ref1,7330,7514,JUNC00000100,4,-,7330,7514,255;0;0,2,26,145,0,39,7356,7369,13,0
17560ref1,7435,7700,JUNC00000101,4,+,7435,7700,255;0;0,2,50,149,0,116,7485,7551,66,0
17560ref1,7399,7654,JUNC00000102,3,-,7399,7654,255;0;0,2,131,98,0,157,7530,7556,26,0
17560ref1,7586,7773,JUNC00000103,2,+,7586,7773,255;0;0,2,74,77,0,110,7660,7696,36,0
17560ref1,7684,8056,JUNC00000104,27,-,7684,8056,255;0;0,2,68,150,0,222,7752,7906,154,0
17560ref1,7687,8038,JUNC00000105,40,-,7687,8038,255;0;0,2,89,147,0,204,7776,7891,115,0
17560ref1,7757,8042,JUNC00000106,97,+,7757,8042,255;0;0,2,22,148,0,137,7779,7894,115,0
17560ref1,7725,7893,JUNC00000107,1,-,7725,7893,255;0;0,2,115,36,0,132,7840,7857,17,0
17560ref1,7842,8038,JUNC00000108,18,-,7842,8038,255;0;0,2,33,147,0,49,7875,7891,16,0
17560ref1,8172,8505,JUNC00000109,84,+,8172,8505,255;0;0,2,149,144,0,189,8321,8361,40,0
17560ref1,8307,8502,JUNC00000110,2,+,8307,8502,255;0;0,2,131,28,0,167,8438,8474,36,0
17560ref1,8290,8651,JUNC00000111,837,+,8290,8651,255;0;0,2,148,150,0,211,8438,8501,63,0
17560ref1,8406,8634,JUNC00000112,2,+,8406,8634,255;0;0,2,82,88,0,140,8488,8546,58,0
17560ref1,8773,9078,JUNC00000113,1459,+,8773,9078,255;0;0,2,150,150,0,155,8923,8928,5,0
17560ref1,9182,9343,JUNC00000114,1,+,9182,9343,255;0;0,2,122,29,0,132,9304,9314,10,0
17560ref1,9471,9735,JUNC00000115,2,+,9471,9735,255;0;0,2,35,148,0,116,9506,9587,81,0
17560ref1,9705,9944,JUNC00000116,76,+,9705,9944,255;0;0,2,70,149,0,90,9775,9795,20,0
17560ref1,9748,9972,JUNC00000117,119,-,9748,9972,255;0;0,2,61,148,0,76,9809,9824,15,0
17560ref1,9827,10075,JUNC00000118,87,+,9827,10075,255;0;0,2,71,150,0,98,9898,9925,27,0
17560ref1,9815,10118,JUNC00000119,721,+,9815,10118,255;0;0,2,105,150,0,153,9920,9968,48,0
27233ref1,594,935,JUNC00000001,622,-,594,935,255;0;0,2,150,150,0,191,744,785,189,0
27233ref1,696,1019,JUNC00000002,355,+,696,1019,255;0;0,2,150,148,0,175,846,871,173,0
27233ref1,775,3184,JUNC00000003,280,-,775,3184,255;0;0,2,150,149,0,2260,925,3035,2258,0
27233ref1,825,1125,JUNC00000004,178,+,825,1125,255;0;0,2,144,149,0,151,969,976,149,0
27233ref1,933,4926,JUNC00000005,103,+,933,4926,255;0;0,2,150,93,0,3900,1083,4833,3898,0
27233ref1,951,1306,JUNC00000006,1433,-,951,1306,255;0;0,2,150,148,0,207,1101,1158,205,0
27233ref1,965,1268,JUNC00000007,2,+,965,1268,255;0;0,2,149,148,0,155,1114,1120,153,0
27233ref1,967,1281,JUNC00000008,2,+,967,1281,255;0;0,2,149,148,0,166,1116,1133,164,0
27233ref1,969,1286,JUNC00000009,3,+,969,1286,255;0;0,2,147,147,0,170,1116,1139,168,0
27233ref1,973,1275,JUNC00000010,5,+,973,1275,255;0;0,2,149,147,0,155,1122,1128,153,0
27233ref1,976,6175,JUNC00000011,23,+,976,6175,255;0;0,2,146,75,0,5124,1122,6100,5122,0
27233ref1,1004,1169,JUNC00000012,48,-,1004,1169,255;0;0,2,146,11,0,154,1150,1158,152,0
27233ref1,1719,1934,JUNC00000013,9,+,1719,1934,255;0;0,2,74,119,0,96,1793,1815,94,0
27233ref1,1709,2036,JUNC00000014,16,-,1709,2036,255;0;0,2,117,124,0,203,1826,1912,201,0
27233ref1,1756,1959,JUNC00000015,1,-,1756,1959,255;0;0,2,104,47,0,156,1860,1912,154,0
27233ref1,1851,2017,JUNC00000016,3,+,1851,2017,255;0;0,2,106,45,0,121,1957,1972,119,0
27233ref1,2342,2661,JUNC00000017,17,+,2342,2661,255;0;0,2,149,149,0,170,2491,2512,168,0
27233ref1,2409,2722,JUNC00000018,3,+,2409,2722,255;0;0,2,122,93,0,220,2531,2629,218,0
27233ref1,2417,2631,JUNC00000019,1,+,2417,2631,255;0;0,2,126,25,0,189,2543,2606,187,0
27233ref1,2441,2788,JUNC00000020,36,+,2441,2788,255;0;0,2,148,150,0,197,2589,2638,195,0
27233ref1,2449,2763,JUNC00000021,5,+,2449,2763,255;0;0,2,149,150,0,164,2598,2613,162,0
27233ref1,2488,2820,JUNC00000022,33,+,2488,2820,255;0;0,2,133,150,0,182,2621,2670,180,0
27233ref1,2656,2990,JUNC00000023,648,+,2656,2990,255;0;0,2,150,150,0,184,2806,2840,182,0
27233ref1,2680,2995,JUNC00000024,547,+,2680,2995,255;0;0,2,150,150,0,165,2830,2845,163,0
27233ref1,2918,3138,JUNC00000025,3,+,2918,3138,255;0;0,2,52,147,0,73,2970,2991,71,0
27233ref1,2884,3214,JUNC00000026,2,+,2884,3214,255;0;0,2,149,128,0,202,3033,3086,200,0
27233ref1,3024,5669,JUNC00000027,344,-,3024,5669,255;0;0,2,149,150,0,2495,3173,5519,2493,0
27233ref1,3209,3434,JUNC00000028,63,-,3209,3434,255;0;0,2,48,150,0,75,3257,3284,73,0
27233ref1,3332,6062,JUNC00000029,2,-,3332,6062,255;0;0,2,100,40,0,2690,3432,6022,2688,0
27233ref1,3532,3939,JUNC00000030,5478,+,3532,3939,255;0;0,2,150,143,0,264,3682,3796,262,0
27233ref1,3729,3973,JUNC00000031,48,-,3729,3973,255;0;0,2,38,147,0,97,3767,3826,95,0
27233ref1,3759,3965,JUNC00000032,328,+,3759,3965,255;0;0,2,27,149,0,57,3786,3816,55,0
27233ref1,3659,3993,JUNC00000033,6,-,3659,3993,255;0;0,2,150,149,0,185,3809,3844,183,0
27233ref1,3846,4060,JUNC00000034,8,+,3846,4060,255;0;0,2,21,150,0,64,3867,3910,62,0
27233ref1,3759,4139,JUNC00000035,17,-,3759,4139,255;0;0,2,150,150,0,230,3909,3989,228,0
27233ref1,3876,4111,JUNC00000036,57,+,3876,4111,255;0;0,2,48,150,0,85,3924,3961,83,0
27233ref1,3829,4125,JUNC00000037,19,+,3829,4125,255;0;0,2,98,149,0,147,3927,3976,145,0
27233ref1,3924,4096,JUNC00000038,162,-,3924,4096,255;0;0,2,11,148,0,24,3935,3948,22,0
27233ref1,3899,4139,JUNC00000039,7,+,3899,4139,255;0;0,2,47,150,0,90,3946,3989,88,0
27233ref1,3797,4141,JUNC00000040,32,+,3797,4141,255;0;0,2,149,150,0,194,3946,3991,192,0
27233ref1,3806,4109,JUNC00000041,19,+,3806,4109,255;0;0,2,148,148,0,155,3954,3961,153,0
27233ref1,3841,4019,JUNC00000042,14,-,3841,4019,255;0;0,2,149,24,0,154,3990,3995,152,0
27233ref1,3960,6578,JUNC00000043,40,+,3960,6578,255;0;0,2,108,150,0,2468,4068,6428,2466,0
27233ref1,3929,4396,JUNC00000044,5,-,3929,4396,255;0;0,2,148,75,0,392,4077,4321,390,0
27233ref1,3953,7559,JUNC00000045,148,-,3953,7559,255;0;0,2,144,150,0,3456,4097,7409,3454,0
27233ref1,3960,5162,JUNC00000046,603,-,3960,5162,255;0;0,2,149,150,0,1052,4109,5012,1050,0
27233ref1,4325,4530,JUNC00000047,3,-,4325,4530,255;0;0,2,27,148,0,57,4352,4382,55,0
27233ref1,4235,4528,JUNC00000048,534,-,4235,4528,255;0;0,2,147,140,0,153,4382,4388,151,0
27233ref1,4888,5065,JUNC00000049,4,-,4888,5065,255;0;0,2,90,61,0,116,4978,5004,114,0
27233ref1,5032,5302,JUNC00000050,2,-,5032,5302,255;0;0,2,98,55,0,215,5130,5247,213,0
27233ref1,5015,5239,JUNC00000051,3,+,5015,5239,255;0;0,2,149,9,0,215,5164,5230,213,0
27233ref1,5956,6184,JUNC00000052,2,+,5956,6184,255;0;0,2,149,74,0,154,6105,6110,152,0
27233ref1,6045,6441,JUNC00000053,22,+,6045,6441,255;0;0,2,147,150,0,246,6192,6291,244,0
27233ref1,6712,6889,JUNC00000054,55,+,6712,6889,255;0;0,2,8,147,0,30,6720,6742,28,0
27233ref1,6601,6980,JUNC00000055,5,+,6601,6980,255;0;0,2,148,149,0,230,6749,6831,228,0
27233ref1,6807,7115,JUNC00000056,3,-,6807,7115,255;0;0,2,144,147,0,161,6951,6968,159,0
27233ref1,6948,7094,JUNC00000057,2,-,6948,7094,255;0;0,2,96,19,0,127,7044,7075,125,0
27233ref1,6906,7158,JUNC00000058,4,-,6906,7158,255;0;0,2,148,73,0,179,7054,7085,177,0
27233ref1,7079,7530,JUNC00000059,3,-,7079,7530,255;0;0,2,22,145,0,306,7101,7385,304,0
27233ref1,6967,7137,JUNC00000060,77,+,6967,7137,255;0;0,2,150,8,0,162,7117,7129,160,0
27233ref1,6988,7170,JUNC00000061,55,+,6988,7170,255;0;0,2,149,28,0,154,7137,7142,152,0
27233ref1,7423,7646,JUNC00000062,80,-,7423,7646,255;0;0,2,150,68,0,155,7573,7578,153,0
27233ref1,7507,8543,JUNC00000063,2,+,7507,8543,255;0;0,2,144,149,0,887,7651,8394,885,0
27233ref1,7725,8027,JUNC00000064,3,-,7725,8027,255;0;0,2,150,147,0,155,7875,7880,153,0
27233ref1,7954,8166,JUNC00000065,24,+,7954,8166,255;0;0,2,8,150,0,62,7962,8016,60,0
27233ref1,7895,8128,JUNC00000066,4,+,7895,8128,255;0;0,2,112,100,0,133,8007,8028,131,0
27233ref1,7962,8197,JUNC00000067,694,-,7962,8197,255;0;0,2,150,68,0,167,8112,8129,165,0
27233ref1,8225,8438,JUNC00000068,2,+,8225,8438,255;0;0,2,149,8,0,205,8374,8430,203,0
27233ref1,8284,8586,JUNC00000069,4,+,8284,8586,255;0;0,2,147,148,0,154,8431,8438,152,0
27233ref1,8296,8603,JUNC00000070,2,+,8296,8603,255;0;0,2,145,149,0,158,8441,8454,156,0
27233ref1,8773,9078,JUNC00000071,612,+,8773,9078,255;0;0,2,150,150,0,155,8923,8928,153,0
27233ref1,9747,10153,JUNC00000072,1,-,9747,10153,255;0;0,2,79,72,0,334,9826,10081,332,0
27233ref1,10018,10234,JUNC00000073,6,+,10018,10234,255;0;0,2,149,22,0,194,10167,10212,192,0
33612ref3,851,10269,JUNC00000030,12,-,851,10269,255;0;0,2,141,127,0,9291,992,10142,9150,0
33612ref3,976,10155,JUNC00000038,74,+,976,10155,255;0;0,2,39,144,0,9035,1015,10011,8996,0
33612ref3,1241,10320,JUNC00000091,27,+,1241,10320,255;0;0,2,145,12,0,9067,1386,10308,8922,0
33612ref3,974,9671,JUNC00000067,1532,+,974,9671,255;0;0,2,148,141,0,8556,1122,9530,8408,0
33612ref3,1767,10318,JUNC00000104,2,+,1767,10318,255;0;0,2,126,25,0,8526,1893,10293,8400,0
33612ref3,1878,10165,JUNC00000112,146,-,1878,10165,255;0;0,2,150,8,0,8279,2028,10157,8129,0
33612ref3,974,9345,JUNC00000066,1495,+,974,9345,255;0;0,2,148,141,0,8230,1122,9204,8082,0
33612ref3,994,9127,JUNC00000037,1,+,994,9127,255;0;0,2,21,130,0,8003,1015,8997,7982,0
33612ref3,1257,9337,JUNC00000081,1,+,1257,9337,255;0;0,2,51,100,0,7980,1308,9237,7929,0
33612ref3,1216,9377,JUNC00000086,10,-,1216,9377,255;0;0,2,147,147,0,8014,1363,9230,7867,0
33612ref3,322,8315,JUNC00000008,113,+,322,8315,255;0;0,2,149,100,0,7893,471,8215,7744,0
33612ref3,1210,9050,JUNC00000077,3,+,1210,9050,255;0;0,2,60,106,0,7734,1270,8944,7674,0
33612ref3,981,8556,JUNC00000069,189,+,981,8556,255;0;0,2,146,10,0,7565,1127,8546,7419,0
33612ref3,1261,8861,JUNC00000080,10,+,1261,8861,255;0;0,2,47,139,0,7461,1308,8722,7414,0
33612ref3,1520,8955,JUNC00000095,2,+,1520,8955,255;0;0,2,33,114,0,7321,1553,8841,7288,0
33612ref3,2148,9623,JUNC00000113,21,-,2148,9623,255;0;0,2,128,78,0,7397,2276,9545,7269,0
33612ref3,295,7738,JUNC00000004,2,+,295,7738,255;0;0,2,125,146,0,7297,420,7592,7172,0
33612ref3,1427,8458,JUNC00000094,2,+,1427,8458,255;0;0,2,121,30,0,7001,1548,8428,6880,0
33612ref3,972,8010,JUNC00000065,10,+,972,8010,255;0;0,2,150,143,0,6895,1122,7867,6745,0
33612ref3,2735,9620,JUNC00000137,1,+,2735,9620,255;0;0,2,46,105,0,6780,2781,9515,6734,0
33612ref3,1027,8036,JUNC00000074,3,-,1027,8036,255;0;0,2,147,145,0,6864,1174,7891,6717,0
33612ref3,974,7853,JUNC00000064,1491,+,974,7853,255;0;0,2,148,142,0,6737,1122,7711,6589,0
33612ref3,1005,7718,JUNC00000036,11,+,1005,7718,255;0;0,2,10,144,0,6569,1015,7574,6559,0
33612ref3,878,7735,JUNC00000040,287,+,878,7735,255;0;0,2,148,150,0,6707,1026,7585,6559,0
33612ref3,2602,9298,JUNC00000134,4,+,2602,9298,255;0;0,2,50,101,0,6595,2652,9197,6545,0
33612ref3,2430,9138,JUNC00000128,5,+,2430,9138,255;0;0,2,148,23,0,6685,2578,9115,6537,0
33612ref3,974,7711,JUNC00000063,18,+,974,7711,255;0;0,2,148,146,0,6591,1122,7565,6443,0
33612ref3,334,6947,JUNC00000003,2,+,334,6947,255;0;0,2,86,144,0,6469,420,6803,6383,0
33612ref3,1123,7611,JUNC00000076,3,+,1123,7611,255;0;0,2,147,103,0,6385,1270,7508,6238,0
33612ref3,2911,9294,JUNC00000144,1,-,2911,9294,255;0;0,2,38,113,0,6270,2949,9181,6232,0
33612ref3,1262,7568,JUNC00000088,2,+,1262,7568,255;0;0,2,119,8,0,6298,1381,7560,6179,0
33612ref3,2883,9326,JUNC00000145,2,+,2883,9326,255;0;0,2,133,148,0,6295,3016,9178,6162,0
33612ref3,3925,10218,JUNC00000167,8,+,3925,10218,255;0;0,2,150,66,0,6227,4075,10152,6077,0
33612ref3,910,7236,JUNC00000043,15,+,910,7236,255;0;0,2,145,147,0,6179,1055,7089,6034,0
33612ref3,2820,8561,JUNC00000142,1,-,2820,8561,255;0;0,2,53,98,0,5643,2873,8463,5590,0
33612ref3,4580,10300,JUNC00000179,3,+,4580,10300,255;0;0,2,141,17,0,5703,4721,10283,5562,0
33612ref3,1776,7562,JUNC00000103,3,+,1776,7562,255;0;0,2,109,144,0,5642,1885,7418,5533,0
33612ref3,976,6738,JUNC00000050,9,+,976,6738,255;0;0,2,119,134,0,5628,1095,6604,5509,0
33612ref3,4715,10355,JUNC00000184,1,+,4715,10355,255;0;0,2,50,101,0,5539,4765,10254,5489,0
33612ref3,2975,8589,JUNC00000147,2,-,2975,8589,255;0;0,2,92,83,0,5531,3067,8506,5439,0
33612ref3,4579,10265,JUNC00000182,8,+,4579,10265,255;0;0,2,145,123,0,5563,4724,10142,5418,0
33612ref3,3293,8922,JUNC00000154,11,+,3293,8922,255;0;0,2,93,147,0,5482,3386,8775,5389,0
33612ref3,2631,8052,JUNC00000136,2,+,2631,8052,255;0;0,2,140,45,0,5376,2771,8007,5236,0
33612ref3,3927,9241,JUNC00000164,2,-,3927,9241,255;0;0,2,63,129,0,5185,3990,9112,5122,0
33612ref3,1045,6236,JUNC00000046,3,-,1045,6236,255;0;0,2,23,146,0,5045,1068,6090,5022,0
33612ref3,973,6195,JUNC00000062,9,+,973,6195,255;0;0,2,149,144,0,5078,1122,6051,4929,0
33612ref3,5230,10248,JUNC00000194,1,-,5230,10248,255;0;0,2,45,106,0,4912,5275,10142,4867,0
33612ref3,1260,6174,JUNC00000085,1,-,1260,6174,255;0;0,2,103,48,0,4866,1363,6126,4763,0
33612ref3,1358,6233,JUNC00000089,2,+,1358,6233,255;0;0,2,25,127,0,4748,1383,6106,4723,0
33612ref3,4203,9182,JUNC00000171,6,-,4203,9182,255;0;0,2,147,150,0,4829,4350,9032,4682,0
33612ref3,896,5754,JUNC00000031,6,-,896,5754,255;0;0,2,111,118,0,4740,1007,5636,4629,0
33612ref3,1855,6702,JUNC00000109,9,+,1855,6702,255;0;0,2,149,149,0,4698,2004,6553,4549,0
33612ref3,4437,9088,JUNC00000174,1,-,4437,9088,255;0;0,2,62,89,0,4562,4499,8999,4500,0
33612ref3,974,5670,JUNC00000061,1498,+,974,5670,255;0;0,2,148,83,0,4613,1122,5587,4465,0
33612ref3,3313,8064,JUNC00000157,46,-,3313,8064,255;0;0,2,143,148,0,4603,3456,7916,4460,0
33612ref3,4529,9082,JUNC00000176,14,+,4529,9082,255;0;0,2,37,142,0,4411,4566,8940,4374,0
33612ref3,4773,9130,JUNC00000186,5,-,4773,9130,255;0;0,2,52,143,0,4214,4825,8987,4162,0
33612ref3,4641,8947,JUNC00000178,3,+,4641,8947,255;0;0,2,24,127,0,4179,4665,8820,4155,0
33612ref3,4759,9102,JUNC00000185,23,+,4759,9102,255;0;0,2,50,146,0,4197,4809,8956,4147,0
33612ref3,5868,10182,JUNC00000200,20,+,5868,10182,255;0;0,2,144,27,0,4287,6012,10155,4143,0
33612ref3,1857,6115,JUNC00000105,1,-,1857,6115,255;0;0,2,124,27,0,4231,1981,6088,4107,0
33612ref3,1857,6252,JUNC00000110,6,+,1857,6252,255;0;0,2,150,149,0,4246,2007,6103,4096,0
33612ref3,6025,10263,JUNC00000205,5,+,6025,10263,255;0;0,2,146,9,0,4229,6171,10254,4083,0
33612ref3,3332,7645,JUNC00000158,26,+,3332,7645,255;0;0,2,149,117,0,4196,3481,7528,4047,0
33612ref3,979,5173,JUNC00000068,124,+,979,5173,255;0;0,2,148,9,0,4185,1127,5164,4037,0
33612ref3,1045,5242,JUNC00000045,4,-,1045,5242,255;0;0,2,23,145,0,4052,1068,5097,4029,0
33612ref3,3781,8034,JUNC00000159,229,+,3781,8034,255;0;0,2,77,149,0,4104,3858,7885,4027,0
33612ref3,446,4622,JUNC00000014,2,-,446,4622,255;0;0,2,149,34,0,4142,595,4588,3993,0
33612ref3,974,5113,JUNC00000060,13,+,974,5113,255;0;0,2,148,72,0,4067,1122,5041,3919,0
33612ref3,602,4701,JUNC00000019,8,+,602,4701,255;0;0,2,128,146,0,3953,730,4555,3825,0
33612ref3,464,4568,JUNC00000016,5,+,464,4568,255;0;0,2,149,150,0,3954,613,4418,3805,0
33612ref3,1261,5146,JUNC00000084,1,-,1261,5146,255;0;0,2,102,49,0,3836,1363,5097,3734,0
33612ref3,4790,8651,JUNC00000187,6,+,4790,8651,255;0;0,2,52,105,0,3756,4842,8546,3704,0
33612ref3,6251,10069,JUNC00000213,3,+,6251,10069,255;0;0,2,51,99,0,3719,6302,9970,3668,0
33612ref3,3996,7802,JUNC00000165,2,+,3996,7802,255;0;0,2,45,106,0,3700,4041,7696,3655,0
33612ref3,974,4911,JUNC00000059,1668,+,974,4911,255;0;0,2,148,146,0,3791,1122,4765,3643,0
33612ref3,2501,6243,JUNC00000123,1,+,2501,6243,255;0;0,2,42,92,0,3650,2543,6151,3608,0
33612ref3,1942,5647,JUNC00000106,3,+,1942,5647,255;0;0,2,42,60,0,3645,1984,5587,3603,0
33612ref3,2434,6270,JUNC00000127,3,+,2434,6270,255;0;0,2,144,89,0,3747,2578,6181,3603,0
33612ref3,1077,4944,JUNC00000075,11,+,1077,4944,255;0;0,2,147,135,0,3732,1224,4809,3585,0
33612ref3,1446,5160,JUNC00000097,3,+,1446,5160,255;0;0,2,149,138,0,3576,1595,5022,3427,0
33612ref3,6582,10275,JUNC00000218,2,-,6582,10275,255;0;0,2,147,149,0,3544,6729,10126,3397,0
33612ref3,506,4060,JUNC00000013,16,-,506,4060,255;0;0,2,80,150,0,3404,586,3910,3324,0
33612ref3,4268,7764,JUNC00000170,3,-,4268,7764,255;0;0,2,29,150,0,3346,4297,7614,3317,0
33612ref3,1003,4466,JUNC00000035,17,+,1003,4466,255;0;0,2,12,145,0,3318,1015,4321,3306,0
33612ref3,4578,8067,JUNC00000177,3,+,4578,8067,255;0;0,2,87,145,0,3344,4665,7922,3257,0
33612ref3,2669,6057,JUNC00000139,29,-,2669,6057,255;0;0,2,147,35,0,3353,2816,6022,3206,0
33612ref3,2629,6076,JUNC00000135,22,+,2629,6076,255;0;0,2,142,133,0,3314,2771,5943,3172,0
33612ref3,2436,5827,JUNC00000129,4,+,2436,5827,255;0;0,2,148,149,0,3242,2584,5678,3094,0
33612ref3,4484,7702,JUNC00000175,4,-,4484,7702,255;0;0,2,71,146,0,3072,4555,7556,3001,0
33612ref3,3126,6181,JUNC00000148,2,+,3126,6181,255;0;0,2,10,75,0,2980,3136,6106,2970,0
33612ref3,6110,9300,JUNC00000208,2,+,6110,9300,255;0;0,2,96,149,0,3041,6206,9151,2945,0
33612ref3,976,4098,JUNC00000058,10,+,976,4098,255;0;0,2,146,124,0,2998,1122,3974,2852,0
33612ref3,962,4111,JUNC00000056,31,+,962,4111,255;0;0,2,149,150,0,2999,1111,3961,2850,0
33612ref3,6133,9238,JUNC00000211,3,+,6133,9238,255;0;0,2,122,150,0,2955,6255,9088,2833,0
33612ref3,6057,9125,JUNC00000204,8,+,6057,9125,255;0;0,2,114,148,0,2920,6171,8977,2806,0
33612ref3,3317,6250,JUNC00000153,1,+,3317,6250,255;0;0,2,69,69,0,2864,3386,6181,2795,0
33612ref3,2240,5140,JUNC00000115,13,+,2240,5140,255;0;0,2,145,27,0,2873,2385,5113,2728,0
33612ref3,1032,3919,JUNC00000048,2,+,1032,3919,255;0;0,2,51,123,0,2764,1083,3796,2713,0
33612ref3,3361,6201,JUNC00000156,14,+,3361,6201,255;0;0,2,33,144,0,2696,3394,6057,2663,0
33612ref3,4579,7460,JUNC00000181,15,+,4579,7460,255;0;0,2,145,75,0,2806,4724,7385,2661,0
33612ref3,322,3210,JUNC00000007,110,+,322,3210,255;0;0,2,149,102,0,2786,471,3108,2637,0
33612ref3,5022,7867,JUNC00000188,2,-,5022,7867,255;0;0,2,75,145,0,2700,5097,7722,2625,0
33612ref3,5005,7849,JUNC00000193,16,+,5005,7849,255;0;0,2,146,150,0,2694,5151,7699,2548,0
33612ref3,7789,10460,JUNC00000239,1,+,7789,10460,255;0;0,2,68,83,0,2588,7857,10377,2520,0
33612ref3,512,3032,JUNC00000012,23,+,512,3032,255;0;0,2,59,148,0,2372,571,2884,2313,0
33612ref3,6603,9089,JUNC00000219,15,+,6603,9089,255;0;0,2,146,112,0,2374,6749,8977,2228,0
33612ref3,5712,8056,JUNC00000196,1,-,5712,8056,255;0;0,2,21,130,0,2214,5733,7926,2193,0
33612ref3,331,2782,JUNC00000009,2172,-,331,2782,255;0;0,2,150,149,0,2302,481,2633,2152,0
33612ref3,323,2664,JUNC00000006,99,+,323,2664,255;0;0,2,148,147,0,2194,471,2517,2046,0
33612ref3,923,3192,JUNC00000034,11,+,923,3192,255;0;0,2,92,145,0,2124,1015,3047,2032,0
33612ref3,1850,4177,JUNC00000107,4,-,1850,4177,255;0;0,2,145,150,0,2177,1995,4027,2032,0
33612ref3,907,3026,JUNC00000039,2,+,907,3026,255;0;0,2,114,37,0,2082,1021,2989,1968,0
33612ref3,933,3148,JUNC00000047,7,+,933,3148,255;0;0,2,150,150,0,2065,1083,2998,1915,0
33612ref3,7551,9637,JUNC00000232,12,+,7551,9637,255;0;0,2,148,50,0,2036,7699,9587,1888,0
33612ref3,973,3143,JUNC00000057,56,+,973,3143,255;0;0,2,149,145,0,2025,1122,2998,1876,0
33612ref3,6994,9103,JUNC00000221,29,+,6994,9103,255;0;0,2,101,147,0,1962,7095,8956,1861,0
33612ref3,3047,5047,JUNC00000150,35,+,3047,5047,255;0;0,2,149,25,0,1975,3196,5022,1826,0
33612ref3,2404,4351,JUNC00000118,8,-,2404,4351,255;0;0,2,29,148,0,1799,2433,4203,1770,0
33612ref3,8385,10302,JUNC00000250,1,+,8385,10302,255;0;0,2,103,48,0,1869,8488,10254,1766,0
33612ref3,7089,9125,JUNC00000222,189,+,7089,9125,255;0;0,2,144,148,0,1888,7233,8977,1744,0
33612ref3,6616,8504,JUNC00000217,2,-,6616,8504,255;0;0,2,41,110,0,1778,6657,8394,1737,0
33612ref3,2658,4665,JUNC00000138,6,+,2658,4665,255;0;0,2,148,149,0,1858,2806,4516,1710,0
33612ref3,3294,5194,JUNC00000155,3,+,3294,5194,255;0;0,2,100,142,0,1758,3394,5052,1658,0
33612ref3,1037,2802,JUNC00000044,6,+,1037,2802,255;0;0,2,23,150,0,1615,1060,2652,1592,0
33612ref3,6033,7845,JUNC00000206,10,+,6033,7845,255;0;0,2,148,146,0,1666,6181,7699,1518,0
33612ref3,5071,6712,JUNC00000191,1,-,5071,6712,255;0;0,2,59,92,0,1549,5130,6620,1490,0
33612ref3,6189,7827,JUNC00000214,4,+,6189,7827,255;0;0,2,116,35,0,1603,6305,7792,1487,0
33612ref3,890,2577,JUNC00000041,2,+,890,2577,255;0;0,2,148,89,0,1598,1038,2488,1450,0
33612ref3,6140,7811,JUNC00000209,7,+,6140,7811,255;0;0,2,109,150,0,1521,6249,7661,1412,0
33612ref3,1163,2835,JUNC00000078,12,-,1163,2835,255;0;0,2,117,145,0,1527,1280,2690,1410,0
33612ref3,4716,6263,JUNC00000180,3,+,4716,6263,255;0;0,2,8,147,0,1400,4724,6116,1392,0
33612ref3,1274,2814,JUNC00000079,1,+,1274,2814,255;0;0,2,34,117,0,1423,1308,2697,1389,0
33612ref3,4189,5682,JUNC00000169,1,-,4189,5682,255;0;0,2,108,43,0,1450,4297,5639,1342,0
33612ref3,910,2541,JUNC00000042,10,+,910,2541,255;0;0,2,145,148,0,1483,1055,2393,1338,0
33612ref3,6223,7616,JUNC00000212,2,+,6223,7616,255;0;0,2,79,104,0,1289,6302,7512,1210,0
33612ref3,6287,7643,JUNC00000215,4,+,6287,7643,255;0;0,2,25,121,0,1235,6312,7522,1210,0
33612ref3,8914,10240,JUNC00000258,1,+,8914,10240,255;0;0,2,63,88,0,1238,8977,10152,1175,0
33612ref3,7661,9101,JUNC00000235,7,+,7661,9101,255;0;0,2,149,145,0,1295,7810,8956,1146,0
33612ref3,7766,9063,JUNC00000237,3,+,7766,9063,255;0;0,2,74,77,0,1220,7840,8986,1146,0
33612ref3,7789,8953,JUNC00000236,2,+,7789,8953,255;0;0,2,24,124,0,1040,7813,8829,1016,0
33612ref3,5062,6227,JUNC00000190,1,-,5062,6227,255;0;0,2,68,83,0,1082,5130,6144,1014,0
33612ref3,4983,6163,JUNC00000189,3,-,4983,6163,255;0;0,2,147,73,0,1107,5130,6090,960,0
33612ref3,7894,9124,JUNC00000242,44,+,7894,9124,255;0;0,2,146,147,0,1083,8040,8977,937,0
33612ref3,1432,2598,JUNC00000093,26,+,1432,2598,255;0;0,2,116,144,0,1022,1548,2454,906,0
33612ref3,9048,10091,JUNC00000262,1,-,9048,10091,255;0;0,2,30,121,0,922,9078,9970,892,0
33612ref3,9241,10228,JUNC00000268,2,+,9241,10228,255;0;0,2,56,95,0,892,9297,10133,836,0
33612ref3,1873,2994,JUNC00000111,9,+,1873,2994,255;0;0,2,150,149,0,972,2023,2845,822,0
33612ref3,7862,8962,JUNC00000241,2,+,7862,8962,255;0;0,2,145,142,0,958,8007,8820,813,0
33612ref3,2498,3379,JUNC00000122,1,+,2498,3379,255;0;0,2,21,130,0,751,2519,3249,730,0
33612ref3,226,1235,JUNC00000002,2,+,226,1235,255;0;0,2,149,145,0,864,375,1090,715,0
33612ref3,1709,2560,JUNC00000100,16,+,1709,2560,255;0;0,2,84,142,0,709,1793,2418,625,0
33612ref3,9543,10266,JUNC00000270,2656,-,9543,10266,255;0;0,2,24,149,0,574,9567,10117,550,0
33612ref3,8328,9066,JUNC00000248,3,-,8328,9066,255;0;0,2,46,149,0,589,8374,8917,543,0
33612ref3,410,1125,JUNC00000005,168,+,410,1125,255;0;0,2,25,149,0,566,435,976,541,0
33612ref3,6819,7556,JUNC00000220,70,-,6819,7556,255;0;0,2,73,138,0,599,6892,7418,526,0
33612ref3,408,1113,JUNC00000010,5,-,408,1113,255;0;0,2,94,96,0,609,502,1017,515,0
33612ref3,8617,9242,JUNC00000251,2,+,8617,9242,255;0;0,2,57,94,0,531,8674,9148,474,0
33612ref3,7523,8106,JUNC00000228,22,+,7523,8106,255;0;0,2,93,62,0,521,7616,8044,428,0
33612ref3,2289,2817,JUNC00000116,2,-,2289,2817,255;0;0,2,107,44,0,484,2396,2773,377,0
33612ref3,9601,10106,JUNC00000271,1,+,9601,10106,255;0;0,2,38,113,0,392,9639,9993,354,0
33612ref3,923,1452,JUNC00000033,15,+,923,1452,255;0;0,2,92,144,0,385,1015,1308,293,0
33612ref3,8738,9182,JUNC00000252,4,-,8738,9182,255;0;0,2,9,142,0,302,8747,9040,293,0
33612ref3,596,1164,JUNC00000020,10,+,596,1164,255;0;0,2,142,149,0,419,738,1015,277,0
33612ref3,3925,4407,JUNC00000166,21,+,3925,4407,255;0;0,2,150,78,0,404,4075,4329,254,0
33612ref3,2353,2852,JUNC00000121,8,+,2353,2852,255;0;0,2,148,127,0,372,2501,2725,224,0
33612ref3,4246,4656,JUNC00000172,3,+,4246,4656,255;0;0,2,132,71,0,339,4378,4585,207,0
33612ref3,4301,4658,JUNC00000173,1,-,4301,4658,255;0;0,2,81,70,0,287,4382,4588,206,0
33612ref3,8816,9289,JUNC00000257,8,+,8816,9289,255;0;0,2,149,148,0,325,8965,9141,176,0
33612ref3,8827,9238,JUNC00000254,444,+,8827,9238,255;0;0,2,94,150,0,261,8921,9088,167,0
33612ref3,8803,9233,JUNC00000253,2033,+,8803,9233,255;0;0,2,118,150,0,280,8921,9083,162,0
33612ref3,1031,1338,JUNC00000073,2,-,1031,1338,255;0;0,2,143,8,0,299,1174,1330,156,0
33612ref3,610,969,JUNC00000018,25,+,610,969,255;0;0,2,64,143,0,216,674,826,152,0
33612ref3,7400,7705,JUNC00000225,4,-,7400,7705,255;0;0,2,9,145,0,160,7409,7560,151,0
33612ref3,2476,2776,JUNC00000120,5,+,2476,2776,255;0;0,2,25,147,0,153,2501,2629,128,0
33612ref3,7776,8052,JUNC00000240,1,+,7776,8052,255;0;0,2,140,8,0,268,7916,8044,128,0
33612ref3,8810,9238,JUNC00000256,2,+,8810,9238,255;0;0,2,150,150,0,278,8960,9088,128,0
33612ref3,2346,2763,JUNC00000119,7,-,2346,2763,255;0;0,2,147,147,0,270,2493,2616,123,0
33612ref3,500,771,JUNC00000011,1,+,500,771,255;0;0,2,71,80,0,191,571,691,120,0
33612ref3,1422,1708,JUNC00000092,15,+,1422,1708,255;0;0,2,43,143,0,143,1465,1565,100,0
33612ref3,1218,1610,JUNC00000087,2,-,1218,1610,255;0;0,2,149,147,0,245,1367,1463,96,0
33612ref3,2394,2700,JUNC00000124,317,-,2394,2700,255;0;0,2,150,64,0,242,2544,2636,92,0
33612ref3,1814,2053,JUNC00000101,3,-,1814,2053,255;0;0,2,12,141,0,98,1826,1912,86,0
33612ref3,7211,7417,JUNC00000223,1,-,7211,7417,255;0;0,2,90,35,0,171,7301,7382,81,0
33612ref3,3761,4137,JUNC00000162,2,-,3761,4137,255;0;0,2,148,148,0,228,3909,3989,80,0
33612ref3,726,1005,JUNC00000021,20,-,726,1005,255;0;0,2,59,145,0,134,785,860,75,0
33612ref3,658,880,JUNC00000017,63,+,658,880,255;0;0,2,16,135,0,87,674,745,71,0
33612ref3,6078,6300,JUNC00000207,1,+,6078,6300,255;0;0,2,128,23,0,199,6206,6277,71,0
33612ref3,8928,9242,JUNC00000260,13,+,8928,9242,255;0;0,2,95,148,0,166,9023,9094,71,0
33612ref3,3927,4204,JUNC00000163,3,-,3927,4204,255;0;0,2,63,147,0,130,3990,4057,67,0
33612ref3,2468,2831,JUNC00000133,7,-,2468,2831,255;0;0,2,148,150,0,213,2616,2681,65,0
33612ref3,2167,2528,JUNC00000114,5,+,2167,2528,255;0;0,2,149,148,0,213,2316,2380,64,0
33612ref3,10046,10262,JUNC00000275,6,+,10046,10262,255;0;0,2,146,8,0,208,10192,10254,62,0
33612ref3,472,685,JUNC00000015,3,+,472,685,255;0;0,2,141,11,0,202,613,674,61,0
33612ref3,951,1213,JUNC00000053,32,-,951,1213,255;0;0,2,148,55,0,207,1099,1158,59,0
33612ref3,953,1285,JUNC00000054,2404,-,953,1285,255;0;0,2,148,127,0,205,1101,1158,57,0
33612ref3,5681,6009,JUNC00000198,14,+,5681,6009,255;0;0,2,149,125,0,203,5830,5884,54,0
33612ref3,825,1171,JUNC00000029,73,+,825,1171,255;0;0,2,144,149,0,197,969,1022,53,0
33612ref3,9021,9231,JUNC00000261,107,+,9021,9231,255;0;0,2,9,148,0,62,9030,9083,53,0
33612ref3,1740,1943,JUNC00000102,1,-,1740,1943,255;0;0,2,120,31,0,172,1860,1912,52,0
33612ref3,2437,2716,JUNC00000125,8,+,2437,2716,255;0;0,2,128,103,0,176,2565,2613,48,0
33612ref3,8063,8324,JUNC00000245,14,+,8063,8324,255;0;0,2,66,148,0,113,8129,8176,47,0
33612ref3,7386,7582,JUNC00000226,1,-,7386,7582,255;0;0,2,125,26,0,170,7511,7556,45,0
33612ref3,8928,9179,JUNC00000259,3,+,8928,9179,255;0;0,2,65,142,0,109,8993,9037,44,0
33612ref3,956,1150,JUNC00000052,10,-,956,1150,255;0;0,2,143,8,0,186,1099,1142,43,0
33612ref3,976,1133,JUNC00000032,9,+,976,1133,255;0;0,2,39,78,0,79,1015,1055,40,0
33612ref3,949,1287,JUNC00000051,326,-,949,1287,255;0;0,2,150,148,0,190,1099,1139,40,0
33612ref3,5589,5923,JUNC00000197,42,+,5589,5923,255;0;0,2,147,148,0,186,5736,5775,39,0
33612ref3,7512,7849,JUNC00000230,15,+,7512,7849,255;0;0,2,148,150,0,187,7660,7699,39,0
33612ref3,2680,3011,JUNC00000141,2,+,2680,3011,255;0;0,2,150,145,0,186,2830,2866,36,0
33612ref3,7513,7716,JUNC00000229,4,+,7513,7716,255;0;0,2,147,20,0,183,7660,7696,36,0
33612ref3,9008,9341,JUNC00000264,89,-,9008,9341,255;0;0,2,150,147,0,186,9158,9194,36,0
33612ref3,2444,2776,JUNC00000130,6,-,2444,2776,255;0;0,2,150,147,0,185,2594,2629,35,0
33612ref3,2448,2782,JUNC00000132,2510,-,2448,2782,255;0;0,2,150,149,0,185,2598,2633,35,0
33612ref3,945,1276,JUNC00000049,15,+,945,1276,255;0;0,2,150,148,0,183,1095,1128,33,0
33612ref3,5530,5780,JUNC00000195,151,-,5530,5780,255;0;0,2,70,147,0,103,5600,5633,33,0
33612ref3,729,1058,JUNC00000024,12,+,729,1058,255;0;0,2,149,148,0,181,878,910,32,0
33612ref3,7652,7834,JUNC00000233,2,+,7652,7834,255;0;0,2,89,62,0,120,7741,7772,31,0
33612ref3,7383,7712,JUNC00000227,9,-,7383,7712,255;0;0,2,149,150,0,179,7532,7562,30,0
33612ref3,6105,6432,JUNC00000210,8,+,6105,6432,255;0;0,2,150,148,0,179,6255,6284,29,0
33612ref3,1519,1842,JUNC00000098,2,+,1519,1842,255;0;0,2,149,146,0,177,1668,1696,28,0
33612ref3,2879,2929,JUNC00000143,1,-,2879,2929,255;0;0,2,12,10,0,40,2891,2919,28,0
33612ref3,3183,3433,JUNC00000151,45,-,3183,3433,255;0;0,2,74,149,0,101,3257,3284,27,0
33612ref3,3788,4043,JUNC00000160,40,+,3788,4043,255;0;0,2,79,149,0,106,3867,3894,27,0
33612ref3,7704,7895,JUNC00000238,11,-,7704,7895,255;0;0,2,144,20,0,171,7848,7875,27,0
33612ref3,976,1287,JUNC00000055,5,+,976,1287,255;0;0,2,135,150,0,161,1111,1137,26,0
33612ref3,3022,3212,JUNC00000149,61,+,3022,3212,255;0;0,2,149,16,0,174,3171,3196,25,0
33612ref3,5876,6025,JUNC00000199,9,-,5876,6025,255;0;0,2,98,26,0,123,5974,5999,25,0
33612ref3,1187,1506,JUNC00000082,3,-,1187,1506,255;0;0,2,150,145,0,174,1337,1361,24,0
33612ref3,3749,4042,JUNC00000161,34,+,3749,4042,255;0;0,2,121,148,0,145,3870,3894,24,0
33612ref3,9385,9668,JUNC00000269,24,+,9385,9668,255;0;0,2,121,138,0,145,9506,9530,24,0
33612ref3,2918,3239,JUNC00000146,2,-,2918,3239,255;0;0,2,149,149,0,172,3067,3090,23,0
33612ref3,2419,2734,JUNC00000126,8,-,2419,2734,255;0;0,2,147,148,0,167,2566,2586,20,0
33612ref3,8239,8410,JUNC00000247,1,+,8239,8410,255;0;0,2,41,110,0,61,8280,8300,20,0
33612ref3,7315,7485,JUNC00000224,1,-,7315,7485,255;0;0,2,75,76,0,94,7390,7409,19,0
33612ref3,743,995,JUNC00000022,16,+,743,995,255;0;0,2,89,145,0,107,832,850,18,0
33612ref3,4741,4910,JUNC00000183,1,+,4741,4910,255;0;0,2,24,127,0,42,4765,4783,18,0
33612ref3,6043,6196,JUNC00000202,4,-,6043,6196,255;0;0,2,83,52,0,101,6126,6144,18,0
33612ref3,7963,8261,JUNC00000243,45,-,7963,8261,255;0;0,2,149,132,0,166,8112,8129,17,0
33612ref3,9028,9341,JUNC00000265,5,+,9028,9341,255;0;0,2,146,150,0,163,9174,9191,17,0
33612ref3,9520,9830,JUNC00000272,8,+,9520,9830,255;0;0,2,145,148,0,162,9665,9682,17,0
33612ref3,907,1135,JUNC00000028,169,+,907,1135,255;0;0,2,62,150,0,78,969,985,16,0
33612ref3,7966,8281,JUNC00000244,14,-,7966,8281,255;0;0,2,149,150,0,165,8115,8131,16,0
33612ref3,999,1195,JUNC00000070,2,+,999,1195,255;0;0,2,149,32,0,164,1148,1163,15,0
33612ref3,1283,1508,JUNC00000083,4,-,1283,1508,255;0;0,2,60,150,0,75,1343,1358,15,0
33612ref3,2448,2763,JUNC00000131,40,+,2448,2763,255;0;0,2,150,150,0,165,2598,2613,15,0
33612ref3,2680,2994,JUNC00000140,6,+,2680,2994,255;0;0,2,150,149,0,165,2830,2845,15,0
33612ref3,3297,3475,JUNC00000152,2,+,3297,3475,255;0;0,2,65,99,0,79,3362,3376,14,0
33612ref3,4236,4418,JUNC00000168,10,+,4236,4418,255;0;0,2,21,147,0,35,4257,4271,14,0
33612ref3,8954,9138,JUNC00000263,26,+,8954,9138,255;0;0,2,147,23,0,161,9101,9115,14,0
33612ref3,7630,7846,JUNC00000234,9,+,7630,7846,255;0;0,2,149,54,0,162,7779,7792,13,0
33612ref3,6077,6314,JUNC00000203,22,+,6077,6314,255;0;0,2,78,147,0,90,6155,6167,12,0
33612ref3,218,380,JUNC00000001,1,+,218,380,255;0;0,2,126,25,0,137,344,355,11,0
33612ref3,826,1026,JUNC00000023,5,+,826,1026,255;0;0,2,41,148,0,52,867,878,11,0
33612ref3,8211,8350,JUNC00000246,4,-,8211,8350,255;0;0,2,28,100,0,39,8239,8250,11,0
33612ref3,798,1099,JUNC00000026,110,-,798,1099,255;0;0,2,145,146,0,155,943,953,10,0
33612ref3,1238,1544,JUNC00000090,11,-,1238,1544,255;0;0,2,148,149,0,157,1386,1395,9,0
33612ref3,6596,6734,JUNC00000216,2,-,6596,6734,255;0;0,2,33,96,0,42,6629,6638,9,0
33612ref3,9030,9199,JUNC00000266,10,+,9030,9199,255;0;0,2,149,11,0,158,9179,9188,9,0
33612ref3,10075,10281,JUNC00000274,3,-,10075,10281,255;0;0,2,50,147,0,59,10125,10134,9,0
33612ref3,786,1067,JUNC00000025,22,-,786,1067,255;0;0,2,123,150,0,131,909,917,8,0
33612ref3,1001,1271,JUNC00000072,1093,-,1001,1271,255;0;0,2,149,113,0,157,1150,1158,8,0
33612ref3,1708,1867,JUNC00000099,1,+,1708,1867,255;0;0,2,43,108,0,51,1751,1759,8,0
33612ref3,1856,2031,JUNC00000108,10,+,1856,2031,255;0;0,2,148,19,0,156,2004,2012,8,0
33612ref3,5927,6111,JUNC00000201,2,+,5927,6111,255;0;0,2,131,45,0,139,6058,6066,8,0
33612ref3,9920,10079,JUNC00000273,1,+,9920,10079,255;0;0,2,73,78,0,81,9993,10001,8,0
33612ref3,823,1126,JUNC00000027,9315,+,823,1126,255;0;0,2,146,150,0,153,969,976,7,0
33612ref3,7540,7845,JUNC00000231,11,+,7540,7845,255;0;0,2,149,149,0,156,7689,7696,7,0
33612ref3,8284,8586,JUNC00000249,15,+,8284,8586,255;0;0,2,147,148,0,154,8431,8438,7,0
33612ref3,1001,1300,JUNC00000071,6,-,1001,1300,255;0;0,2,149,145,0,154,1150,1155,5,0
33612ref3,1437,1612,JUNC00000096,5,+,1437,1612,255;0;0,2,149,21,0,154,1586,1591,5,0
33612ref3,2356,2559,JUNC00000117,10,-,2356,2559,255;0;0,2,50,148,0,55,2406,2411,5,0
33612ref3,5024,5180,JUNC00000192,1,+,5024,5180,255;0;0,2,118,33,0,123,5142,5147,5,0
33612ref3,8797,9078,JUNC00000255,23696,+,8797,9078,255;0;0,2,126,150,0,131,8923,8928,5,0
33612ref3,9049,9205,JUNC00000267,1,+,9049,9205,255;0;0,2,143,8,0,148,9192,9197,5,0
31689ref2,1881,10085,JUNC00000013,3,+,1881,10085,255;0;0,2,69,84,0,8120,1950,10001,8051,0
31689ref2,1264,9333,JUNC00000011,2,+,1264,9333,255;0;0,2,44,96,0,7973,1308,9237,7929,0
31689ref2,200,7900,JUNC00000001,1,+,200,7900,255;0;0,2,124,27,0,7673,324,7873,7549,0
31689ref2,2264,7881,JUNC00000014,1,+,2264,7881,255;0;0,2,121,8,0,5609,2385,7873,5488,0
31689ref2,2520,7814,JUNC00000017,2,+,2520,7814,255;0;0,2,58,115,0,5179,2578,7699,5121,0
31689ref2,4903,9080,JUNC00000022,2,-,4903,9080,255;0;0,2,53,88,0,4089,4956,8992,4036,0
31689ref2,599,4575,JUNC00000004,2,+,599,4575,255;0;0,2,131,20,0,3956,730,4555,3825,0
31689ref2,4175,8006,JUNC00000020,1,+,4175,8006,255;0;0,2,29,100,0,3731,4204,7906,3702,0
31689ref2,5102,8537,JUNC00000024,2,+,5102,8537,255;0;0,2,62,109,0,3326,5164,8428,3264,0
31689ref2,2322,5499,JUNC00000015,2,+,2322,5499,255;0;0,2,148,50,0,3127,2470,5449,2979,0
31689ref2,763,3299,JUNC00000007,2,+,763,3299,255;0;0,2,115,27,0,2509,878,3272,2394,0
31689ref2,789,3341,JUNC00000006,3,+,789,3341,255;0;0,2,43,145,0,2407,832,3196,2364,0
31689ref2,861,2991,JUNC00000008,2,-,861,2991,255;0;0,2,104,124,0,2006,965,2867,1902,0
31689ref2,310,2227,JUNC00000002,4,+,310,2227,255;0;0,2,144,82,0,1835,454,2145,1691,0
31689ref2,7748,8930,JUNC00000028,4,+,7748,8930,255;0;0,2,65,101,0,1081,7813,8829,1016,0
31689ref2,7778,8959,JUNC00000029,2,+,7778,8959,255;0;0,2,47,118,0,1063,7825,8841,1016,0
31689ref2,5083,5752,JUNC00000023,2,-,5083,5752,255;0;0,2,47,81,0,588,5130,5671,541,0
31689ref2,1598,2029,JUNC00000012,1,+,1598,2029,255;0;0,2,45,106,0,325,1643,1923,280,0
31689ref2,649,983,JUNC00000005,1,-,649,983,255;0;0,2,121,30,0,304,770,953,183,0
31689ref2,2442,2743,JUNC00000016,1,+,2442,2743,255;0;0,2,123,28,0,273,2565,2715,150,0
31689ref2,526,762,JUNC00000003,1,+,526,762,255;0;0,2,8,143,0,93,534,619,85,0
31689ref2,7840,8076,JUNC00000030,1,+,7840,8076,255;0;0,2,82,69,0,167,7922,8007,85,0
31689ref2,6878,7071,JUNC00000026,1,+,6878,7071,255;0;0,2,99,32,0,161,6977,7039,62,0
31689ref2,8619,8825,JUNC00000032,1,+,8619,8825,255;0;0,2,55,96,0,110,8674,8729,55,0
31689ref2,2505,2705,JUNC00000018,1,+,2505,2705,255;0;0,2,116,35,0,165,2621,2670,49,0
31689ref2,958,1280,JUNC00000009,3,-,958,1280,255;0;0,2,143,147,0,175,1101,1133,32,0
31689ref2,3046,3227,JUNC00000019,1,-,3046,3227,255;0;0,2,125,26,0,155,3171,3201,30,0
31689ref2,4239,4396,JUNC00000021,2,+,4239,4396,255;0;0,2,18,125,0,32,4257,4271,14,0
31689ref2,6880,7016,JUNC00000025,2,-,6880,7016,255;0;0,2,60,66,0,70,6940,6950,10,0
31689ref2,8284,8483,JUNC00000031,2,+,8284,8483,255;0;0,2,147,45,0,154,8431,8438,7,0
31689ref2,979,1142,JUNC00000010,394,-,979,1142,255;0;0,2,149,9,0,154,1128,1133,5,0
31689ref2,7090,7246,JUNC00000027,1,+,7090,7246,255;0;0,2,47,104,0,52,7137,7142,5,0
31689ref2,8773,9078,JUNC00000033,717,+,8773,9078,255;0;0,2,150,150,0,155,8923,8928,5,0
18925ref,389,10284,JUNC00000024,2,+,389,10284,255;0;0,2,82,69,0,9826,471,10215,9744,0
18925ref,789,10388,JUNC00000084,3,+,789,10388,255;0;0,2,149,150,0,9449,938,10238,9300,0
18925ref,975,10399,JUNC00000176,124,+,975,10399,255;0;0,2,147,145,0,9279,1122,10254,9132,0
18925ref,969,10224,JUNC00000157,6,+,969,10224,255;0;0,2,142,9,0,9246,1111,10215,9104,0
18925ref,336,9569,JUNC00000005,1,+,336,9569,255;0;0,2,32,118,0,9115,368,9451,9083,0
18925ref,379,9551,JUNC00000031,16,+,379,9551,255;0;0,2,147,21,0,9151,526,9530,9004,0
18925ref,422,9639,JUNC00000037,9,-,422,9639,255;0;0,2,149,148,0,9069,571,9491,8920,0
18925ref,999,10031,JUNC00000189,12,+,999,10031,255;0;0,2,149,48,0,8984,1148,9983,8835,0
18925ref,305,9269,JUNC00000011,38,+,305,9269,255;0;0,2,149,49,0,8915,454,9220,8766,0
18925ref,331,9393,JUNC00000027,2186,+,331,9393,255;0;0,2,150,146,0,8916,481,9247,8766,0
18925ref,349,9246,JUNC00000004,3,+,349,9246,255;0;0,2,19,149,0,8748,368,9097,8729,0
18925ref,1165,10027,JUNC00000214,6,+,1165,10027,255;0;0,2,143,44,0,8818,1308,9983,8675,0
18925ref,185,9099,JUNC00000003,16,+,185,9099,255;0;0,2,148,150,0,8764,333,8949,8616,0
18925ref,913,9656,JUNC00000129,7,+,913,9656,255;0;0,2,142,10,0,8733,1055,9646,8591,0
18925ref,933,9606,JUNC00000138,72,+,933,9606,255;0;0,2,150,10,0,8663,1083,9596,8513,0
18925ref,403,9076,JUNC00000023,15,+,403,9076,255;0;0,2,68,148,0,8525,471,8928,8457,0
18925ref,527,9244,JUNC00000054,22,+,527,9244,255;0;0,2,149,150,0,8567,676,9094,8418,0
18925ref,977,9504,JUNC00000185,81,+,977,9504,255;0;0,2,150,8,0,8519,1127,9496,8369,0
18925ref,2020,10263,JUNC00000288,1,-,2020,10263,255;0;0,2,27,124,0,8119,2047,10139,8092,0
18925ref,974,9347,JUNC00000175,71,+,974,9347,255;0;0,2,148,143,0,8230,1122,9204,8082,0
18925ref,947,9155,JUNC00000148,13,+,947,9155,255;0;0,2,148,25,0,8183,1095,9130,8035,0
18925ref,1033,9217,JUNC00000193,1,-,1033,9217,255;0;0,2,141,10,0,8174,1174,9207,8033,0
18925ref,973,9276,JUNC00000174,68,+,973,9276,255;0;0,2,149,146,0,8157,1122,9130,8008,0
18925ref,1469,9616,JUNC00000248,2,+,1469,9616,255;0;0,2,126,29,0,8118,1595,9587,7992,0
18925ref,979,9142,JUNC00000184,41,+,979,9142,255;0;0,2,148,42,0,8121,1127,9100,7973,0
18925ref,974,9242,JUNC00000173,94,+,974,9242,255;0;0,2,148,148,0,8120,1122,9094,7972,0
18925ref,970,9143,JUNC00000134,6,-,970,9143,255;0;0,2,98,146,0,8027,1068,8997,7929,0
18925ref,1234,9252,JUNC00000213,4,+,1234,9252,255;0;0,2,74,15,0,8003,1308,9237,7929,0
18925ref,910,8996,JUNC00000128,5,+,910,8996,255;0;0,2,145,68,0,8018,1055,8928,7873,0
18925ref,975,9123,JUNC00000172,285,+,975,9123,255;0;0,2,147,146,0,8002,1122,8977,7855,0
18925ref,763,8756,JUNC00000082,2,-,763,8756,255;0;0,2,131,18,0,7975,894,8738,7844,0
18925ref,322,8331,JUNC00000022,12,+,322,8331,255;0;0,2,149,23,0,7986,471,8308,7837,0
18925ref,1237,9159,JUNC00000207,8,-,1237,9159,255;0;0,2,43,146,0,7776,1280,9013,7733,0
18925ref,867,8808,JUNC00000108,39,+,867,8808,255;0;0,2,148,143,0,7798,1015,8665,7650,0
18925ref,1526,9333,JUNC00000245,4,+,1526,9333,255;0;0,2,22,142,0,7665,1548,9191,7643,0
18925ref,1234,9127,JUNC00000231,25,+,1234,9127,255;0;0,2,149,150,0,7743,1383,8977,7594,0
18925ref,1234,9094,JUNC00000230,4,+,1234,9094,255;0;0,2,149,150,0,7710,1383,8944,7561,0
18925ref,1536,9176,JUNC00000251,3,+,1536,9176,255;0;0,2,107,44,0,7596,1643,9132,7489,0
18925ref,259,8013,JUNC00000007,5,+,259,8013,255;0;0,2,144,146,0,7608,403,7867,7464,0
18925ref,924,8545,JUNC00000089,39,-,924,8545,255;0;0,2,19,149,0,7472,943,8396,7453,0
18925ref,1451,9046,JUNC00000249,3,+,1451,9046,255;0;0,2,147,22,0,7573,1598,9024,7426,0
18925ref,965,8544,JUNC00000156,71,+,965,8544,255;0;0,2,146,150,0,7429,1111,8394,7283,0
18925ref,510,7946,JUNC00000034,38,-,510,7946,255;0;0,2,48,140,0,7296,558,7806,7248,0
18925ref,949,8423,JUNC00000147,24,+,949,8423,255;0;0,2,146,107,0,7367,1095,8316,7221,0
18925ref,2699,10119,JUNC00000387,17,+,2699,10119,255;0;0,2,147,149,0,7271,2846,9970,7124,0
18925ref,1860,9129,JUNC00000276,4,+,1860,9129,255;0;0,2,144,9,0,7260,2004,9120,7116,0
18925ref,2670,9824,JUNC00000375,4,-,2670,9824,255;0;0,2,146,24,0,7130,2816,9800,6984,0
18925ref,2034,9266,JUNC00000293,29,+,2034,9266,255;0;0,2,141,146,0,7086,2175,9120,6945,0
18925ref,2652,9886,JUNC00000369,4,-,2652,9886,255;0;0,2,150,147,0,7087,2802,9739,6937,0
18925ref,2669,9800,JUNC00000374,41,-,2669,9800,255;0;0,2,147,47,0,7084,2816,9753,6937,0
18925ref,2467,9692,JUNC00000352,24,-,2467,9692,255;0;0,2,149,147,0,7078,2616,9545,6929,0
18925ref,390,7518,JUNC00000021,6,+,390,7518,255;0;0,2,81,133,0,6995,471,7385,6914,0
18925ref,978,8067,JUNC00000183,153,+,978,8067,255;0;0,2,149,26,0,7063,1127,8041,6914,0
18925ref,1002,8047,JUNC00000191,890,-,1002,8047,255;0;0,2,148,24,0,7021,1150,8023,6873,0
18925ref,3247,10398,JUNC00000416,7,+,3247,10398,255;0;0,2,147,144,0,7007,3394,10254,6860,0
18925ref,2168,9272,JUNC00000301,65,-,2168,9272,255;0;0,2,118,150,0,6954,2286,9122,6836,0
18925ref,973,8011,JUNC00000171,21,+,973,8011,255;0;0,2,149,144,0,6894,1122,7867,6745,0
18925ref,2190,9103,JUNC00000296,17,+,2190,9103,255;0;0,2,27,147,0,6766,2217,8956,6739,0
18925ref,1058,7941,JUNC00000192,6,-,1058,7941,255;0;0,2,116,50,0,6833,1174,7891,6717,0
18925ref,2685,9645,JUNC00000379,2,+,2685,9645,255;0;0,2,145,149,0,6811,2830,9496,6666,0
18925ref,1232,8078,JUNC00000221,4,-,1232,8078,255;0;0,2,131,50,0,6796,1363,8028,6665,0
18925ref,949,7733,JUNC00000099,6,+,949,7733,255;0;0,2,47,148,0,6636,996,7585,6589,0
18925ref,619,7482,JUNC00000065,11,+,619,7482,255;0;0,2,149,149,0,6714,768,7333,6565,0
18925ref,1000,7735,JUNC00000112,763,+,1000,7735,255;0;0,2,26,150,0,6585,1026,7585,6559,0
18925ref,2578,9339,JUNC00000355,12,+,2578,9339,255;0;0,2,74,142,0,6619,2652,9197,6545,0
18925ref,2416,9237,JUNC00000340,27,+,2416,9237,255;0;0,2,149,137,0,6684,2565,9100,6535,0
18925ref,985,7662,JUNC00000127,8,+,985,7662,255;0;0,2,70,81,0,6596,1055,7581,6526,0
18925ref,913,7729,JUNC00000131,10,+,913,7729,255;0;0,2,147,148,0,6668,1060,7581,6521,0
18925ref,908,7699,JUNC00000126,15,+,908,7699,255;0;0,2,147,139,0,6652,1055,7560,6505,0
18925ref,914,7693,JUNC00000130,4,+,914,7693,255;0;0,2,146,142,0,6637,1060,7551,6491,0
18925ref,2237,9019,JUNC00000315,84,-,2237,9019,255;0;0,2,148,150,0,6632,2385,8869,6484,0
18925ref,973,7712,JUNC00000170,98,+,973,7712,255;0;0,2,149,147,0,6592,1122,7565,6443,0
18925ref,933,7670,JUNC00000137,20,+,933,7670,255;0;0,2,150,148,0,6589,1083,7522,6439,0
18925ref,323,7051,JUNC00000020,7,+,323,7051,255;0;0,2,148,148,0,6580,471,6903,6432,0
18925ref,996,7714,JUNC00000187,17,+,996,7714,255;0;0,2,150,149,0,6569,1146,7565,6419,0
18925ref,3126,9686,JUNC00000404,35,-,3126,9686,255;0;0,2,10,144,0,6416,3136,9542,6406,0
18925ref,974,7647,JUNC00000169,69,+,974,7647,255;0;0,2,148,143,0,6530,1122,7504,6382,0
18925ref,871,7435,JUNC00000107,32,+,871,7435,255;0;0,2,144,50,0,6514,1015,7385,6370,0
18925ref,1075,7734,JUNC00000202,26,+,1075,7734,255;0;0,2,149,149,0,6510,1224,7585,6361,0
18925ref,1072,7700,JUNC00000201,83,+,1072,7700,255;0;0,2,149,149,0,6479,1221,7551,6330,0
18925ref,2600,9162,JUNC00000365,4,+,2600,9162,255;0;0,2,150,92,0,6470,2750,9070,6320,0
18925ref,2601,9078,JUNC00000351,48,-,2601,9078,255;0;0,2,15,150,0,6327,2616,8928,6312,0
18925ref,2477,9078,JUNC00000354,24,-,2477,9078,255;0;0,2,144,145,0,6456,2621,8933,6312,0
18925ref,1878,8416,JUNC00000283,42,-,1878,8416,255;0;0,2,150,148,0,6390,2028,8268,6240,0
18925ref,1220,7617,JUNC00000220,17,-,1220,7617,255;0;0,2,143,25,0,6372,1363,7592,6229,0
18925ref,3927,10410,JUNC00000453,16,+,3927,10410,255;0;0,2,148,113,0,6370,4075,10297,6222,0
18925ref,1234,7738,JUNC00000229,6,+,1234,7738,255;0;0,2,149,150,0,6354,1383,7588,6205,0
18925ref,2296,8655,JUNC00000309,24,+,2296,8655,255;0;0,2,26,149,0,6210,2322,8506,6184,0
18925ref,2691,9171,JUNC00000383,10,+,2691,9171,255;0;0,2,150,149,0,6331,2841,9022,6181,0
18925ref,974,7367,JUNC00000168,368,+,974,7367,255;0;0,2,148,146,0,6247,1122,7221,6099,0
18925ref,2166,8388,JUNC00000304,30,+,2166,8388,255;0;0,2,150,9,0,6213,2316,8379,6063,0
18925ref,3803,10161,JUNC00000441,5,+,3803,10161,255;0;0,2,148,148,0,6210,3951,10013,6062,0
18925ref,1234,7510,JUNC00000225,21,+,1234,7510,255;0;0,2,147,149,0,6127,1381,7361,5980,0
18925ref,1573,7673,JUNC00000246,5,-,1573,7673,255;0;0,2,8,145,0,5955,1581,7528,5947,0
18925ref,3051,9136,JUNC00000410,8,+,3051,9136,255;0;0,2,145,21,0,6064,3196,9115,5919,0
18925ref,909,7117,JUNC00000125,26,+,909,7117,255;0;0,2,146,146,0,6062,1055,6971,5916,0
18925ref,3054,9096,JUNC00000401,33,+,3054,9096,255;0;0,2,9,144,0,5898,3063,8952,5889,0
18925ref,2002,8065,JUNC00000282,126,-,2002,8065,255;0;0,2,26,149,0,5914,2028,7916,5888,0
18925ref,1902,8049,JUNC00000287,20,-,1902,8049,255;0;0,2,145,143,0,6004,2047,7906,5859,0
18925ref,2171,8314,JUNC00000306,18,+,2171,8314,255;0;0,2,148,149,0,5994,2319,8165,5846,0
18925ref,3237,9148,JUNC00000415,1,+,3237,9148,255;0;0,2,118,33,0,5878,3355,9115,5760,0
18925ref,2433,8413,JUNC00000342,14,+,2433,8413,255;0;0,2,145,97,0,5883,2578,8316,5738,0
18925ref,4379,10359,JUNC00000476,22,+,4379,10359,255;0;0,2,142,105,0,5875,4521,10254,5733,0
18925ref,1878,7850,JUNC00000281,84,-,1878,7850,255;0;0,2,150,147,0,5825,2028,7703,5675,0
18925ref,1899,7769,JUNC00000286,30,-,1899,7769,255;0;0,2,148,47,0,5823,2047,7722,5675,0
18925ref,1876,7693,JUNC00000279,3,+,1876,7693,255;0;0,2,147,18,0,5799,2023,7675,5652,0
18925ref,1818,7712,JUNC00000269,16,+,1818,7712,255;0;0,2,94,150,0,5744,1912,7562,5650,0
18925ref,973,6900,JUNC00000167,35,+,973,6900,255;0;0,2,149,145,0,5782,1122,6755,5633,0
18925ref,453,6338,JUNC00000045,3,-,453,6338,255;0;0,2,150,149,0,5736,603,6189,5586,0
18925ref,1232,7108,JUNC00000224,715,+,1232,7108,255;0;0,2,149,149,0,5727,1381,6959,5578,0
18925ref,976,6697,JUNC00000101,29,+,976,6697,255;0;0,2,26,146,0,5575,1002,6551,5549,0
18925ref,2685,8461,JUNC00000378,32,+,2685,8461,255;0;0,2,145,145,0,5631,2830,8316,5486,0
18925ref,2866,8496,JUNC00000392,7,+,2866,8496,255;0;0,2,53,135,0,5495,2919,8361,5442,0
18925ref,2154,7775,JUNC00000295,60,-,2154,7775,255;0;0,2,37,150,0,5471,2191,7625,5434,0
18925ref,4434,10083,JUNC00000481,5,-,4434,10083,255;0;0,2,123,124,0,5525,4557,9959,5402,0
18925ref,2667,8342,JUNC00000373,43,-,2667,8342,255;0;0,2,149,145,0,5530,2816,8197,5381,0
18925ref,1740,7402,JUNC00000268,9,+,1740,7402,255;0;0,2,145,140,0,5522,1885,7262,5377,0
18925ref,3804,9299,JUNC00000432,13,+,3804,9299,255;0;0,2,50,148,0,5347,3854,9151,5297,0
18925ref,2438,8016,JUNC00000345,13,+,2438,8016,255;0;0,2,146,149,0,5429,2584,7867,5283,0
18925ref,708,6256,JUNC00000074,11,+,708,6256,255;0;0,2,150,146,0,5402,858,6110,5252,0
18925ref,3918,9330,JUNC00000442,2,-,3918,9330,255;0;0,2,57,136,0,5276,3975,9194,5219,0
18925ref,5018,10529,JUNC00000536,52,+,5018,10529,255;0;0,2,146,148,0,5363,5164,10381,5217,0
18925ref,629,6088,JUNC00000056,14,+,629,6088,255;0;0,2,101,145,0,5314,730,5943,5213,0
18925ref,4944,10319,JUNC00000523,15,+,4944,10319,255;0;0,2,144,36,0,5339,5088,10283,5195,0
18925ref,999,6355,JUNC00000188,43,+,999,6355,255;0;0,2,149,25,0,5331,1148,6330,5182,0
18925ref,1793,7132,JUNC00000261,41,+,1793,7132,255;0;0,2,21,149,0,5190,1814,6983,5169,0
18925ref,423,5711,JUNC00000019,29,+,423,5711,255;0;0,2,48,148,0,5140,471,5563,5092,0
18925ref,933,6316,JUNC00000136,54,+,933,6316,255;0;0,2,150,149,0,5234,1083,6167,5084,0
18925ref,322,5658,JUNC00000018,14,+,322,5658,255;0;0,2,149,146,0,5190,471,5512,5041,0
18925ref,3326,8544,JUNC00000418,78,+,3326,8544,255;0;0,2,148,36,0,5182,3474,8508,5034,0
18925ref,2276,7592,JUNC00000321,3,+,2276,7592,255;0;0,2,149,148,0,5168,2425,7444,5019,0
18925ref,4032,9325,JUNC00000460,32,+,4032,9325,255;0;0,2,142,147,0,5146,4174,9178,5004,0
18925ref,2831,8021,JUNC00000391,33,+,2831,8021,255;0;0,2,88,99,0,5091,2919,7922,5003,0
18925ref,2443,7639,JUNC00000347,23,+,2443,7639,255;0;0,2,150,49,0,5147,2593,7590,4997,0
18925ref,974,6245,JUNC00000166,70,+,974,6245,255;0;0,2,148,145,0,5126,1122,6100,4978,0
18925ref,4574,9828,JUNC00000492,12,+,4574,9828,255;0;0,2,147,148,0,5106,4721,9680,4959,0
18925ref,983,6083,JUNC00000109,1,+,983,6083,255;0;0,2,38,112,0,4988,1021,5971,4950,0
18925ref,973,6192,JUNC00000165,15,+,973,6192,255;0;0,2,149,141,0,5078,1122,6051,4929,0
18925ref,945,6051,JUNC00000146,7,+,945,6051,255;0;0,2,150,149,0,4957,1095,5902,4807,0
18925ref,2696,7721,JUNC00000386,24,+,2696,7721,255;0;0,2,150,147,0,4878,2846,7574,4728,0
18925ref,1234,6148,JUNC00000228,12,+,1234,6148,255;0;0,2,149,42,0,4872,1383,6106,4723,0
18925ref,3256,8157,JUNC00000414,5,+,3256,8157,255;0;0,2,42,150,0,4751,3298,8007,4709,0
18925ref,2800,7674,JUNC00000394,9,-,2800,7674,255;0;0,2,149,25,0,4849,2949,7649,4700,0
18925ref,2418,7269,JUNC00000339,66,+,2418,7269,255;0;0,2,147,48,0,4803,2565,7221,4656,0
18925ref,2221,7159,JUNC00000313,18,-,2221,7159,255;0;0,2,143,148,0,4790,2364,7011,4647,0
18925ref,553,5279,JUNC00000044,8,-,553,5279,255;0;0,2,50,149,0,4577,603,5130,4527,0
18925ref,4579,9383,JUNC00000494,8,+,4579,9383,255;0;0,2,145,146,0,4658,4724,9237,4513,0
18925ref,4961,9504,JUNC00000529,11,+,4961,9504,255;0;0,2,148,8,0,4535,5109,9496,4387,0
18925ref,4539,9212,JUNC00000487,7,+,4539,9212,255;0;0,2,150,144,0,4529,4689,9068,4379,0
18925ref,2981,7470,JUNC00000400,10,+,2981,7470,255;0;0,2,66,85,0,4404,3047,7385,4338,0
18925ref,4475,9092,JUNC00000485,9,+,4475,9092,255;0;0,2,147,148,0,4469,4622,8944,4322,0
18925ref,5854,10364,JUNC00000559,4,+,5854,10364,255;0;0,2,57,149,0,4361,5911,10215,4304,0
18925ref,4713,9297,JUNC00000506,3,+,4713,9297,255;0;0,2,148,149,0,4435,4861,9148,4287,0
18925ref,4946,9383,JUNC00000526,5,+,4946,9383,255;0;0,2,145,146,0,4291,5091,9237,4146,0
18925ref,1858,6252,JUNC00000277,48,+,1858,6252,255;0;0,2,149,149,0,4245,2007,6103,4096,0
18925ref,1398,5713,JUNC00000240,185,+,1398,5713,255;0;0,2,70,150,0,4165,1468,5563,4095,0
18925ref,3332,7660,JUNC00000419,40,+,3332,7660,255;0;0,2,149,132,0,4196,3481,7528,4047,0
18925ref,974,5310,JUNC00000164,155,+,974,5310,255;0;0,2,148,146,0,4190,1122,5164,4042,0
18925ref,1769,6054,JUNC00000266,3,+,1769,6054,255;0;0,2,103,149,0,4136,1872,5905,4033,0
18925ref,4858,9018,JUNC00000517,3,-,4858,9018,255;0;0,2,125,26,0,4134,4983,8992,4009,0
18925ref,871,5144,JUNC00000106,23,+,871,5144,255;0;0,2,144,144,0,4129,1015,5000,3985,0
18925ref,5060,9228,JUNC00000537,3,+,5060,9228,255;0;0,2,145,50,0,4118,5205,9178,3973,0
18925ref,3304,7563,JUNC00000417,28,-,3304,7563,255;0;0,2,148,145,0,4114,3452,7418,3966,0
18925ref,1856,5974,JUNC00000275,15,+,1856,5974,255;0;0,2,148,21,0,4097,2004,5953,3949,0
18925ref,2746,6965,JUNC00000389,8,-,2746,6965,255;0;0,2,145,147,0,4072,2891,6818,3927,0
18925ref,2021,6078,JUNC00000285,1,-,2021,6078,255;0;0,2,26,125,0,3932,2047,5953,3906,0
18925ref,4888,9077,JUNC00000521,8,+,4888,9077,255;0;0,2,146,149,0,4040,5034,8928,3894,0
18925ref,5144,9232,JUNC00000539,3,+,5144,9232,255;0;0,2,94,100,0,3988,5238,9132,3894,0
18925ref,3821,7838,JUNC00000430,2,-,3821,7838,255;0;0,2,22,147,0,3870,3843,7691,3848,0
18925ref,913,5008,JUNC00000124,13,+,913,5008,255;0;0,2,142,130,0,3965,1055,4878,3823,0
18925ref,1204,5204,JUNC00000217,7,+,1204,5204,255;0;0,2,149,33,0,3967,1353,5171,3818,0
18925ref,5943,10041,JUNC00000566,5,+,5943,10041,255;0;0,2,148,146,0,3952,6091,9895,3804,0
18925ref,1234,5311,JUNC00000227,7,+,1234,5311,255;0;0,2,149,147,0,3930,1383,5164,3781,0
18925ref,5109,9187,JUNC00000540,2,+,5109,9187,255;0;0,2,147,150,0,3928,5256,9037,3781,0
18925ref,3887,7807,JUNC00000450,10,+,3887,7807,255;0;0,2,138,23,0,3897,4025,7784,3759,0
18925ref,4542,8586,JUNC00000488,15,-,4542,8586,255;0;0,2,149,148,0,3896,4691,8438,3747,0
18925ref,4579,8527,JUNC00000491,9,+,4579,8527,255;0;0,2,142,89,0,3859,4721,8438,3717,0
18925ref,615,4553,JUNC00000063,15,+,615,4553,255;0;0,2,149,141,0,3797,764,4412,3648,0
18925ref,947,4837,JUNC00000145,30,+,947,4837,255;0;0,2,148,97,0,3793,1095,4740,3645,0
18925ref,974,4911,JUNC00000163,151,+,974,4911,255;0;0,2,148,146,0,3791,1122,4765,3643,0
18925ref,974,4906,JUNC00000162,81,+,974,4906,255;0;0,2,148,144,0,3788,1122,4762,3640,0
18925ref,3802,7714,JUNC00000440,4,+,3802,7714,255;0;0,2,149,149,0,3763,3951,7565,3614,0
18925ref,3959,7848,JUNC00000458,73,-,3959,7848,255;0;0,2,150,147,0,3742,4109,7701,3592,0
18925ref,910,4765,JUNC00000123,13,+,910,4765,255;0;0,2,145,145,0,3710,1055,4620,3565,0
18925ref,2206,6012,JUNC00000312,22,-,2206,6012,255;0;0,2,148,125,0,3681,2354,5887,3533,0
18925ref,616,4408,JUNC00000062,12,+,616,4408,255;0;0,2,148,147,0,3645,764,4261,3497,0
18925ref,622,4412,JUNC00000064,6,+,622,4412,255;0;0,2,146,147,0,3643,768,4265,3497,0
18925ref,3009,6794,JUNC00000406,8,+,3009,6794,255;0;0,2,148,150,0,3635,3157,6644,3487,0
18925ref,2800,6540,JUNC00000393,29,-,2800,6540,255;0;0,2,149,145,0,3595,2949,6395,3446,0
18925ref,979,4620,JUNC00000182,167,+,979,4620,255;0;0,2,148,54,0,3587,1127,4566,3439,0
18925ref,6461,9949,JUNC00000597,1,-,6461,9949,255;0;0,2,79,72,0,3416,6540,9877,3337,0
18925ref,4007,7559,JUNC00000454,27,-,4007,7559,255;0;0,2,90,150,0,3402,4097,7409,3312,0
18925ref,4419,8015,JUNC00000483,17,+,4419,8015,255;0;0,2,147,142,0,3454,4566,7873,3307,0
18925ref,3875,7373,JUNC00000436,6,-,3875,7373,255;0;0,2,44,150,0,3348,3919,7223,3304,0
18925ref,988,4430,JUNC00000105,18,+,988,4430,255;0;0,2,27,142,0,3300,1015,4288,3273,0
18925ref,2699,6256,JUNC00000388,39,+,2699,6256,255;0;0,2,149,146,0,3411,2848,6110,3262,0
18925ref,5009,8519,JUNC00000535,5,+,5009,8519,255;0;0,2,145,125,0,3385,5154,8394,3240,0
18925ref,5616,9125,JUNC00000550,13,+,5616,9125,255;0;0,2,145,148,0,3361,5761,8977,3216,0
18925ref,2658,6107,JUNC00000371,9,+,2658,6107,255;0;0,2,148,95,0,3354,2806,6012,3206,0
18925ref,2629,6088,JUNC00000367,22,+,2629,6088,255;0;0,2,142,145,0,3314,2771,5943,3172,0
18925ref,5005,8378,JUNC00000533,63,+,5005,8378,255;0;0,2,146,62,0,3311,5151,8316,3165,0
18925ref,1245,4521,JUNC00000215,4,-,1245,4521,255;0;0,2,92,24,0,3252,1337,4497,3160,0
18925ref,1457,4911,JUNC00000250,19,+,1457,4911,255;0;0,2,148,149,0,3305,1605,4762,3157,0
18925ref,4638,7918,JUNC00000496,6,-,4638,7918,255;0;0,2,108,43,0,3237,4746,7875,3129,0
18925ref,948,4242,JUNC00000144,10,+,948,4242,255;0;0,2,147,23,0,3271,1095,4219,3124,0
18925ref,7124,10384,JUNC00000618,1,+,7124,10384,255;0;0,2,50,101,0,3159,7174,10283,3109,0
18925ref,2652,6037,JUNC00000368,5,-,2652,6037,255;0;0,2,150,150,0,3235,2802,5887,3085,0
18925ref,2670,6037,JUNC00000377,21,-,2670,6037,255;0;0,2,150,150,0,3217,2820,5887,3067,0
18925ref,1912,5155,JUNC00000271,29,+,1912,5155,255;0;0,2,69,146,0,3097,1981,5009,3028,0
18925ref,6089,9338,JUNC00000586,3,-,6089,9338,255;0;0,2,147,75,0,3174,6236,9263,3027,0
18925ref,669,3973,JUNC00000070,9,-,669,3973,255;0;0,2,142,147,0,3157,811,3826,3015,0
18925ref,790,3978,JUNC00000071,41,+,790,3978,255;0;0,2,26,147,0,3041,816,3831,3015,0
18925ref,5958,9244,JUNC00000567,44,+,5958,9244,255;0;0,2,147,144,0,3142,6105,9100,2995,0
18925ref,3073,6256,JUNC00000403,9,+,3073,6256,255;0;0,2,63,150,0,3033,3136,6106,2970,0
18925ref,6024,9277,JUNC00000571,16,+,6024,9277,255;0;0,2,147,147,0,3106,6171,9130,2959,0
18925ref,961,4196,JUNC00000155,14,+,961,4196,255;0;0,2,150,142,0,3093,1111,4054,2943,0
18925ref,4944,8048,JUNC00000525,7,+,4944,8048,255;0;0,2,147,25,0,3079,5091,8023,2932,0
18925ref,6184,9286,JUNC00000577,25,+,6184,9286,255;0;0,2,22,149,0,2953,6206,9137,2931,0
18925ref,5943,9144,JUNC00000565,5,+,5943,9144,255;0;0,2,127,147,0,3054,6070,8997,2927,0
18925ref,2696,5919,JUNC00000385,33,+,2696,5919,255;0;0,2,150,150,0,3073,2846,5769,2923,0
18925ref,1264,4358,JUNC00000235,49,+,1264,4358,255;0;0,2,147,35,0,3059,1411,4323,2912,0
18925ref,4793,7848,JUNC00000501,7,-,4793,7848,255;0;0,2,19,147,0,2908,4812,7701,2889,0
18925ref,2943,6092,JUNC00000402,4,-,2943,6092,255;0;0,2,149,112,0,3037,3092,5980,2888,0
18925ref,4574,7736,JUNC00000490,11,+,4574,7736,255;0;0,2,147,144,0,3018,4721,7592,2871,0
18925ref,2204,5353,JUNC00000311,4,-,2204,5353,255;0;0,2,150,146,0,3003,2354,5207,2853,0
18925ref,6106,9244,JUNC00000590,11,+,6106,9244,255;0;0,2,143,150,0,2988,6249,9094,2845,0
18925ref,4793,7785,JUNC00000513,2,+,4793,7785,255;0;0,2,142,9,0,2983,4935,7776,2841,0
18925ref,6092,9048,JUNC00000570,6,+,6092,9048,255;0;0,2,79,71,0,2885,6171,8977,2806,0
18925ref,6122,9134,JUNC00000572,6,+,6122,9134,255;0;0,2,59,148,0,2864,6181,8986,2805,0
18925ref,4951,7895,JUNC00000518,1,+,4951,7895,255;0;0,2,57,94,0,2850,5008,7801,2793,0
18925ref,5186,8149,JUNC00000538,7,-,5186,8149,255;0;0,2,37,150,0,2813,5223,7999,2776,0
18925ref,5223,8059,JUNC00000541,10,-,5223,8059,255;0;0,2,34,26,0,2810,5257,8033,2776,0
18925ref,6100,9101,JUNC00000587,24,+,6100,9101,255;0;0,2,147,104,0,2897,6247,8997,2750,0
18925ref,893,3923,JUNC00000117,16,+,893,3923,255;0;0,2,145,149,0,2881,1038,3774,2736,0
18925ref,2672,5703,JUNC00000376,2,-,2672,5703,255;0;0,2,148,147,0,2884,2820,5556,2736,0
18925ref,6059,9092,JUNC00000579,6,+,6059,9092,255;0;0,2,149,150,0,2883,6208,8942,2734,0
18925ref,4740,7722,JUNC00000508,8,+,4740,7722,255;0;0,2,147,148,0,2834,4887,7574,2687,0
18925ref,378,3349,JUNC00000032,407,-,378,3349,255;0;0,2,150,148,0,2823,528,3201,2673,0
18925ref,3794,6668,JUNC00000431,9,-,3794,6668,255;0;0,2,53,148,0,2726,3847,6520,2673,0
18925ref,4959,7796,JUNC00000528,12,+,4959,7796,255;0;0,2,150,24,0,2813,5109,7772,2663,0
18925ref,5004,7951,JUNC00000534,23,+,5004,7951,255;0;0,2,150,145,0,2802,5154,7806,2652,0
18925ref,5010,7785,JUNC00000527,40,-,5010,7785,255;0;0,2,87,63,0,2712,5097,7722,2625,0
18925ref,950,3723,JUNC00000143,10,+,950,3723,255;0;0,2,145,8,0,2765,1095,3715,2620,0
18925ref,3046,5905,JUNC00000409,44,+,3046,5905,255;0;0,2,150,90,0,2769,3196,5815,2619,0
18925ref,2261,5173,JUNC00000318,239,+,2261,5173,255;0;0,2,148,149,0,2763,2409,5024,2615,0
18925ref,390,3196,JUNC00000017,9,+,390,3196,255;0;0,2,81,149,0,2657,471,3047,2576,0
18925ref,6294,9078,JUNC00000594,49,-,6294,9078,255;0;0,2,96,150,0,2634,6390,8928,2538,0
18925ref,4597,7405,JUNC00000495,11,-,4597,7405,255;0;0,2,149,148,0,2660,4746,7257,2511,0
18925ref,1856,4521,JUNC00000274,14,+,1856,4521,255;0;0,2,148,24,0,2641,2004,4497,2493,0
18925ref,7708,10294,JUNC00000648,1,+,7708,10294,255;0;0,2,117,33,0,2553,7825,10261,2436,0
18925ref,3959,6685,JUNC00000457,197,-,3959,6685,255;0;0,2,150,149,0,2577,4109,6536,2427,0
18925ref,6541,9255,JUNC00000603,2,-,6541,9255,255;0;0,2,142,149,0,2565,6683,9106,2423,0
18925ref,6600,9294,JUNC00000607,5,+,6600,9294,255;0;0,2,149,149,0,2545,6749,9145,2396,0
18925ref,1215,3759,JUNC00000219,3,-,1215,3759,255;0;0,2,148,25,0,2519,1363,3734,2371,0
18925ref,5863,8449,JUNC00000563,15,+,5863,8449,255;0;0,2,149,68,0,2518,6012,8381,2369,0
18925ref,2274,4910,JUNC00000320,9,+,2274,4910,255;0;0,2,144,145,0,2491,2418,4765,2347,0
18925ref,370,2957,JUNC00000016,48,+,370,2957,255;0;0,2,101,141,0,2446,471,2816,2345,0
18925ref,6092,8622,JUNC00000585,4,-,6092,8622,255;0;0,2,144,62,0,2468,6236,8560,2324,0
18925ref,619,3196,JUNC00000061,26,+,619,3196,255;0;0,2,145,149,0,2428,764,3047,2283,0
18925ref,972,3396,JUNC00000161,2,+,972,3396,255;0;0,2,142,10,0,2414,1114,3386,2272,0
18925ref,2888,5294,JUNC00000395,1,-,2888,5294,255;0;0,2,68,81,0,2325,2956,5213,2257,0
18925ref,1330,3873,JUNC00000241,4,+,1330,3873,255;0;0,2,146,149,0,2394,1476,3724,2248,0
18925ref,3849,6373,JUNC00000446,4,+,3849,6373,255;0;0,2,150,148,0,2376,3999,6225,2226,0
18925ref,6858,9222,JUNC00000612,4,-,6858,9222,255;0;0,2,86,64,0,2300,6944,9158,2214,0
18925ref,878,3386,JUNC00000111,628,+,878,3386,255;0;0,2,148,150,0,2358,1026,3236,2210,0
18925ref,7805,10186,JUNC00000649,10,-,7805,10186,255;0;0,2,24,150,0,2231,7829,10036,2207,0
18925ref,3951,6247,JUNC00000445,4,+,3951,6247,255;0;0,2,48,141,0,2155,3999,6106,2107,0
18925ref,3856,6248,JUNC00000448,16,+,3856,6248,255;0;0,2,149,148,0,2244,4005,6100,2095,0
18925ref,2166,4411,JUNC00000303,18,+,2166,4411,255;0;0,2,150,9,0,2236,2316,4402,2086,0
18925ref,2169,4555,JUNC00000305,1271,+,2169,4555,255;0;0,2,150,150,0,2236,2319,4405,2086,0
18925ref,2173,4555,JUNC00000308,7689,+,2173,4555,255;0;0,2,149,147,0,2235,2322,4408,2086,0
18925ref,2432,4793,JUNC00000341,6,+,2432,4793,255;0;0,2,146,142,0,2219,2578,4651,2073,0
18925ref,6959,9325,JUNC00000616,27,+,6959,9325,255;0;0,2,148,147,0,2219,7107,9178,2071,0
18925ref,3833,6074,JUNC00000443,5,+,3833,6074,255;0;0,2,149,46,0,2195,3982,6028,2046,0
18925ref,384,2601,JUNC00000015,10,+,384,2601,255;0;0,2,87,100,0,2117,471,2501,2030,0
18925ref,4566,6889,JUNC00000489,4,+,4566,6889,255;0;0,2,147,147,0,2176,4713,6742,2029,0
18925ref,2365,4537,JUNC00000332,31,+,2365,4537,255;0;0,2,148,21,0,2151,2513,4516,2003,0
18925ref,5695,7985,JUNC00000556,5,+,5695,7985,255;0;0,2,149,149,0,2141,5844,7836,1992,0
18925ref,1158,3317,JUNC00000195,17,-,1158,3317,255;0;0,2,50,148,0,2011,1208,3169,1961,0
18925ref,1664,3916,JUNC00000260,8,-,1664,3916,255;0;0,2,145,149,0,2103,1809,3767,1958,0
18925ref,4016,6121,JUNC00000451,2,+,4016,6121,255;0;0,2,52,99,0,2006,4068,6022,1954,0
18925ref,945,3171,JUNC00000142,20,+,945,3171,255;0;0,2,150,139,0,2087,1095,3032,1937,0
18925ref,1840,4070,JUNC00000273,5,+,1840,4070,255;0;0,2,149,150,0,2080,1989,3920,1931,0
18925ref,978,3182,JUNC00000181,25,+,978,3182,255;0;0,2,149,150,0,2054,1127,3032,1905,0
18925ref,1234,3437,JUNC00000226,15,+,1234,3437,255;0;0,2,149,149,0,2054,1383,3288,1905,0
18925ref,996,3182,JUNC00000186,6,+,996,3182,255;0;0,2,150,150,0,2036,1146,3032,1886,0
18925ref,945,2991,JUNC00000095,9,+,945,2991,255;0;0,2,24,149,0,1897,969,2842,1873,0
18925ref,3875,5923,JUNC00000434,6,+,3875,5923,255;0;0,2,37,148,0,1900,3912,5775,1863,0
18925ref,405,2412,JUNC00000014,1,+,405,2412,255;0;0,2,66,85,0,1922,471,2327,1856,0
18925ref,4050,5937,JUNC00000452,19,+,4050,5937,255;0;0,2,25,32,0,1855,4075,5905,1830,0
18925ref,889,2825,JUNC00000116,4,+,889,2825,255;0;0,2,149,25,0,1911,1038,2800,1762,0
18925ref,5825,7850,JUNC00000561,80,-,5825,7850,255;0;0,2,149,147,0,1878,5974,7703,1729,0
18925ref,2484,4352,JUNC00000350,1,-,2484,4352,255;0;0,2,123,27,0,1841,2607,4325,1718,0
18925ref,978,2989,JUNC00000180,163,+,978,2989,255;0;0,2,149,147,0,1864,1127,2842,1715,0
18925ref,7711,9571,JUNC00000652,15,-,7711,9571,255;0;0,2,146,29,0,1831,7857,9542,1685,0
18925ref,446,2173,JUNC00000013,2,+,446,2173,255;0;0,2,25,26,0,1701,471,2147,1676,0
18925ref,423,2300,JUNC00000025,154,+,423,2300,255;0;0,2,51,150,0,1727,474,2150,1676,0
18925ref,7440,9149,JUNC00000625,7,+,7440,9149,255;0;0,2,54,29,0,1680,7494,9120,1626,0
18925ref,2868,4666,JUNC00000390,6,+,2868,4666,255;0;0,2,25,150,0,1648,2893,4516,1623,0
18925ref,730,2633,JUNC00000077,31,+,730,2633,255;0;0,2,148,143,0,1760,878,2490,1612,0
18925ref,849,2633,JUNC00000081,2,-,849,2633,255;0;0,2,42,130,0,1654,891,2503,1612,0
18925ref,2608,4467,JUNC00000360,7,+,2608,4467,255;0;0,2,107,144,0,1715,2715,4323,1608,0
18925ref,889,2758,JUNC00000115,10,+,889,2758,255;0;0,2,149,145,0,1724,1038,2613,1575,0
18925ref,6106,7970,JUNC00000589,4,+,6106,7970,255;0;0,2,143,150,0,1714,6249,7820,1571,0
18925ref,7516,9319,JUNC00000635,7,+,7516,9319,255;0;0,2,149,148,0,1655,7665,9171,1506,0
18925ref,850,2608,JUNC00000090,15,+,850,2608,255;0;0,2,103,150,0,1608,953,2458,1505,0
18925ref,2522,4211,JUNC00000357,56,+,2522,4211,255;0;0,2,148,36,0,1653,2670,4175,1505,0
18925ref,7499,9275,JUNC00000632,4,+,7499,9275,255;0;0,2,148,143,0,1633,7647,9132,1485,0
18925ref,7513,9294,JUNC00000634,5,+,7513,9294,255;0;0,2,147,149,0,1632,7660,9145,1485,0
18925ref,2696,4387,JUNC00000382,14,+,2696,4387,255;0;0,2,145,64,0,1627,2841,4323,1482,0
18925ref,884,2566,JUNC00000085,20,+,884,2566,255;0;0,2,56,148,0,1534,940,2418,1478,0
18925ref,1220,2988,JUNC00000223,13,-,1220,2988,255;0;0,2,147,148,0,1620,1367,2840,1473,0
18925ref,896,2667,JUNC00000118,23,+,896,2667,255;0;0,2,149,150,0,1621,1045,2517,1472,0
18925ref,909,2670,JUNC00000122,20,+,909,2670,255;0;0,2,146,143,0,1618,1055,2527,1472,0
18925ref,6859,8468,JUNC00000609,1,+,6859,8468,255;0;0,2,44,107,0,1502,6903,8361,1458,0
18925ref,7551,9258,JUNC00000642,9,+,7551,9258,255;0;0,2,148,110,0,1597,7699,9148,1449,0
18925ref,970,2691,JUNC00000160,8,+,970,2691,255;0;0,2,144,147,0,1574,1114,2544,1430,0
18925ref,7551,9239,JUNC00000641,29,+,7551,9239,255;0;0,2,148,145,0,1543,7699,9094,1395,0
18925ref,244,1924,JUNC00000006,4,+,244,1924,255;0;0,2,147,147,0,1533,391,1777,1386,0
18925ref,4520,6204,JUNC00000486,179,+,4520,6204,255;0;0,2,150,149,0,1535,4670,6055,1385,0
18925ref,6061,7738,JUNC00000576,8,+,6061,7738,255;0;0,2,145,148,0,1529,6206,7590,1384,0
18925ref,7539,9220,JUNC00000639,59,+,7539,9220,255;0;0,2,150,148,0,1533,7689,9072,1383,0
18925ref,1536,3195,JUNC00000255,5,+,1536,3195,255;0;0,2,150,141,0,1518,1686,3054,1368,0
18925ref,6059,7715,JUNC00000578,8,+,6059,7715,255;0;0,2,149,150,0,1506,6208,7565,1357,0
18925ref,2685,4204,JUNC00000358,2,+,2685,4204,255;0;0,2,24,147,0,1372,2709,4057,1348,0
18925ref,491,1975,JUNC00000033,9,+,491,1975,255;0;0,2,61,90,0,1394,552,1885,1333,0
18925ref,4618,6243,JUNC00000499,4,+,4618,6243,255;0;0,2,147,145,0,1480,4765,6098,1333,0
18925ref,6105,7718,JUNC00000588,7,+,6105,7718,255;0;0,2,144,150,0,1463,6249,7568,1319,0
18925ref,6106,7717,JUNC00000591,19,+,6106,7717,255;0;0,2,149,149,0,1462,6255,7568,1313,0
18925ref,6619,8078,JUNC00000601,35,-,6619,8078,255;0;0,2,10,143,0,1316,6629,7935,1306,0
18925ref,979,2568,JUNC00000179,432,+,979,2568,255;0;0,2,148,150,0,1439,1127,2418,1291,0
18925ref,969,2543,JUNC00000154,154,+,969,2543,255;0;0,2,142,150,0,1424,1111,2393,1282,0
18925ref,1277,2784,JUNC00000236,9,+,1277,2784,255;0;0,2,142,87,0,1420,1419,2697,1278,0
18925ref,7848,9192,JUNC00000654,84,+,7848,9192,255;0;0,2,25,55,0,1289,7873,9137,1264,0
18925ref,8494,9942,JUNC00000676,19,-,8494,9942,255;0;0,2,149,42,0,1406,8643,9900,1257,0
18925ref,945,2494,JUNC00000141,142,+,945,2494,255;0;0,2,150,143,0,1406,1095,2351,1256,0
18925ref,379,1862,JUNC00000012,11,+,379,1862,255;0;0,2,92,141,0,1342,471,1721,1250,0
18925ref,305,1841,JUNC00000010,9,+,305,1841,255;0;0,2,149,145,0,1391,454,1696,1242,0
18925ref,4713,6127,JUNC00000505,5,+,4713,6127,255;0;0,2,148,24,0,1390,4861,6103,1242,0
18925ref,6242,7661,JUNC00000592,7,+,6242,7661,255;0;0,2,60,149,0,1270,6302,7512,1210,0
18925ref,6200,7669,JUNC00000593,5,+,6200,7669,255;0;0,2,112,147,0,1322,6312,7522,1210,0
18925ref,1147,2646,JUNC00000210,21,+,1147,2646,255;0;0,2,148,147,0,1352,1295,2499,1204,0
18925ref,1165,2605,JUNC00000212,9,+,1165,2605,255;0;0,2,143,93,0,1347,1308,2512,1204,0
18925ref,6088,7572,JUNC00000584,13,-,6088,7572,255;0;0,2,148,149,0,1335,6236,7423,1187,0
18925ref,6055,7534,JUNC00000575,17,+,6055,7534,255;0;0,2,148,149,0,1330,6203,7385,1182,0
18925ref,972,2316,JUNC00000097,2,+,972,2316,255;0;0,2,19,148,0,1196,991,2168,1177,0
18925ref,4909,6256,JUNC00000516,5,-,4909,6256,255;0;0,2,56,130,0,1217,4965,6126,1161,0
18925ref,8773,10217,JUNC00000683,24,+,8773,10217,255;0;0,2,148,146,0,1298,8921,10071,1150,0
18925ref,7574,8959,JUNC00000637,10,-,7574,8959,255;0;0,2,111,139,0,1246,7685,8820,1135,0
18925ref,7790,9199,JUNC00000656,19,+,7790,9199,255;0;0,2,148,147,0,1262,7938,9052,1114,0
18925ref,7808,9184,JUNC00000659,8,+,7808,9184,255;0;0,2,148,114,0,1262,7956,9070,1114,0
18925ref,9188,10452,JUNC00000702,1,+,9188,10452,255;0;0,2,26,124,0,1140,9214,10328,1114,0
18925ref,1030,2295,JUNC00000121,5,+,1030,2295,255;0;0,2,25,145,0,1120,1055,2150,1095,0
18925ref,2638,3869,JUNC00000364,4,-,2638,3869,255;0;0,2,99,43,0,1188,2737,3826,1089,0
18925ref,5564,6800,JUNC00000545,23,+,5564,6800,255;0;0,2,31,150,0,1086,5595,6650,1055,0
18925ref,1262,2577,JUNC00000234,39,+,1262,2577,255;0;0,2,149,123,0,1192,1411,2454,1043,0
18925ref,965,2295,JUNC00000153,9,+,965,2295,255;0;0,2,146,148,0,1182,1111,2147,1036,0
18925ref,7955,9249,JUNC00000665,2,+,7955,9249,255;0;0,2,144,129,0,1165,8099,9120,1021,0
18925ref,871,2180,JUNC00000104,25,+,871,2180,255;0;0,2,144,146,0,1163,1015,2034,1019,0
18925ref,4987,6242,JUNC00000531,12,-,4987,6242,255;0;0,2,143,98,0,1157,5130,6144,1014,0
18925ref,1223,2367,JUNC00000222,2,-,1223,2367,255;0;0,2,144,15,0,1129,1367,2352,985,0
18925ref,6737,7875,JUNC00000608,34,+,6737,7875,255;0;0,2,150,8,0,1130,6887,7867,980,0
18925ref,7539,8740,JUNC00000636,9,-,7539,8740,255;0;0,2,146,83,0,1118,7685,8657,972,0
18925ref,9197,10428,JUNC00000713,18,+,9197,10428,255;0;0,2,145,145,0,1086,9342,10283,941,0
18925ref,1283,2364,JUNC00000209,53,+,1283,2364,255;0;0,2,12,139,0,942,1295,2225,930,0
18925ref,1072,2293,JUNC00000200,571,+,1072,2293,255;0;0,2,149,146,0,1075,1221,2147,926,0
18925ref,3961,5161,JUNC00000456,138,-,3961,5161,255;0;0,2,148,149,0,1051,4109,5012,903,0
18925ref,4882,6047,JUNC00000520,5,+,4882,6047,255;0;0,2,150,147,0,1018,5032,5900,868,0
18925ref,9107,10001,JUNC00000691,2,+,9107,10001,255;0;0,2,8,26,0,868,9115,9975,860,0
18925ref,7871,9019,JUNC00000660,34,-,7871,9019,255;0;0,2,147,150,0,998,8018,8869,851,0
18925ref,7679,8673,JUNC00000647,4,-,7679,8673,255;0;0,2,127,24,0,970,7806,8649,843,0
18925ref,9151,10275,JUNC00000710,8,+,9151,10275,255;0;0,2,146,142,0,982,9297,10133,836,0
18925ref,1551,2565,JUNC00000247,5,+,1551,2565,255;0;0,2,44,147,0,867,1595,2418,823,0
18925ref,7585,8621,JUNC00000643,120,+,7585,8621,255;0;0,2,146,75,0,961,7731,8546,815,0
18925ref,910,1992,JUNC00000120,19,+,910,1992,255;0;0,2,145,148,0,934,1055,1844,789,0
18925ref,8298,9237,JUNC00000669,10,+,8298,9237,255;0;0,2,18,140,0,799,8316,9097,781,0
18925ref,9081,10139,JUNC00000703,8,+,9081,10139,255;0;0,2,141,146,0,912,9222,9993,771,0
18925ref,9091,10137,JUNC00000707,67,+,9091,10137,255;0;0,2,146,144,0,902,9237,9993,756,0
18925ref,9497,10431,JUNC00000715,2,+,9497,10431,255;0;0,2,49,138,0,796,9546,10293,747,0
18925ref,527,1513,JUNC00000050,17,+,527,1513,255;0;0,2,129,115,0,871,656,1398,742,0
18925ref,1047,1942,JUNC00000133,13,-,1047,1942,255;0;0,2,21,147,0,748,1068,1795,727,0
18925ref,8194,9127,JUNC00000667,10,+,8194,9127,255;0;0,2,59,150,0,783,8253,8977,724,0
18925ref,1955,2950,JUNC00000289,96,+,1955,2950,255;0;0,2,149,150,0,845,2104,2800,696,0
18925ref,1877,2837,JUNC00000278,6,+,1877,2837,255;0;0,2,146,122,0,838,2023,2715,692,0
18925ref,4153,5137,JUNC00000464,11,-,4153,5137,255;0;0,2,147,149,0,835,4300,4988,688,0
18925ref,2296,3143,JUNC00000307,19,+,2296,3143,255;0;0,2,26,149,0,698,2322,2994,672,0
18925ref,1075,2031,JUNC00000199,41,+,1075,2031,255;0;0,2,146,146,0,810,1221,1885,664,0
18925ref,4277,5055,JUNC00000469,1,+,4277,5055,255;0;0,2,95,55,0,723,4372,5000,628,0
18925ref,1683,2565,JUNC00000258,26,+,1683,2565,255;0;0,2,110,147,0,735,1793,2418,625,0
18925ref,8177,9006,JUNC00000668,2,+,8177,9006,255;0;0,2,81,129,0,700,8258,8877,619,0
18925ref,6070,6981,JUNC00000582,14,+,6070,6981,255;0;0,2,149,150,0,761,6219,6831,612,0
18925ref,610,1330,JUNC00000053,7,-,610,1330,255;0;0,2,66,85,0,635,676,1245,569,0
18925ref,8810,9663,JUNC00000686,4,+,8810,9663,255;0;0,2,150,148,0,705,8960,9515,555,0
18925ref,1215,2024,JUNC00000218,6,-,1215,2024,255;0;0,2,148,115,0,694,1363,1909,546,0
18925ref,2342,3186,JUNC00000329,85,+,2342,3186,255;0;0,2,149,149,0,695,2491,3037,546,0
18925ref,2359,3196,JUNC00000331,26,+,2359,3196,255;0;0,2,142,149,0,688,2501,3047,546,0
18925ref,5114,5805,JUNC00000530,1,-,5114,5805,255;0;0,2,16,134,0,557,5130,5671,541,0
18925ref,3046,3874,JUNC00000408,60,+,3046,3874,255;0;0,2,150,146,0,682,3196,3728,532,0
18925ref,7448,8137,JUNC00000624,7,+,7448,8137,255;0;0,2,25,143,0,546,7473,7994,521,0
18925ref,2571,3377,JUNC00000359,9,+,2571,3377,255;0;0,2,144,145,0,661,2715,3232,517,0
18925ref,1638,2305,JUNC00000252,167,+,1638,2305,255;0;0,2,9,149,0,518,1647,2156,509,0
18925ref,305,1098,JUNC00000009,14,+,305,1098,255;0;0,2,149,149,0,644,454,949,495,0
18925ref,1060,1855,JUNC00000196,59,+,1060,1855,255;0;0,2,150,150,0,645,1210,1705,495,0
18925ref,3959,4616,JUNC00000455,4,-,3959,4616,255;0;0,2,148,16,0,641,4107,4600,493,0
18925ref,6041,6827,JUNC00000574,19,-,6041,6827,255;0;0,2,147,148,0,638,6188,6679,491,0
18925ref,1824,2483,JUNC00000270,15,+,1824,2483,255;0;0,2,148,25,0,634,1972,2458,486,0
18925ref,332,1101,JUNC00000026,45,-,332,1101,255;0;0,2,145,148,0,621,477,953,476,0
18925ref,889,1646,JUNC00000114,10,+,889,1646,255;0;0,2,149,147,0,610,1038,1499,461,0
18925ref,9026,9777,JUNC00000699,7,+,9026,9777,255;0;0,2,148,150,0,601,9174,9627,453,0
18925ref,6021,6742,JUNC00000568,3,-,6021,6742,255;0;0,2,147,149,0,572,6168,6593,425,0
18925ref,379,1098,JUNC00000030,24,+,379,1098,255;0;0,2,147,149,0,570,526,949,423,0
18925ref,8685,9387,JUNC00000678,11,+,8685,9387,255;0;0,2,147,140,0,562,8832,9247,415,0
18925ref,1338,2021,JUNC00000242,4,+,1338,2021,255;0;0,2,144,136,0,547,1482,1885,403,0
18925ref,9090,9647,JUNC00000706,20,+,9090,9647,255;0;0,2,147,8,0,549,9237,9639,402,0
18925ref,2477,3159,JUNC00000353,158,-,2477,3159,255;0;0,2,144,147,0,535,2621,3012,391,0
18925ref,6569,7126,JUNC00000599,304,-,6569,7126,255;0;0,2,26,149,0,408,6595,6977,382,0
18925ref,6569,7102,JUNC00000600,40,-,6569,7102,255;0;0,2,60,91,0,442,6629,7011,382,0
18925ref,6069,6737,JUNC00000581,20,+,6069,6737,255;0;0,2,150,141,0,527,6219,6596,377,0
18925ref,601,1148,JUNC00000046,41,+,601,1148,255;0;0,2,26,146,0,401,627,1002,375,0
18925ref,3797,4466,JUNC00000438,4,+,3797,4466,255;0;0,2,149,145,0,524,3946,4321,375,0
18925ref,3803,4354,JUNC00000439,11,+,3803,4354,255;0;0,2,145,31,0,520,3948,4323,375,0
18925ref,1300,1802,JUNC00000211,7,+,1300,1802,255;0;0,2,8,124,0,378,1308,1678,370,0
18925ref,624,1158,JUNC00000066,22,+,624,1158,255;0;0,2,149,16,0,518,773,1142,369,0
18925ref,2352,3003,JUNC00000330,271,+,2352,3003,255;0;0,2,149,147,0,504,2501,2856,355,0
18925ref,2694,3210,JUNC00000381,39,+,2694,3210,255;0;0,2,147,14,0,502,2841,3196,355,0
18925ref,9657,10285,JUNC00000721,29,+,9657,10285,255;0;0,2,146,149,0,479,9803,10136,333,0
18925ref,9678,10161,JUNC00000723,75,-,9678,10161,255;0;0,2,131,19,0,464,9809,10142,333,0
18925ref,9184,9672,JUNC00000712,23,+,9184,9672,255;0;0,2,149,8,0,480,9333,9664,331,0
18925ref,2692,3315,JUNC00000380,16,+,2692,3315,255;0;0,2,149,149,0,474,2841,3166,325,0
18925ref,5776,6254,JUNC00000551,4,+,5776,6254,255;0;0,2,8,148,0,330,5784,6106,322,0
18925ref,502,982,JUNC00000048,2,+,502,982,255;0;0,2,148,18,0,462,650,964,314,0
18925ref,1902,2475,JUNC00000284,8,-,1902,2475,255;0;0,2,145,121,0,452,2047,2354,307,0
18925ref,7371,7968,JUNC00000627,23,+,7371,7968,255;0;0,2,144,148,0,449,7515,7820,305,0
18925ref,877,1394,JUNC00000088,1129,-,877,1394,255;0;0,2,66,149,0,368,943,1245,302,0
18925ref,871,1453,JUNC00000103,110,+,871,1453,255;0;0,2,144,145,0,437,1015,1308,293,0
18925ref,4230,4682,JUNC00000472,17,-,4230,4682,255;0;0,2,145,15,0,437,4375,4667,292,0
18925ref,6089,6676,JUNC00000583,6,-,6089,6676,255;0;0,2,147,149,0,438,6236,6527,291,0
18925ref,979,1559,JUNC00000178,13,+,979,1559,255;0;0,2,148,143,0,437,1127,1416,289,0
18925ref,890,1415,JUNC00000096,77,+,890,1415,255;0;0,2,88,149,0,376,978,1266,288,0
18925ref,2629,3196,JUNC00000366,12,+,2629,3196,255;0;0,2,142,149,0,418,2771,3047,276,0
18925ref,7351,7806,JUNC00000623,26,-,7351,7806,255;0;0,2,58,121,0,334,7409,7685,276,0
18925ref,3693,4125,JUNC00000421,496,+,3693,4125,255;0;0,2,9,149,0,283,3702,3976,274,0
18925ref,1444,1877,JUNC00000239,3,+,1444,1877,255;0;0,2,21,145,0,288,1465,1732,267,0
18925ref,820,1384,JUNC00000094,8686,+,820,1384,255;0;0,2,149,150,0,414,969,1234,265,0
18925ref,967,1527,JUNC00000159,71,+,967,1527,255;0;0,2,147,150,0,410,1114,1377,263,0
18925ref,619,1127,JUNC00000060,34,+,619,1127,255;0;0,2,145,112,0,396,764,1015,251,0
18925ref,8470,8921,JUNC00000675,53,+,8470,8921,255;0;0,2,59,146,0,305,8529,8775,246,0
18925ref,980,1519,JUNC00000177,10,+,980,1519,255;0;0,2,147,147,0,392,1127,1372,245,0
18925ref,8283,8822,JUNC00000672,38,+,8283,8822,255;0;0,2,146,148,0,391,8429,8674,245,0
18925ref,5818,6265,JUNC00000557,4,-,5818,6265,255;0;0,2,55,149,0,298,5873,6116,243,0
18925ref,1298,1831,JUNC00000237,17,+,1298,1831,255;0;0,2,145,148,0,385,1443,1683,240,0
18925ref,4439,4824,JUNC00000474,3,-,4439,4824,255;0;0,2,47,104,0,281,4486,4720,234,0
18925ref,3857,4384,JUNC00000447,22,+,3857,4384,255;0;0,2,148,147,0,380,4005,4237,232,0
18925ref,4009,4403,JUNC00000449,13,+,4009,4403,255;0;0,2,16,146,0,248,4025,4257,232,0
18925ref,4517,4907,JUNC00000478,224,-,4517,4907,255;0;0,2,15,149,0,241,4532,4758,226,0
18925ref,5001,5387,JUNC00000532,18,+,5001,5387,255;0;0,2,150,10,0,376,5151,5377,226,0
18925ref,4714,5235,JUNC00000507,69,-,4714,5235,255;0;0,2,149,148,0,373,4863,5087,224,0
18925ref,9151,9631,JUNC00000709,9,+,9151,9631,255;0;0,2,146,116,0,364,9297,9515,218,0
18925ref,1747,2122,JUNC00000257,5,-,1747,2122,255;0;0,2,22,148,0,227,1769,1974,205,0
18925ref,8790,9277,JUNC00000685,49,+,8790,9277,255;0;0,2,138,145,0,342,8928,9132,204,0
18925ref,7428,7924,JUNC00000631,12,-,7428,7924,255;0;0,2,145,148,0,348,7573,7776,203,0
18925ref,8771,9271,JUNC00000682,20,-,8771,9271,255;0;0,2,150,149,0,351,8921,9122,201,0
18925ref,6023,6519,JUNC00000569,6,+,6023,6519,255;0;0,2,148,148,0,348,6171,6371,200,0
18925ref,6036,6529,JUNC00000573,4,+,6036,6529,255;0;0,2,147,146,0,347,6183,6383,200,0
18925ref,1072,1556,JUNC00000198,35,+,1072,1556,255;0;0,2,149,148,0,336,1221,1408,187,0
18925ref,3687,4152,JUNC00000429,4,-,3687,4152,255;0;0,2,150,137,0,328,3837,4015,178,0
18925ref,1058,1532,JUNC00000194,18,-,1058,1532,255;0;0,2,148,149,0,325,1206,1383,177,0
18925ref,1072,1542,JUNC00000197,34,+,1072,1542,255;0;0,2,149,144,0,326,1221,1398,177,0
18925ref,7539,8011,JUNC00000638,9,+,7539,8011,255;0;0,2,150,147,0,325,7689,7864,175,0
18925ref,7551,8019,JUNC00000640,67,+,7551,8019,255;0;0,2,148,146,0,322,7699,7873,174,0
18925ref,8429,8644,JUNC00000673,1,+,8429,8644,255;0;0,2,9,38,0,177,8438,8606,168,0
18925ref,9829,10150,JUNC00000725,2,+,9829,10150,255;0;0,2,65,90,0,231,9894,10060,166,0
18925ref,482,813,JUNC00000029,22,-,482,813,255;0;0,2,27,144,0,187,509,669,160,0
18925ref,570,1020,JUNC00000055,146,+,570,1020,255;0;0,2,147,149,0,301,717,871,154,0
18925ref,5866,6190,JUNC00000562,5,+,5866,6190,255;0;0,2,146,25,0,299,6012,6165,153,0
18925ref,4715,5154,JUNC00000504,14,+,4715,5154,255;0;0,2,146,145,0,294,4861,5009,148,0
18925ref,2251,2542,JUNC00000299,3,+,2251,2542,255;0;0,2,23,124,0,167,2274,2418,144,0
18925ref,4448,4887,JUNC00000484,9,+,4448,4887,255;0;0,2,150,147,0,292,4598,4740,142,0
18925ref,8014,8324,JUNC00000663,7,+,8014,8324,255;0;0,2,20,148,0,162,8034,8176,142,0
18925ref,9024,9443,JUNC00000695,5,+,9024,9443,255;0;0,2,134,146,0,273,9158,9297,139,0
18925ref,1106,1535,JUNC00000204,3,+,1106,1535,255;0;0,2,143,148,0,281,1249,1387,138,0
18925ref,1263,1589,JUNC00000233,122,+,1263,1589,255;0;0,2,148,41,0,285,1411,1548,137,0
18925ref,9662,9877,JUNC00000719,84,-,9662,9877,255;0;0,2,26,53,0,162,9688,9824,136,0
18925ref,3786,4087,JUNC00000427,2,-,3786,4087,255;0;0,2,18,148,0,153,3804,3939,135,0
18925ref,4508,4717,JUNC00000477,2,-,4508,4717,255;0;0,2,24,50,0,159,4532,4667,135,0
18925ref,4392,4811,JUNC00000479,11,-,4392,4811,255;0;0,2,147,137,0,282,4539,4674,135,0
18925ref,4519,4694,JUNC00000480,2,-,4519,4694,255;0;0,2,25,15,0,160,4544,4679,135,0
18925ref,3749,4169,JUNC00000433,38,+,3749,4169,255;0;0,2,145,144,0,276,3894,4025,131,0
18925ref,1695,1980,JUNC00000263,7,-,1695,1980,255;0;0,2,131,25,0,260,1826,1955,129,0
18925ref,2238,2665,JUNC00000316,240,-,2238,2665,255;0;0,2,150,150,0,277,2388,2515,127,0
18925ref,2335,2753,JUNC00000327,30,+,2335,2753,255;0;0,2,146,150,0,268,2481,2603,122,0
18925ref,91,413,JUNC00000002,166,+,91,413,255;0;0,2,115,89,0,233,206,324,118,0
18925ref,3165,3433,JUNC00000413,8,+,3165,3433,255;0;0,2,111,39,0,229,3276,3394,118,0
18925ref,700,1111,JUNC00000072,13,+,700,1111,255;0;0,2,146,149,0,262,846,962,116,0
18925ref,6516,6929,JUNC00000602,3,+,6516,6929,255;0;0,2,148,150,0,263,6664,6779,115,0
18925ref,2578,2907,JUNC00000361,3,+,2578,2907,255;0;0,2,148,67,0,262,2726,2840,114,0
18925ref,3653,3938,JUNC00000420,69,+,3653,3938,255;0;0,2,29,142,0,143,3682,3796,114,0
18925ref,4191,4602,JUNC00000466,2,+,4191,4602,255;0;0,2,148,149,0,262,4339,4453,114,0
18925ref,2137,2369,JUNC00000297,1,+,2137,2369,255;0;0,2,101,18,0,214,2238,2351,113,0
18925ref,2624,2992,JUNC00000363,30,-,2624,2992,255;0;0,2,106,149,0,219,2730,2843,113,0
18925ref,4728,4992,JUNC00000500,2,-,4728,4992,255;0;0,2,45,106,0,158,4773,4886,113,0
18925ref,4176,4570,JUNC00000465,125,+,4176,4570,255;0;0,2,147,135,0,259,4323,4435,112,0
18925ref,5226,5598,JUNC00000542,16,+,5226,5598,255;0;0,2,150,110,0,262,5376,5488,112,0
18925ref,2166,2574,JUNC00000302,21,+,2166,2574,255;0;0,2,150,148,0,260,2316,2426,110,0
18925ref,4758,5161,JUNC00000509,23,-,4758,5161,255;0;0,2,144,149,0,254,4902,5012,110,0
18925ref,762,1038,JUNC00000067,21,+,762,1038,255;0;0,2,21,146,0,130,783,892,109,0
18925ref,1511,1788,JUNC00000243,14,+,1511,1788,255;0;0,2,18,150,0,127,1529,1638,109,0
18925ref,7109,7387,JUNC00000617,2,+,7109,7387,255;0;0,2,19,150,0,128,7128,7237,109,0
18925ref,9704,10003,JUNC00000724,8,-,9704,10003,255;0;0,2,147,44,0,255,9851,9959,108,0
18925ref,1110,1507,JUNC00000206,6,+,1110,1507,255;0;0,2,146,144,0,253,1256,1363,107,0
18925ref,2228,2374,JUNC00000298,3,+,2228,2374,255;0;0,2,22,23,0,123,2250,2351,101,0
18925ref,1319,1703,JUNC00000238,7,+,1319,1703,255;0;0,2,146,138,0,246,1465,1565,100,0
18925ref,6619,6964,JUNC00000604,2,-,6619,6964,255;0;0,2,98,149,0,196,6717,6815,98,0
18925ref,6685,6970,JUNC00000605,19,-,6685,6970,255;0;0,2,38,149,0,136,6723,6821,98,0
18925ref,7138,7532,JUNC00000619,87,-,7138,7532,255;0;0,2,149,147,0,247,7287,7385,98,0
18925ref,1878,2256,JUNC00000280,27,+,1878,2256,255;0;0,2,150,133,0,245,2028,2123,95,0
18925ref,6521,6818,JUNC00000598,9,+,6521,6818,255;0;0,2,55,148,0,149,6576,6670,94,0
18925ref,2390,2777,JUNC00000334,14,-,2390,2777,255;0;0,2,146,148,0,239,2536,2629,93,0
18925ref,8761,9148,JUNC00000680,3,-,8761,9148,255;0;0,2,145,149,0,238,8906,8999,93,0
18925ref,2394,2778,JUNC00000335,189,-,2394,2778,255;0;0,2,150,142,0,242,2544,2636,92,0
18925ref,423,805,JUNC00000035,4,-,423,805,255;0;0,2,146,147,0,235,569,658,89,0
18925ref,7811,8053,JUNC00000658,9,+,7811,8053,255;0;0,2,145,9,0,233,7956,8044,88,0
18925ref,6263,6647,JUNC00000595,2,-,6263,6647,255;0;0,2,148,149,0,235,6411,6498,87,0
18925ref,10394,10631,JUNC00000735,1,+,10394,10631,255;0;0,2,107,43,0,194,10501,10588,87,0
18925ref,1790,2058,JUNC00000262,33,-,1790,2058,255;0;0,2,36,146,0,122,1826,1912,86,0
18925ref,570,824,JUNC00000038,18,+,570,824,255;0;0,2,19,150,0,104,589,674,85,0
18925ref,451,730,JUNC00000039,36,-,451,730,255;0;0,2,147,47,0,232,598,683,85,0
18925ref,4783,5075,JUNC00000503,15,-,4783,5075,255;0;0,2,62,145,0,147,4845,4930,85,0
18925ref,7259,7536,JUNC00000622,10,-,7259,7536,255;0;0,2,150,42,0,235,7409,7494,85,0
18925ref,6586,6831,JUNC00000606,12,-,6586,6831,255;0;0,2,143,19,0,226,6729,6812,83,0
18925ref,2522,2853,JUNC00000356,18,+,2522,2853,255;0;0,2,148,102,0,229,2670,2751,81,0
18925ref,9151,9522,JUNC00000708,26,+,9151,9522,255;0;0,2,146,144,0,227,9297,9378,81,0
18925ref,452,830,JUNC00000043,19,-,452,830,255;0;0,2,148,150,0,228,600,680,80,0
18925ref,7312,7544,JUNC00000620,3,+,7312,7544,255;0;0,2,10,142,0,90,7322,7402,80,0
18925ref,9029,9267,JUNC00000701,5,+,9029,9267,255;0;0,2,150,8,0,230,9179,9259,80,0
18925ref,8977,9345,JUNC00000693,74,+,8977,9345,255;0;0,2,143,148,0,220,9120,9197,77,0
18925ref,747,1020,JUNC00000069,6,+,747,1020,255;0;0,2,48,149,0,124,795,871,76,0
18925ref,7792,8166,JUNC00000657,5,+,7792,8166,255;0;0,2,148,150,0,224,7940,8016,76,0
18925ref,1607,1974,JUNC00000256,44,-,1607,1974,255;0;0,2,144,148,0,219,1751,1826,75,0
18925ref,589,958,JUNC00000057,26,+,589,958,255;0;0,2,149,146,0,223,738,812,74,0
18925ref,8884,9254,JUNC00000688,6,-,8884,9254,255;0;0,2,149,148,0,222,9033,9106,73,0
18925ref,3875,4140,JUNC00000435,5,-,3875,4140,255;0;0,2,44,149,0,116,3919,3991,72,0
18925ref,9079,9314,JUNC00000705,12,+,9079,9314,255;0;0,2,146,17,0,218,9225,9297,72,0
18925ref,525,886,JUNC00000052,80,+,525,886,255;0;0,2,149,141,0,220,674,745,71,0
18925ref,8033,8276,JUNC00000664,5,-,8033,8276,255;0;0,2,25,147,0,96,8058,8129,71,0
18925ref,8977,9333,JUNC00000692,13,+,8977,9333,255;0;0,2,143,145,0,211,9120,9188,68,0
18925ref,502,816,JUNC00000047,5,+,502,816,255;0;0,2,148,101,0,213,650,715,65,0
18925ref,1659,2023,JUNC00000259,2,-,1659,2023,255;0;0,2,150,149,0,215,1809,1874,65,0
18925ref,4888,5147,JUNC00000512,5,+,4888,5147,255;0;0,2,47,147,0,112,4935,5000,65,0
18925ref,618,879,JUNC00000051,7,+,618,879,255;0;0,2,49,149,0,112,667,730,63,0
18925ref,1702,1948,JUNC00000265,8,-,1702,1948,255;0;0,2,148,36,0,210,1850,1912,62,0
18925ref,8529,8883,JUNC00000677,16,+,8529,8883,255;0;0,2,145,147,0,207,8674,8736,62,0
18925ref,9010,9368,JUNC00000694,7,+,9010,9368,255;0;0,2,148,148,0,210,9158,9220,62,0
18925ref,10026,10388,JUNC00000733,6,+,10026,10388,255;0;0,2,150,150,0,212,10176,10238,62,0
18925ref,10049,10263,JUNC00000734,19,+,10049,10263,255;0;0,2,143,9,0,205,10192,10254,62,0
18925ref,2950,3165,JUNC00000399,5,+,2950,3165,255;0;0,2,97,59,0,156,3047,3106,59,0
18925ref,4359,4698,JUNC00000475,30,-,4359,4698,255;0;0,2,138,143,0,196,4497,4555,58,0
18925ref,4762,5006,JUNC00000510,6,-,4762,5006,255;0;0,2,145,41,0,203,4907,4965,58,0
18925ref,7699,8056,JUNC00000651,25,-,7699,8056,255;0;0,2,149,150,0,207,7848,7906,58,0
18925ref,953,1306,JUNC00000151,2842,-,953,1306,255;0;0,2,148,148,0,205,1101,1158,57,0
18925ref,9228,9569,JUNC00000714,15,+,9228,9569,255;0;0,2,150,134,0,207,9378,9435,57,0
18925ref,745,1085,JUNC00000078,54,+,745,1085,255;0;0,2,135,150,0,190,880,935,55,0
18925ref,5680,6030,JUNC00000554,22,+,5680,6030,255;0;0,2,150,146,0,204,5830,5884,54,0
18925ref,8294,8534,JUNC00000671,3,-,8294,8534,255;0;0,2,46,140,0,100,8340,8394,54,0
18925ref,825,1170,JUNC00000093,24,+,825,1170,255;0;0,2,144,148,0,197,969,1022,53,0
18925ref,2883,3233,JUNC00000398,5,+,2883,3233,255;0;0,2,150,147,0,203,3033,3086,53,0
18925ref,4249,4457,JUNC00000463,18,+,4249,4457,255;0;0,2,8,147,0,61,4257,4310,53,0
18925ref,6804,7155,JUNC00000613,24,+,6804,7155,255;0;0,2,150,149,0,202,6954,7006,52,0
18925ref,1134,1479,JUNC00000208,9,+,1134,1479,255;0;0,2,148,146,0,199,1282,1333,51,0
18925ref,1383,1731,JUNC00000244,24,-,1383,1731,255;0;0,2,147,150,0,198,1530,1581,51,0
18925ref,3037,3358,JUNC00000405,7,+,3037,3358,255;0;0,2,120,150,0,171,3157,3208,51,0
18925ref,3594,3913,JUNC00000423,3,-,3594,3913,255;0;0,2,122,146,0,173,3716,3767,51,0
18925ref,4867,5087,JUNC00000519,10,+,4867,5087,255;0;0,2,146,23,0,197,5013,5064,51,0
18925ref,6784,7132,JUNC00000611,36,-,6784,7132,255;0;0,2,150,147,0,201,6934,6985,51,0
18925ref,3758,4004,JUNC00000426,24,-,3758,4004,255;0;0,2,46,150,0,96,3804,3854,50,0
18925ref,2432,2776,JUNC00000343,21,+,2432,2776,255;0;0,2,148,147,0,197,2580,2629,49,0
18925ref,5680,6013,JUNC00000553,16,+,5680,6013,255;0;0,2,150,134,0,199,5830,5879,49,0
18925ref,620,958,JUNC00000059,53,+,620,958,255;0;0,2,144,146,0,192,764,812,48,0
18925ref,2540,2637,JUNC00000338,2,+,2540,2637,255;0;0,2,25,24,0,73,2565,2613,48,0
18925ref,7810,8029,JUNC00000650,7,+,7810,8029,255;0;0,2,22,149,0,70,7832,7880,48,0
18925ref,4946,5160,JUNC00000515,12,-,4946,5160,255;0;0,2,19,148,0,66,4965,5012,47,0
18925ref,8934,9251,JUNC00000689,4,-,8934,9251,255;0;0,2,122,148,0,169,9056,9103,47,0
18925ref,5627,5890,JUNC00000547,351,-,5627,5890,255;0;0,2,68,149,0,114,5695,5741,46,0
18925ref,2349,2568,JUNC00000314,5,+,2349,2568,255;0;0,2,24,150,0,69,2373,2418,45,0
18925ref,3755,3980,JUNC00000425,45,+,3755,3980,255;0;0,2,31,149,0,76,3786,3831,45,0
18925ref,7362,7582,JUNC00000626,4,-,7362,7582,255;0;0,2,149,26,0,194,7511,7556,45,0
18925ref,8928,9184,JUNC00000687,13,+,8928,9184,255;0;0,2,65,147,0,109,8993,9037,44,0
18925ref,889,1228,JUNC00000113,12,+,889,1228,255;0;0,2,149,147,0,192,1038,1081,43,0
18925ref,7658,7995,JUNC00000646,128,-,7658,7995,255;0;0,2,148,146,0,191,7806,7849,43,0
18925ref,9077,9342,JUNC00000704,15,+,9077,9342,255;0;0,2,148,74,0,191,9225,9268,43,0
18925ref,453,792,JUNC00000042,36,-,453,792,255;0;0,2,147,150,0,189,600,642,42,0
18925ref,1108,1304,JUNC00000205,39,+,1108,1304,255;0;0,2,145,9,0,187,1253,1295,42,0
18925ref,3844,4184,JUNC00000444,5,+,3844,4184,255;0;0,2,149,149,0,191,3993,4035,42,0
18925ref,9015,9212,JUNC00000696,10,+,9015,9212,255;0;0,2,147,8,0,189,9162,9204,42,0
18925ref,599,907,JUNC00000058,35,-,599,907,255;0;0,2,145,122,0,186,744,785,41,0
18925ref,746,1077,JUNC00000080,5,-,746,1077,255;0;0,2,145,145,0,186,891,932,41,0
18925ref,2417,2748,JUNC00000337,13,+,2417,2748,255;0;0,2,148,142,0,189,2565,2606,41,0
18925ref,7326,7525,JUNC00000621,2,-,7326,7525,255;0;0,2,9,149,0,50,7335,7376,41,0
18925ref,871,1199,JUNC00000102,33,+,871,1199,255;0;0,2,144,144,0,184,1015,1055,40,0
18925ref,949,1287,JUNC00000149,700,-,949,1287,255;0;0,2,150,148,0,190,1099,1139,40,0
18925ref,4418,4748,JUNC00000482,10,+,4418,4748,255;0;0,2,148,142,0,188,4566,4606,40,0
18925ref,5805,6015,JUNC00000560,5,-,5805,6015,255;0;0,2,148,22,0,188,5953,5993,40,0
18925ref,6361,6697,JUNC00000596,185,-,6361,6697,255;0;0,2,146,150,0,186,6507,6547,40,0
18925ref,935,1131,JUNC00000135,7,+,935,1131,255;0;0,2,148,9,0,187,1083,1122,39,0
18925ref,4618,4921,JUNC00000498,23,+,4618,4921,255;0;0,2,147,117,0,186,4765,4804,39,0
18925ref,5590,5924,JUNC00000549,49,+,5590,5924,255;0;0,2,146,149,0,185,5736,5775,39,0
18925ref,4092,4321,JUNC00000461,2,-,4092,4321,255;0;0,2,147,44,0,185,4239,4277,38,0
18925ref,5234,5519,JUNC00000543,56,+,5234,5519,255;0;0,2,146,101,0,184,5380,5418,38,0
18925ref,1537,1871,JUNC00000254,6,+,1537,1871,255;0;0,2,149,148,0,186,1686,1723,37,0
18925ref,2135,2467,JUNC00000300,12,+,2135,2467,255;0;0,2,146,150,0,182,2281,2317,36,0
18925ref,3782,4111,JUNC00000437,3,+,3782,4111,255;0;0,2,148,145,0,184,3930,3966,36,0
18925ref,5680,6012,JUNC00000552,29,+,5680,6012,255;0;0,2,150,146,0,186,5830,5866,36,0
18925ref,7513,7707,JUNC00000633,6,+,7513,7707,255;0;0,2,147,11,0,183,7660,7696,36,0
18925ref,9770,9991,JUNC00000722,95,-,9770,9991,255;0;0,2,39,146,0,75,9809,9845,36,0
18925ref,773,1102,JUNC00000083,92,-,773,1102,255;0;0,2,145,149,0,180,918,953,35,0
18925ref,2448,2783,JUNC00000349,2585,-,2448,2783,255;0;0,2,150,150,0,185,2598,2633,35,0
18925ref,8301,8634,JUNC00000674,6,+,8301,8634,255;0;0,2,148,150,0,183,8449,8484,35,0
18925ref,477,686,JUNC00000028,14,-,477,686,255;0;0,2,25,150,0,59,502,536,34,0
18925ref,2661,2989,JUNC00000370,14,+,2661,2989,255;0;0,2,145,149,0,179,2806,2840,34,0
18925ref,945,1276,JUNC00000140,39,+,945,1276,255;0;0,2,150,148,0,183,1095,1128,33,0
18925ref,1842,2167,JUNC00000272,12,+,1842,2167,255;0;0,2,147,145,0,180,1989,2022,33,0
18925ref,4817,5003,JUNC00000502,9,-,4817,5003,255;0;0,2,8,145,0,41,4825,4858,33,0
18925ref,730,1057,JUNC00000076,22,+,730,1057,255;0;0,2,148,147,0,180,878,910,32,0
18925ref,952,1278,JUNC00000150,136,-,952,1278,255;0;0,2,149,145,0,181,1101,1133,32,0
18925ref,3659,3984,JUNC00000428,6,-,3659,3984,255;0;0,2,148,146,0,179,3807,3838,31,0
18925ref,6915,7103,JUNC00000610,11,-,6915,7103,255;0;0,2,10,147,0,41,6925,6956,31,0
18925ref,3686,3964,JUNC00000424,121,+,3686,3964,255;0;0,2,100,148,0,130,3786,3816,30,0
18925ref,4203,4390,JUNC00000467,2,-,4203,4390,255;0;0,2,147,10,0,177,4350,4380,30,0
18925ref,4313,4405,JUNC00000468,47,-,4313,4405,255;0;0,2,39,23,0,69,4352,4382,30,0
18925ref,4228,4554,JUNC00000471,21,+,4228,4554,255;0;0,2,147,149,0,177,4375,4405,30,0
18925ref,9028,9212,JUNC00000698,14,+,9028,9212,255;0;0,2,146,8,0,176,9174,9204,30,0
18925ref,9238,9419,JUNC00000711,1,+,9238,9419,255;0;0,2,90,61,0,120,9328,9358,30,0
18925ref,864,1150,JUNC00000100,24,+,864,1150,255;0;0,2,138,119,0,167,1002,1031,29,0
18925ref,5594,5781,JUNC00000546,11,-,5594,5781,255;0;0,2,10,148,0,39,5604,5633,29,0
18925ref,7385,7605,JUNC00000628,34,-,7385,7605,255;0;0,2,142,49,0,171,7527,7556,29,0
18925ref,1522,1842,JUNC00000253,4,+,1522,1842,255;0;0,2,146,146,0,174,1668,1696,28,0
18925ref,2696,3024,JUNC00000384,32,+,2696,3024,255;0;0,2,150,150,0,178,2846,2874,28,0
18925ref,3134,3434,JUNC00000412,86,-,3134,3434,255;0;0,2,123,150,0,150,3257,3284,27,0
18925ref,3687,3876,JUNC00000422,48,-,3687,3876,255;0;0,2,29,133,0,56,3716,3743,27,0
18925ref,964,1145,JUNC00000152,12,+,964,1145,255;0;0,2,147,8,0,173,1111,1137,26,0
18925ref,3022,3211,JUNC00000407,202,+,3022,3211,255;0;0,2,149,15,0,174,3171,3196,25,0
18925ref,5397,5718,JUNC00000544,10,+,5397,5718,255;0;0,2,146,150,0,171,5543,5568,25,0
18925ref,9456,9737,JUNC00000716,40,+,9456,9737,255;0;0,2,106,150,0,131,9562,9587,25,0
18925ref,1030,1224,JUNC00000119,80,+,1030,1224,255;0;0,2,25,145,0,49,1055,1079,24,0
18925ref,1234,1527,JUNC00000216,62,+,1234,1527,255;0;0,2,119,150,0,143,1353,1377,24,0
18925ref,2834,3153,JUNC00000396,14,+,2834,3153,255;0;0,2,148,147,0,172,2982,3006,24,0
18925ref,1978,2299,JUNC00000290,7,+,1978,2299,255;0;0,2,149,149,0,172,2127,2150,23,0
18925ref,1991,2311,JUNC00000292,5,+,1991,2311,255;0;0,2,147,150,0,170,2138,2161,23,0
18925ref,4235,4555,JUNC00000473,89,+,4235,4555,255;0;0,2,147,150,0,170,4382,4405,23,0
18925ref,9944,10139,JUNC00000727,10,+,9944,10139,255;0;0,2,26,146,0,49,9970,9993,23,0
18925ref,1103,1419,JUNC00000203,7,+,1103,1419,255;0;0,2,146,149,0,167,1249,1270,21,0
18925ref,2330,2636,JUNC00000324,38,+,2330,2636,255;0;0,2,137,148,0,158,2467,2488,21,0
18925ref,4922,5229,JUNC00000522,3,-,4922,5229,255;0;0,2,144,142,0,165,5066,5087,21,0
18925ref,8282,8506,JUNC00000670,11,-,8282,8506,255;0;0,2,58,145,0,79,8340,8361,21,0
18925ref,7402,7712,JUNC00000629,80,+,7402,7712,255;0;0,2,140,150,0,160,7542,7562,20,0
18925ref,451,767,JUNC00000041,46,-,451,767,255;0;0,2,149,148,0,168,600,619,19,0
18925ref,2438,2629,JUNC00000323,19,-,2438,2629,255;0;0,2,26,146,0,45,2464,2483,19,0
18925ref,7766,8080,JUNC00000655,25,-,7766,8080,255;0;0,2,150,145,0,169,7916,7935,19,0
18925ref,511,821,JUNC00000049,18,+,511,821,255;0;0,2,145,147,0,163,656,674,18,0
18925ref,2335,2646,JUNC00000326,10,+,2335,2646,255;0;0,2,146,147,0,164,2481,2499,18,0
18925ref,4637,4926,JUNC00000497,38,+,4637,4926,255;0;0,2,128,143,0,146,4765,4783,18,0
18925ref,2624,2893,JUNC00000362,7,-,2624,2893,255;0;0,2,106,146,0,123,2730,2747,17,0
18925ref,7963,8165,JUNC00000666,104,-,7963,8165,255;0;0,2,149,36,0,166,8112,8129,17,0
18925ref,9518,9829,JUNC00000718,9,+,9518,9829,255;0;0,2,147,147,0,164,9665,9682,17,0
18925ref,2668,2949,JUNC00000372,26,-,2668,2949,255;0;0,2,148,117,0,164,2816,2832,16,0
18925ref,5902,6214,JUNC00000564,206,+,5902,6214,255;0;0,2,148,148,0,164,6050,6066,16,0
18925ref,6983,7220,JUNC00000615,120,+,6983,7220,255;0;0,2,90,131,0,106,7073,7089,16,0
18925ref,10028,10340,JUNC00000732,201,+,10028,10340,255;0;0,2,148,148,0,164,10176,10192,16,0
18925ref,945,1131,JUNC00000139,20,+,945,1131,255;0;0,2,150,21,0,165,1095,1110,15,0
18925ref,2436,2749,JUNC00000344,15,+,2436,2749,255;0;0,2,148,150,0,163,2584,2599,15,0
18925ref,2448,2763,JUNC00000348,56,+,2448,2763,255;0;0,2,150,150,0,165,2598,2613,15,0
18925ref,5605,5892,JUNC00000548,3,-,5605,5892,255;0;0,2,124,148,0,139,5729,5744,15,0
18925ref,7725,8034,JUNC00000653,85,+,7725,8034,255;0;0,2,148,146,0,163,7873,7888,15,0
18925ref,9987,10161,JUNC00000730,19,+,9987,10161,255;0;0,2,150,9,0,165,10137,10152,15,0
18925ref,4201,4418,JUNC00000462,32,+,4201,4418,255;0;0,2,56,147,0,70,4257,4271,14,0
18925ref,979,1150,JUNC00000110,12,-,979,1150,255;0;0,2,45,113,0,58,1024,1037,13,0
18925ref,2389,2698,JUNC00000333,8,-,2389,2698,255;0;0,2,147,149,0,160,2536,2549,13,0
18925ref,2418,2721,JUNC00000336,44,+,2418,2721,255;0;0,2,147,143,0,160,2565,2578,13,0
18925ref,5695,5992,JUNC00000555,47,+,5695,5992,255;0;0,2,146,138,0,159,5841,5854,13,0
18925ref,8775,9076,JUNC00000681,8,+,8775,9076,255;0;0,2,140,148,0,153,8915,8928,13,0
18925ref,796,1101,JUNC00000087,45,-,796,1101,255;0;0,2,147,146,0,159,943,955,12,0
18925ref,2260,2568,JUNC00000317,35,+,2260,2568,255;0;0,2,146,150,0,158,2406,2418,12,0
18925ref,10078,10285,JUNC00000729,6,+,10078,10285,255;0;0,2,46,149,0,58,10124,10136,12,0
18925ref,812,1026,JUNC00000075,16,+,812,1026,255;0;0,2,55,148,0,66,867,878,11,0
18925ref,953,1220,JUNC00000132,5,-,953,1220,255;0;0,2,115,141,0,126,1068,1079,11,0
18925ref,1991,2297,JUNC00000291,13,+,1991,2297,255;0;0,2,145,150,0,156,2136,2147,11,0
18925ref,452,756,JUNC00000040,6,-,452,756,255;0;0,2,148,146,0,158,600,610,10,0
18925ref,800,1102,JUNC00000086,93,-,800,1102,255;0;0,2,143,149,0,153,943,953,10,0
18925ref,848,1153,JUNC00000098,15,+,848,1153,255;0;0,2,148,147,0,158,996,1006,10,0
18925ref,4574,4760,JUNC00000493,11,+,4574,4760,255;0;0,2,150,26,0,160,4724,4734,10,0
18925ref,7628,7808,JUNC00000644,23,-,7628,7808,255;0;0,2,148,22,0,158,7776,7786,10,0
18925ref,7890,8088,JUNC00000662,86,+,7890,8088,255;0;0,2,144,44,0,154,8034,8044,10,0
18925ref,9606,9781,JUNC00000717,3,+,9606,9781,255;0;0,2,21,144,0,31,9627,9637,10,0
18925ref,305,608,JUNC00000008,39,+,305,608,255;0;0,2,149,145,0,158,454,463,9,0
18925ref,2169,2336,JUNC00000294,2,+,2169,2336,255;0;0,2,13,145,0,22,2182,2191,9,0
18925ref,4790,4967,JUNC00000511,4,+,4790,4967,255;0;0,2,145,23,0,154,4935,4944,9,0
18925ref,4917,5119,JUNC00000514,5,-,4917,5119,255;0;0,2,48,145,0,57,4965,4974,9,0
18925ref,7730,7962,JUNC00000645,31,-,7730,7962,255;0;0,2,76,147,0,85,7806,7815,9,0
18925ref,9030,9197,JUNC00000700,13,+,9030,9197,255;0;0,2,149,9,0,158,9179,9188,9,0
18925ref,9976,10280,JUNC00000728,10,+,9976,10280,255;0;0,2,148,147,0,157,10124,10133,9,0
18925ref,867,1048,JUNC00000079,9,-,867,1048,255;0;0,2,24,149,0,32,891,899,8,0
18925ref,808,991,JUNC00000091,2340,+,808,991,255;0;0,2,150,25,0,158,958,966,8,0
18925ref,969,1269,JUNC00000158,12,+,969,1269,255;0;0,2,145,147,0,153,1114,1122,8,0
18925ref,1002,1305,JUNC00000190,856,-,1002,1305,255;0;0,2,148,147,0,156,1150,1158,8,0
18925ref,2271,2574,JUNC00000319,61,+,2271,2574,255;0;0,2,147,148,0,155,2418,2426,8,0
18925ref,3205,3364,JUNC00000411,1,+,3205,3364,255;0;0,2,19,132,0,27,3224,3232,8,0
18925ref,4133,4317,JUNC00000459,2,-,4133,4317,255;0;0,2,28,148,0,36,4161,4169,8,0
18925ref,10007,10305,JUNC00000731,31,+,10007,10305,255;0;0,2,148,142,0,156,10155,10163,8,0
18925ref,84,242,JUNC00000001,63,+,84,242,255;0;0,2,122,29,0,129,206,213,7,0
18925ref,824,1126,JUNC00000092,829,+,824,1126,255;0;0,2,145,150,0,152,969,976,7,0
18925ref,1740,2027,JUNC00000267,5,+,1740,2027,255;0;0,2,145,135,0,152,1885,1892,7,0
18925ref,4228,4405,JUNC00000470,8,-,4228,4405,255;0;0,2,147,23,0,154,4375,4382,7,0
18925ref,7884,8058,JUNC00000661,8,+,7884,8058,255;0;0,2,150,17,0,157,8034,8041,7,0
18925ref,423,725,JUNC00000036,6,+,423,725,255;0;0,2,148,148,0,154,571,577,6,0
18925ref,750,907,JUNC00000068,2,+,750,907,255;0;0,2,45,106,0,51,795,801,6,0
18925ref,1696,1994,JUNC00000264,17,+,1696,1994,255;0;0,2,144,148,0,150,1840,1846,6,0
18925ref,2344,2643,JUNC00000328,10,+,2344,2643,255;0;0,2,147,146,0,153,2491,2497,6,0
18925ref,2444,2748,JUNC00000346,60,+,2444,2748,255;0;0,2,149,149,0,155,2593,2599,6,0
18925ref,4943,5243,JUNC00000524,6,+,4943,5243,255;0;0,2,148,146,0,154,5091,5097,6,0
18925ref,5729,6028,JUNC00000558,6,+,5729,6028,255;0;0,2,149,144,0,155,5878,5884,6,0
18925ref,6070,6233,JUNC00000580,3,+,6070,6233,255;0;0,2,149,8,0,155,6219,6225,6,0
18925ref,7019,7197,JUNC00000614,94,-,7019,7197,255;0;0,2,27,145,0,33,7046,7052,6,0
18925ref,8952,9257,JUNC00000690,24,-,8952,9257,255;0;0,2,150,149,0,156,9102,9108,6,0
18925ref,9564,9865,JUNC00000720,8,-,9564,9865,255;0;0,2,149,146,0,155,9713,9719,6,0
18925ref,9804,10108,JUNC00000726,7,-,9804,10108,255;0;0,2,149,149,0,155,9953,9959,6,0
18925ref,707,1007,JUNC00000073,14,-,707,1007,255;0;0,2,148,147,0,153,855,860,5,0
18925ref,1262,1559,JUNC00000232,30,+,1262,1559,255;0;0,2,149,143,0,154,1411,1416,5,0
18925ref,2204,2505,JUNC00000310,4,-,2204,2505,255;0;0,2,150,146,0,155,2354,2359,5,0
18925ref,2417,2464,JUNC00000322,3,+,2417,2464,255;0;0,2,19,23,0,24,2436,2441,5,0
18925ref,2335,2631,JUNC00000325,6,+,2335,2631,255;0;0,2,146,145,0,151,2481,2486,5,0
18925ref,2934,3169,JUNC00000397,15,-,2934,3169,255;0;0,2,82,148,0,87,3016,3021,5,0
18925ref,7423,7602,JUNC00000630,20,-,7423,7602,255;0;0,2,150,24,0,155,7573,7578,5,0
18925ref,8714,8869,JUNC00000679,1,+,8714,8869,255;0;0,2,122,28,0,127,8836,8841,5,0
18925ref,8780,9078,JUNC00000684,14525,+,8780,9078,255;0;0,2,143,150,0,148,8923,8928,5,0
18925ref,9018,9319,JUNC00000697,8,+,9018,9319,255;0;0,2,148,148,0,153,9166,9171,5,0
17582ref1,174,5862,JUNC00000001,1790,+,174,5862,255;0;0,2,150,87,0,5601,324,5775,5451,0
17582ref1,378,1010,JUNC00000002,3,-,378,1010,255;0;0,2,126,150,0,482,504,860,356,0
17582ref1,384,789,JUNC00000003,1129,+,384,789,255;0;0,2,150,133,0,272,534,656,122,0
17582ref1,478,732,JUNC00000004,21,-,478,732,255;0;0,2,120,49,0,205,598,683,85,0
17582ref1,629,1149,JUNC00000005,23,+,629,1149,255;0;0,2,27,147,0,373,656,1002,346,0
17582ref1,554,1161,JUNC00000006,21,+,554,1161,255;0;0,2,102,146,0,461,656,1015,359,0
17582ref1,522,870,JUNC00000007,53,+,522,870,255;0;0,2,145,149,0,199,667,721,54,0
17582ref1,666,828,JUNC00000008,13,+,666,828,255;0;0,2,8,148,0,14,674,680,6,0
17582ref1,556,765,JUNC00000009,3,+,556,765,255;0;0,2,118,20,0,189,674,745,71,0
17582ref1,620,1163,JUNC00000010,8,+,620,1163,255;0;0,2,54,148,0,395,674,1015,341,0
17582ref1,687,1013,JUNC00000011,20,+,687,1013,255;0;0,2,23,149,0,177,710,864,154,0
17582ref1,663,1019,JUNC00000012,97,+,663,1019,255;0;0,2,54,148,0,208,717,871,154,0
17582ref1,620,1141,JUNC00000013,6,+,620,1141,255;0;0,2,110,126,0,395,730,1015,285,0
17582ref1,731,982,JUNC00000014,213,+,731,982,255;0;0,2,64,150,0,101,795,832,37,0
17582ref1,680,1163,JUNC00000015,98,+,680,1163,255;0;0,2,146,148,0,335,826,1015,189,0
17582ref1,711,876,JUNC00000016,9,-,711,876,255;0;0,2,149,10,0,155,860,866,6,0
17582ref1,721,1028,JUNC00000017,48,+,721,1028,255;0;0,2,146,150,0,157,867,878,11,0
17582ref1,772,1084,JUNC00000018,6,-,772,1084,255;0;0,2,150,149,0,163,922,935,13,0
17582ref1,898,1098,JUNC00000019,15,+,898,1098,255;0;0,2,45,149,0,51,943,949,6,0
17582ref1,898,1125,JUNC00000020,20,+,898,1125,255;0;0,2,45,149,0,78,943,976,33,0
17582ref1,824,1125,JUNC00000021,112,+,824,1125,255;0;0,2,145,149,0,152,969,976,7,0
17582ref1,826,1171,JUNC00000022,26,+,826,1171,255;0;0,2,143,149,0,196,969,1022,53,0
17582ref1,871,1452,JUNC00000023,60,+,871,1452,255;0;0,2,144,144,0,437,1015,1308,293,0
17582ref1,871,9556,JUNC00000024,73,+,871,9556,255;0;0,2,144,145,0,8540,1015,9411,8396,0
17582ref1,946,1277,JUNC00000025,10,+,946,1277,255;0;0,2,149,149,0,182,1095,1128,33,0
17582ref1,953,1283,JUNC00000026,15,-,953,1283,255;0;0,2,148,150,0,180,1101,1133,32,0
17582ref1,955,1308,JUNC00000027,692,-,955,1308,255;0;0,2,146,150,0,203,1101,1158,57,0
17582ref1,962,1283,JUNC00000028,11,+,962,1283,255;0;0,2,149,150,0,171,1111,1133,22,0
17582ref1,966,1295,JUNC00000029,6,+,966,1295,255;0;0,2,145,150,0,179,1111,1145,34,0
17582ref1,975,1283,JUNC00000030,6,+,975,1283,255;0;0,2,141,150,0,158,1116,1133,17,0
17582ref1,974,1275,JUNC00000031,5,+,974,1275,255;0;0,2,148,147,0,154,1122,1128,6,0
17582ref1,974,9296,JUNC00000032,58,+,974,9296,255;0;0,2,148,145,0,8177,1122,9151,8029,0
17582ref1,977,1297,JUNC00000033,43,+,977,1297,255;0;0,2,150,150,0,170,1127,1147,20,0
17582ref1,1000,1312,JUNC00000034,38,+,1000,1312,255;0;0,2,148,149,0,163,1148,1163,15,0
17582ref1,1001,1308,JUNC00000035,90,-,1001,1308,255;0;0,2,149,150,0,157,1150,1158,8,0
17582ref1,1128,5685,JUNC00000036,1,-,1128,5685,255;0;0,2,51,72,0,4485,1179,5613,4434,0
17582ref1,1075,1506,JUNC00000037,6,-,1075,1506,255;0;0,2,149,148,0,283,1224,1358,134,0
17582ref1,1125,1363,JUNC00000038,22,+,1125,1363,255;0;0,2,145,48,0,190,1270,1315,45,0
17582ref1,1128,1460,JUNC00000039,93,+,1128,1460,255;0;0,2,142,83,0,249,1270,1377,107,0
17582ref1,1234,1792,JUNC00000040,13,+,1234,1792,255;0;0,2,38,149,0,409,1272,1643,371,0
17582ref1,1161,1781,JUNC00000041,45,+,1161,1781,255;0;0,2,147,103,0,517,1308,1678,370,0
17582ref1,1308,1792,JUNC00000042,2,-,1308,1792,255;0;0,2,150,149,0,335,1458,1643,185,0
17582ref1,1445,1821,JUNC00000043,3,+,1445,1821,255;0;0,2,26,147,0,229,1471,1674,203,0
17582ref1,1683,2120,JUNC00000044,47,+,1683,2120,255;0;0,2,66,148,0,289,1749,1972,223,0
17582ref1,1608,1972,JUNC00000045,52,-,1608,1972,255;0;0,2,143,146,0,218,1751,1826,75,0
17582ref1,1724,2058,JUNC00000046,7,-,1724,2058,255;0;0,2,102,146,0,188,1826,1912,86,0
17582ref1,1824,2032,JUNC00000047,2,+,1824,2032,255;0;0,2,14,126,0,82,1838,1906,68,0
17582ref1,1759,2061,JUNC00000048,11,-,1759,2061,255;0;0,2,101,149,0,153,1860,1912,52,0
17582ref1,1858,2164,JUNC00000049,18,+,1858,2164,255;0;0,2,149,150,0,156,2007,2014,7,0
17582ref1,1892,2268,JUNC00000050,274,+,1892,2268,255;0;0,2,142,118,0,258,2034,2150,116,0
17582ref1,1967,2502,JUNC00000051,80,-,1967,2502,255;0;0,2,80,148,0,387,2047,2354,307,0
17582ref1,2153,2473,JUNC00000052,40,+,2153,2473,255;0;0,2,72,146,0,174,2225,2327,102,0
17582ref1,2211,9581,JUNC00000053,13,+,2211,9581,255;0;0,2,136,150,0,7220,2347,9431,7084,0
17582ref1,2238,2555,JUNC00000054,10,+,2238,2555,255;0;0,2,150,148,0,169,2388,2407,19,0
17582ref1,2346,2799,JUNC00000055,99,+,2346,2799,255;0;0,2,47,147,0,306,2393,2652,259,0
17582ref1,2372,2557,JUNC00000056,71,+,2372,2557,255;0;0,2,24,150,0,35,2396,2407,11,0
17582ref1,2467,2638,JUNC00000057,4,+,2467,2638,255;0;0,2,8,148,0,23,2475,2490,15,0
17582ref1,2346,2665,JUNC00000058,6,-,2346,2665,255;0;0,2,147,49,0,270,2493,2616,123,0
17582ref1,2484,2798,JUNC00000059,2,-,2484,2798,255;0;0,2,52,146,0,168,2536,2652,116,0
17582ref1,2418,2757,JUNC00000060,4,-,2418,2757,255;0;0,2,148,149,0,190,2566,2608,42,0
17582ref1,2432,2777,JUNC00000061,19,+,2432,2777,255;0;0,2,148,148,0,197,2580,2629,49,0
17582ref1,2558,2748,JUNC00000062,8,+,2558,2748,255;0;0,2,26,149,0,41,2584,2599,15,0
17582ref1,2450,2782,JUNC00000063,146,-,2450,2782,255;0;0,2,148,149,0,183,2598,2633,35,0
17582ref1,2478,2817,JUNC00000064,13,+,2478,2817,255;0;0,2,143,147,0,192,2621,2670,49,0
17582ref1,2482,2786,JUNC00000065,2,+,2482,2786,255;0;0,2,149,148,0,156,2631,2638,7,0
17582ref1,2527,2974,JUNC00000066,12,-,2527,2974,255;0;0,2,148,149,0,298,2675,2825,150,0
17582ref1,2766,9786,JUNC00000067,2,+,2766,9786,255;0;0,2,21,147,0,6873,2787,9639,6852,0
17582ref1,2659,3005,JUNC00000068,32,+,2659,3005,255;0;0,2,147,147,0,199,2806,2858,52,0
17582ref1,2668,2980,JUNC00000069,8,-,2668,2980,255;0;0,2,148,148,0,164,2816,2832,16,0
17582ref1,2675,2959,JUNC00000070,20,+,2675,2959,255;0;0,2,148,101,0,183,2823,2858,35,0
17582ref1,2683,3014,JUNC00000071,107,+,2683,3014,255;0;0,2,147,148,0,183,2830,2866,36,0
17582ref1,2744,3107,JUNC00000072,7,+,2744,3107,255;0;0,2,149,146,0,217,2893,2961,68,0
17582ref1,2941,3346,JUNC00000073,78,+,2941,3346,255;0;0,2,147,150,0,255,3088,3196,108,0
17582ref1,3085,6220,JUNC00000074,2,-,3085,6220,255;0;0,2,16,148,0,2987,3101,6072,2971,0
17582ref1,3200,3434,JUNC00000075,21,-,3200,3434,255;0;0,2,57,150,0,84,3257,3284,27,0
17582ref1,3836,4043,JUNC00000076,59,+,3836,4043,255;0;0,2,31,149,0,58,3867,3894,27,0
17582ref1,3899,8630,JUNC00000077,4,-,3899,8630,255;0;0,2,20,150,0,4581,3919,8480,4561,0
17582ref1,3910,4109,JUNC00000078,20,+,3910,4109,255;0;0,2,20,148,0,51,3930,3961,31,0
17582ref1,3904,4180,JUNC00000079,38,+,3904,4180,255;0;0,2,26,147,0,129,3930,4033,103,0
17582ref1,4050,4268,JUNC00000080,423,+,4050,4268,255;0;0,2,25,147,0,71,4075,4121,46,0
17582ref1,3960,4326,JUNC00000081,7,-,3960,4326,255;0;0,2,149,150,0,216,4109,4176,67,0
17582ref1,3963,4390,JUNC00000082,14,-,3963,4390,255;0;0,2,146,150,0,277,4109,4240,131,0
17582ref1,4200,4394,JUNC00000083,8,+,4200,4394,255;0;0,2,23,147,0,47,4223,4247,24,0
17582ref1,4209,9065,JUNC00000084,18,-,4209,9065,255;0;0,2,39,148,0,4708,4248,8917,4669,0
17582ref1,4231,4418,JUNC00000085,16,+,4231,4418,255;0;0,2,26,147,0,40,4257,4271,14,0
17582ref1,4227,4459,JUNC00000086,14,+,4227,4459,255;0;0,2,30,149,0,83,4257,4310,53,0
17582ref1,4176,4510,JUNC00000087,197,+,4176,4510,255;0;0,2,147,75,0,259,4323,4435,112,0
17582ref1,4233,4708,JUNC00000088,10,+,4233,4708,255;0;0,2,131,135,0,340,4364,4573,209,0
17582ref1,4225,4551,JUNC00000089,24,+,4225,4551,255;0;0,2,150,146,0,180,4375,4405,30,0
17582ref1,4228,4584,JUNC00000090,59,+,4228,4584,255;0;0,2,147,149,0,207,4375,4435,60,0
17582ref1,4302,4647,JUNC00000091,23,-,4302,4647,255;0;0,2,135,150,0,195,4437,4497,60,0
17582ref1,4430,4677,JUNC00000092,156,-,4430,4677,255;0;0,2,67,122,0,125,4497,4555,58,0
17582ref1,4444,4766,JUNC00000093,287,-,4444,4766,255;0;0,2,88,99,0,223,4532,4667,135,0
17582ref1,4402,4763,JUNC00000094,178,-,4402,4763,255;0;0,2,137,89,0,272,4539,4674,135,0
17582ref1,4436,7216,JUNC00000095,4249,+,4436,7216,255;0;0,2,130,150,0,2630,4566,7066,2500,0
17582ref1,4549,4873,JUNC00000096,151,-,4549,4873,255;0;0,2,118,147,0,177,4667,4726,59,0
17582ref1,4524,7749,JUNC00000097,40,+,4524,7749,255;0;0,2,150,149,0,3076,4674,7600,2926,0
17582ref1,4537,9062,JUNC00000098,12,+,4537,9062,255;0;0,2,147,149,0,4376,4684,8913,4229,0
17582ref1,4546,5000,JUNC00000099,15,+,4546,5000,255;0;0,2,149,147,0,307,4695,4853,158,0
17582ref1,4600,9077,JUNC00000100,28,+,4600,9077,255;0;0,2,99,149,0,4328,4699,8928,4229,0
17582ref1,4579,8587,JUNC00000101,15,+,4579,8587,255;0;0,2,142,149,0,3859,4721,8438,3717,0
17582ref1,4580,5255,JUNC00000102,101,+,4580,5255,255;0;0,2,148,148,0,527,4728,5107,379,0
17582ref1,4632,4933,JUNC00000103,1480,+,4632,4933,255;0;0,2,133,150,0,151,4765,4783,18,0
17582ref1,4835,4999,JUNC00000104,3,-,4835,4999,255;0;0,2,8,146,0,18,4843,4853,10,0
17582ref1,4749,5158,JUNC00000105,2,+,4749,5158,255;0;0,2,147,149,0,260,4896,5009,113,0
17582ref1,4873,5151,JUNC00000106,41,-,4873,5151,255;0;0,2,107,149,0,129,4980,5002,22,0
17582ref1,4948,9505,JUNC00000107,190,+,4948,9505,255;0;0,2,143,94,0,4463,5091,9411,4320,0
17582ref1,5250,5764,JUNC00000108,1548,+,5250,5764,255;0;0,2,150,133,0,381,5400,5631,231,0
17582ref1,5346,5612,JUNC00000109,3,+,5346,5612,255;0;0,2,114,147,0,119,5460,5465,5,0
17582ref1,5610,5923,JUNC00000110,18,+,5610,5923,255;0;0,2,126,148,0,165,5736,5775,39,0
17582ref1,5794,6032,JUNC00000111,4,+,5794,6032,255;0;0,2,36,148,0,90,5830,5884,54,0
17582ref1,5730,6090,JUNC00000112,31,-,5730,6090,255;0;0,2,148,149,0,211,5878,5941,63,0
17582ref1,5807,6035,JUNC00000113,2,-,5807,6035,255;0;0,2,146,42,0,186,5953,5993,40,0
17582ref1,5826,6157,JUNC00000114,8,+,5826,6157,255;0;0,2,148,150,0,181,5974,6007,33,0
17582ref1,6010,6278,JUNC00000115,39,-,6010,6278,255;0;0,2,72,147,0,121,6082,6131,49,0
17582ref1,6103,6302,JUNC00000116,30,+,6103,6302,255;0;0,2,146,25,0,174,6249,6277,28,0
17582ref1,6121,7658,JUNC00000117,83,-,6121,7658,255;0;0,2,128,52,0,1485,6249,7606,1357,0
17582ref1,6482,6716,JUNC00000118,2,+,6482,6716,255;0;0,2,20,147,0,87,6502,6569,67,0
17582ref1,6732,6965,JUNC00000119,28,-,6732,6965,255;0;0,2,46,147,0,86,6778,6818,40,0
17582ref1,6738,7048,JUNC00000120,15,+,6738,7048,255;0;0,2,149,149,0,161,6887,6899,12,0
17582ref1,6792,7180,JUNC00000121,294,-,6792,7180,255;0;0,2,150,149,0,239,6942,7031,89,0
17582ref1,6815,7121,JUNC00000122,2,-,6815,7121,255;0;0,2,146,150,0,156,6961,6971,10,0
17582ref1,6833,7524,JUNC00000123,574,+,6833,7524,255;0;0,2,150,145,0,546,6983,7379,396,0
17582ref1,6900,7175,JUNC00000124,41,-,6900,7175,255;0;0,2,117,150,0,125,7017,7025,8,0
17582ref1,6929,7640,JUNC00000125,2,+,6929,7640,255;0;0,2,144,146,0,565,7073,7494,421,0
17582ref1,7171,7689,JUNC00000126,3,+,7171,7689,255;0;0,2,77,106,0,412,7248,7583,335,0
17582ref1,7324,7537,JUNC00000127,30,-,7324,7537,255;0;0,2,41,150,0,63,7365,7387,22,0
17582ref1,7311,7550,JUNC00000128,5,-,7311,7550,255;0;0,2,70,147,0,92,7381,7403,22,0
17582ref1,7383,7610,JUNC00000129,9,-,7383,7610,255;0;0,2,147,54,0,173,7530,7556,26,0
17582ref1,7476,7725,JUNC00000130,12,-,7476,7725,255;0;0,2,97,147,0,102,7573,7578,5,0
17582ref1,7536,7839,JUNC00000131,6,+,7536,7839,255;0;0,2,124,143,0,160,7660,7696,36,0
17582ref1,7512,7787,JUNC00000132,16,+,7512,7787,255;0;0,2,148,88,0,187,7660,7699,39,0
17582ref1,7539,7845,JUNC00000133,11,+,7539,7845,255;0;0,2,150,149,0,157,7689,7696,7,0
17582ref1,7557,7994,JUNC00000134,11,+,7557,7994,255;0;0,2,142,121,0,316,7699,7873,174,0
17582ref1,7583,8033,JUNC00000135,17,+,7583,8033,255;0;0,2,148,148,0,302,7731,7885,154,0
17582ref1,7586,7970,JUNC00000136,20,+,7586,7970,255;0;0,2,147,150,0,234,7733,7820,87,0
17582ref1,7661,7920,JUNC00000137,8,+,7661,7920,255;0;0,2,75,150,0,109,7736,7770,34,0
17582ref1,7718,8049,JUNC00000138,9,-,7718,8049,255;0;0,2,34,143,0,188,7752,7906,154,0
17582ref1,7633,8060,JUNC00000139,4,-,7633,8060,255;0;0,2,146,150,0,277,7779,7910,131,0
17582ref1,7797,7973,JUNC00000140,31,-,7797,7973,255;0;0,2,9,146,0,30,7806,7827,21,0
17582ref1,7768,8036,JUNC00000141,22,-,7768,8036,255;0;0,2,38,145,0,123,7806,7891,85,0
17582ref1,7696,8142,JUNC00000142,48,+,7696,8142,255;0;0,2,141,148,0,298,7837,7994,157,0
17582ref1,7702,7895,JUNC00000143,83,-,7702,7895,255;0;0,2,146,20,0,173,7848,7875,27,0
17582ref1,7708,8013,JUNC00000144,2,+,7708,8013,255;0;0,2,149,149,0,156,7857,7864,7,0
17582ref1,7725,8026,JUNC00000145,22,-,7725,8026,255;0;0,2,150,146,0,155,7875,7880,5,0
17582ref1,7725,8152,JUNC00000146,11,-,7725,8152,255;0;0,2,150,145,0,282,7875,8007,132,0
17582ref1,7923,8156,JUNC00000147,93,-,7923,8156,255;0;0,2,49,149,0,84,7972,8007,35,0
17582ref1,7963,8277,JUNC00000148,86,-,7963,8277,255;0;0,2,149,148,0,166,8112,8129,17,0
17582ref1,7988,8305,JUNC00000149,4,-,7988,8305,255;0;0,2,144,149,0,168,8132,8156,24,0
17582ref1,8323,8511,JUNC00000150,9,-,8323,8511,255;0;0,2,24,148,0,40,8347,8363,16,0
17582ref1,8260,8571,JUNC00000151,119,+,8260,8571,255;0;0,2,149,146,0,165,8409,8425,16,0
17582ref1,8290,8694,JUNC00000152,258,+,8290,8694,255;0;0,2,148,107,0,297,8438,8587,149,0
17582ref1,8293,8603,JUNC00000153,19,+,8293,8603,255;0;0,2,148,149,0,161,8441,8454,13,0
17582ref1,8569,8750,JUNC00000154,4,+,8569,8750,255;0;0,2,105,21,0,160,8674,8729,55,0
17582ref1,8529,8883,JUNC00000155,31,+,8529,8883,255;0;0,2,145,147,0,207,8674,8736,62,0
17582ref1,8766,9105,JUNC00000156,12,+,8766,9105,255;0;0,2,140,149,0,190,8906,8956,50,0
17582ref1,8763,9065,JUNC00000157,43,-,8763,9065,255;0;0,2,145,148,0,154,8908,8917,9,0
17582ref1,8799,9078,JUNC00000158,2564,+,8799,9078,255;0;0,2,124,150,0,129,8923,8928,5,0
17582ref1,8899,9237,JUNC00000159,12,+,8899,9237,255;0;0,2,131,149,0,189,9030,9088,58,0
17582ref1,8955,9326,JUNC00000160,15,+,8955,9326,255;0;0,2,149,148,0,223,9104,9178,74,0
17582ref1,9030,9196,JUNC00000161,19,+,9030,9196,255;0;0,2,149,8,0,158,9179,9188,9,0
17582ref1,9184,9494,JUNC00000162,4,-,9184,9494,255;0;0,2,149,150,0,160,9333,9344,11,0
17582ref1,9379,9680,JUNC00000163,188,+,9379,9680,255;0;0,2,127,150,0,151,9506,9530,24,0
17582ref1,9463,9768,JUNC00000164,463,+,9463,9768,255;0;0,2,150,150,0,155,9613,9618,5,0
17582ref1,9480,9782,JUNC00000165,1111,+,9480,9782,255;0;0,2,147,150,0,152,9627,9632,5,0
17582ref1,9549,9861,JUNC00000166,298,+,9549,9861,255;0;0,2,145,147,0,165,9694,9714,20,0
17582ref1,9715,10011,JUNC00000167,155,-,9715,10011,255;0;0,2,111,148,0,148,9826,9863,37,0
17582ref1,9713,10225,JUNC00000168,21,-,9713,10225,255;0;0,2,113,144,0,368,9826,10081,255,0
17582ref1,9850,10085,JUNC00000169,21,-,9850,10085,255;0;0,2,8,147,0,88,9858,9938,80,0
17582ref1,9852,10020,JUNC00000170,3,-,9852,10020,255;0;0,2,36,118,0,50,9888,9902,14,0
17582ref1,9831,10117,JUNC00000171,51,+,9831,10117,255;0;0,2,67,147,0,139,9898,9970,72,0
17582ref1,10008,10204,JUNC00000172,1,+,10008,10204,255;0;0,2,124,27,0,169,10132,10177,45,0
17582ref1,10018,10349,JUNC00000173,7,+,10018,10349,255;0;0,2,149,137,0,194,10167,10212,45,0
18318ref1,733,10161,JUNC00000015,304,-,733,10161,255;0;0,2,37,121,0,9307,770,10040,9270,0
18318ref1,2632,5247,JUNC00000052,302,-,2632,5247,255;0;0,2,105,150,0,2465,2737,5097,2360,0
18318ref1,6353,8102,JUNC00000093,2,+,6353,8102,255;0;0,2,131,58,0,1691,6484,8044,1560,0
18318ref1,5068,6201,JUNC00000084,1,-,5068,6201,255;0;0,2,29,75,0,1058,5097,6126,1029,0
18318ref1,3054,4187,JUNC00000064,414,-,3054,4187,255;0;0,2,11,144,0,989,3065,4043,978,0
18318ref1,4212,5010,JUNC00000077,4,+,4212,5010,255;0;0,2,59,124,0,674,4271,4886,615,0
18318ref1,2437,3139,JUNC00000042,3,-,2437,3139,255;0;0,2,99,29,0,673,2536,3110,574,0
18318ref1,457,1151,JUNC00000004,59,+,457,1151,255;0;0,2,89,149,0,545,546,1002,456,0
18318ref1,581,1127,JUNC00000008,41,+,581,1127,255;0;0,2,27,142,0,404,608,985,377,0
18318ref1,3873,4399,JUNC00000070,198,+,3873,4399,255;0;0,2,120,76,0,450,3993,4323,330,0
18318ref1,8037,8546,JUNC00000105,2,-,8037,8546,255;0;0,2,33,147,0,362,8070,8399,329,0
18318ref1,2520,2994,JUNC00000043,53,+,2520,2994,255;0;0,2,27,149,0,325,2547,2845,298,0
18318ref1,4713,5235,JUNC00000083,223,-,4713,5235,255;0;0,2,150,148,0,374,4863,5087,224,0
18318ref1,1649,2119,JUNC00000033,53,+,1649,2119,255;0;0,2,100,147,0,323,1749,1972,223,0
18318ref1,2698,3098,JUNC00000060,7,+,2698,3098,255;0;0,2,150,44,0,356,2848,3054,206,0
18318ref1,6207,6592,JUNC00000091,2,+,6207,6592,255;0;0,2,48,132,0,253,6255,6460,205,0
18318ref1,7325,7733,JUNC00000098,116,+,7325,7733,255;0;0,2,64,148,0,260,7389,7585,196,0
18318ref1,7551,8034,JUNC00000101,77,+,7551,8034,255;0;0,2,148,146,0,337,7699,7888,189,0
18318ref1,1288,1676,JUNC00000031,457,+,1288,1676,255;0;0,2,150,58,0,330,1438,1618,180,0
18318ref1,9843,10119,JUNC00000117,2,+,9843,10119,255;0;0,2,48,48,0,228,9891,10071,180,0
18318ref1,9836,10164,JUNC00000118,1,+,9836,10164,255;0;0,2,142,9,0,319,9978,10155,177,0
18318ref1,7554,8005,JUNC00000100,34,+,7554,8005,255;0;0,2,145,138,0,313,7699,7867,168,0
18318ref1,8858,9233,JUNC00000109,301,+,8858,9233,255;0;0,2,63,150,0,225,8921,9083,162,0
18318ref1,168,478,JUNC00000001,3,-,168,478,255;0;0,2,63,94,0,216,231,384,153,0
18318ref1,3843,4165,JUNC00000069,7,+,3843,4165,255;0;0,2,24,150,0,172,3867,4015,148,0
18318ref1,2437,2824,JUNC00000046,33,+,2437,2824,255;0;0,2,141,109,0,278,2578,2715,137,0
18318ref1,4422,4707,JUNC00000082,1,-,4422,4707,255;0;0,2,117,33,0,252,4539,4674,135,0
18318ref1,2698,3127,JUNC00000059,33,+,2698,3127,255;0;0,2,150,147,0,282,2848,2980,132,0
18318ref1,9619,9902,JUNC00000113,5,-,9619,9902,255;0;0,2,8,143,0,140,9627,9759,132,0
18318ref1,2622,2989,JUNC00000050,73,+,2622,2989,255;0;0,2,87,149,0,218,2709,2840,131,0
18318ref1,2706,2991,JUNC00000051,21,+,2706,2991,255;0;0,2,9,146,0,139,2715,2845,130,0
18318ref1,7893,8195,JUNC00000104,45,+,7893,8195,255;0;0,2,29,144,0,158,7922,8051,129,0
18318ref1,2349,2767,JUNC00000041,25,-,2349,2767,255;0;0,2,144,146,0,272,2493,2621,128,0
18318ref1,2794,3069,JUNC00000061,1,+,2794,3069,255;0;0,2,127,22,0,253,2921,3047,126,0
18318ref1,1911,2300,JUNC00000037,1171,+,1911,2300,255;0;0,2,123,150,0,239,2034,2150,116,0
18318ref1,1261,1670,JUNC00000030,24,+,1261,1670,255;0;0,2,150,149,0,260,1411,1521,110,0
18318ref1,476,807,JUNC00000005,34,-,476,807,255;0;0,2,86,149,0,182,562,658,96,0
18318ref1,1760,2058,JUNC00000036,38,-,1760,2058,255;0;0,2,66,146,0,152,1826,1912,86,0
18318ref1,4039,4370,JUNC00000072,235,-,4039,4370,255;0;0,2,101,148,0,183,4140,4222,82,0
18318ref1,1607,1972,JUNC00000034,29,-,1607,1972,255;0;0,2,144,146,0,219,1751,1826,75,0
18318ref1,2251,2496,JUNC00000039,82,-,2251,2496,255;0;0,2,25,147,0,98,2276,2349,73,0
18318ref1,1722,2029,JUNC00000035,5,-,1722,2029,255;0;0,2,93,144,0,163,1815,1885,70,0
18318ref1,2840,3196,JUNC00000062,97,+,2840,3196,255;0;0,2,142,149,0,207,2982,3047,65,0
18318ref1,4008,4364,JUNC00000073,342,+,4008,4364,255;0;0,2,144,147,0,209,4152,4217,65,0
18318ref1,8294,8651,JUNC00000108,1193,+,8294,8651,255;0;0,2,144,150,0,207,8438,8501,63,0
18318ref1,4407,4705,JUNC00000081,1004,-,4407,4705,255;0;0,2,90,150,0,148,4497,4555,58,0
18318ref1,955,1308,JUNC00000024,3916,-,955,1308,255;0;0,2,146,150,0,203,1101,1158,57,0
18318ref1,2881,3136,JUNC00000063,2,+,2881,3136,255;0;0,2,150,50,0,205,3031,3086,55,0
18318ref1,624,836,JUNC00000009,75,-,624,836,255;0;0,2,8,150,0,62,632,686,54,0
18318ref1,522,871,JUNC00000011,65,+,522,871,255;0;0,2,145,150,0,199,667,721,54,0
18318ref1,825,1171,JUNC00000023,3,+,825,1171,255;0;0,2,144,149,0,197,969,1022,53,0
18318ref1,5680,5915,JUNC00000087,14,+,5680,5915,255;0;0,2,150,36,0,199,5830,5879,49,0
18318ref1,6610,6892,JUNC00000094,31,-,6610,6892,255;0;0,2,84,150,0,132,6694,6742,48,0
18318ref1,9695,9972,JUNC00000115,31,+,9695,9972,255;0;0,2,80,149,0,128,9775,9823,48,0
18318ref1,4217,4555,JUNC00000078,44,+,4217,4555,255;0;0,2,145,147,0,191,4362,4408,46,0
18318ref1,3509,3834,JUNC00000067,5,-,3509,3834,255;0;0,2,133,148,0,177,3642,3686,44,0
18318ref1,4068,4352,JUNC00000074,250,-,4068,4352,255;0;0,2,93,149,0,135,4161,4203,42,0
18318ref1,601,923,JUNC00000014,15,-,601,923,255;0;0,2,143,138,0,184,744,785,41,0
18318ref1,3660,3997,JUNC00000068,29,-,3660,3997,255;0;0,2,147,149,0,188,3807,3848,41,0
18318ref1,5253,5442,JUNC00000085,1,+,5253,5442,255;0;0,2,127,24,0,165,5380,5418,38,0
18318ref1,1518,1855,JUNC00000032,16,+,1518,1855,255;0;0,2,150,150,0,187,1668,1705,37,0
18318ref1,871,1125,JUNC00000021,57,+,871,1125,255;0;0,2,69,149,0,105,940,976,36,0
18318ref1,2238,2574,JUNC00000040,14,-,2238,2574,255;0;0,2,150,150,0,186,2388,2424,36,0
18318ref1,2448,2781,JUNC00000049,178,-,2448,2781,255;0;0,2,150,148,0,185,2598,2633,35,0
18318ref1,2735,2989,JUNC00000053,218,+,2735,2989,255;0;0,2,71,149,0,105,2806,2840,34,0
18318ref1,5574,5783,JUNC00000086,16,-,5574,5783,255;0;0,2,26,150,0,59,5600,5633,33,0
18318ref1,732,1058,JUNC00000020,38,+,732,1058,255;0;0,2,146,148,0,178,878,910,32,0
18318ref1,3958,4235,JUNC00000071,136,-,3958,4235,255;0;0,2,149,97,0,180,4107,4138,31,0
18318ref1,5826,6157,JUNC00000090,8,+,5826,6157,255;0;0,2,150,150,0,181,5976,6007,31,0
18318ref1,5751,5952,JUNC00000089,18,-,5751,5952,255;0;0,2,150,21,0,180,5901,5931,30,0
18318ref1,686,869,JUNC00000016,111,-,686,869,255;0;0,2,147,9,0,174,833,860,27,0
18318ref1,3178,3434,JUNC00000066,29,-,3178,3434,255;0;0,2,79,150,0,106,3257,3284,27,0
18318ref1,3022,3346,JUNC00000065,111,+,3022,3346,255;0;0,2,149,150,0,174,3171,3196,25,0
18318ref1,2666,2988,JUNC00000055,8,-,2666,2988,255;0;0,2,150,148,0,174,2816,2840,24,0
18318ref1,582,775,JUNC00000007,20,+,582,775,255;0;0,2,26,144,0,49,608,631,23,0
18318ref1,9826,10006,JUNC00000116,2,+,9826,10006,255;0;0,2,10,149,0,31,9836,9857,21,0
18318ref1,977,1293,JUNC00000026,41,+,977,1293,255;0;0,2,150,146,0,170,1127,1147,20,0
18318ref1,9690,9944,JUNC00000114,71,+,9690,9944,255;0;0,2,85,149,0,105,9775,9795,20,0
18318ref1,7288,7534,JUNC00000097,116,+,7288,7534,255;0;0,2,79,149,0,97,7367,7385,18,0
18318ref1,2715,2989,JUNC00000056,67,+,2715,2989,255;0;0,2,108,149,0,125,2823,2840,17,0
18318ref1,4144,4335,JUNC00000075,58,+,4144,4335,255;0;0,2,26,148,0,43,4170,4187,17,0
18318ref1,7963,8279,JUNC00000107,145,-,7963,8279,255;0;0,2,149,150,0,166,8112,8129,17,0
18318ref1,614,824,JUNC00000010,30,-,614,824,255;0;0,2,46,148,0,62,660,676,16,0
18318ref1,2668,2883,JUNC00000054,44,-,2668,2883,255;0;0,2,148,51,0,164,2816,2832,16,0
18318ref1,2408,2720,JUNC00000044,25,+,2408,2720,255;0;0,2,148,149,0,163,2556,2571,15,0
18318ref1,2460,2746,JUNC00000047,6,+,2460,2746,255;0;0,2,124,147,0,139,2584,2599,15,0
18318ref1,2448,2763,JUNC00000048,14,+,2448,2763,255;0;0,2,150,150,0,165,2598,2613,15,0
18318ref1,2680,2994,JUNC00000057,56,+,2680,2994,255;0;0,2,150,149,0,165,2830,2845,15,0
18318ref1,8987,9300,JUNC00000111,3,+,8987,9300,255;0;0,2,149,149,0,164,9136,9151,15,0
18318ref1,9968,10155,JUNC00000119,35,+,9968,10155,255;0;0,2,147,25,0,162,10115,10130,15,0
18318ref1,596,761,JUNC00000013,1,+,596,761,255;0;0,2,142,9,0,156,738,752,14,0
18318ref1,4183,4418,JUNC00000076,25,+,4183,4418,255;0;0,2,74,147,0,88,4257,4271,14,0
18318ref1,710,1020,JUNC00000018,70,+,710,1020,255;0;0,2,148,149,0,161,858,871,13,0
18318ref1,2533,2723,JUNC00000045,14,+,2533,2723,255;0;0,2,32,145,0,45,2565,2578,13,0
18318ref1,4226,4407,JUNC00000079,23,-,4226,4407,255;0;0,2,149,19,0,162,4375,4388,13,0
18318ref1,2699,3005,JUNC00000058,23,+,2699,3005,255;0;0,2,147,147,0,159,2846,2858,12,0
18318ref1,331,642,JUNC00000003,19,+,331,642,255;0;0,2,150,150,0,161,481,492,11,0
18318ref1,701,871,JUNC00000012,336,+,701,871,255;0;0,2,9,150,0,20,710,721,11,0
18318ref1,721,1024,JUNC00000019,140,+,721,1024,255;0;0,2,146,146,0,157,867,878,11,0
18318ref1,2065,2297,JUNC00000038,23,+,2065,2297,255;0;0,2,71,150,0,82,2136,2147,11,0
18318ref1,6990,7292,JUNC00000096,143,+,6990,7292,255;0;0,2,147,144,0,158,7137,7148,11,0
18318ref1,451,758,JUNC00000006,12,-,451,758,255;0;0,2,149,148,0,159,600,610,10,0
18318ref1,304,612,JUNC00000002,164,+,304,612,255;0;0,2,150,149,0,159,454,463,9,0
18318ref1,7495,7701,JUNC00000099,19,+,7495,7701,255;0;0,2,47,150,0,56,7542,7551,9,0
18318ref1,9030,9196,JUNC00000112,8,+,9030,9196,255;0;0,2,149,8,0,158,9179,9188,9,0
18318ref1,1002,1308,JUNC00000027,200,-,1002,1308,255;0;0,2,148,150,0,156,1150,1158,8,0
18318ref1,1074,1382,JUNC00000028,215,+,1074,1382,255;0;0,2,150,150,0,158,1224,1232,8,0
18318ref1,7956,8260,JUNC00000106,32,+,7956,8260,255;0;0,2,148,148,0,156,8104,8112,8,0
18318ref1,824,1125,JUNC00000022,25,+,824,1125,255;0;0,2,145,149,0,152,969,976,7,0
18318ref1,6392,6636,JUNC00000092,49,+,6392,6636,255;0;0,2,92,145,0,99,6484,6491,7,0
18318ref1,7718,7894,JUNC00000102,20,+,7718,7894,255;0;0,2,148,21,0,155,7866,7873,7,0
18318ref1,10137,10302,JUNC00000120,313,+,10137,10302,255;0;0,2,149,9,0,156,10286,10293,7,0
18318ref1,976,1276,JUNC00000025,7,+,976,1276,255;0;0,2,146,148,0,152,1122,1128,6,0
18318ref1,4316,4545,JUNC00000080,2,-,4316,4545,255;0;0,2,150,73,0,156,4466,4472,6,0
18318ref1,5729,6030,JUNC00000088,3,+,5729,6030,255;0;0,2,149,146,0,155,5878,5884,6,0
18318ref1,6971,7275,JUNC00000095,83,+,6971,7275,255;0;0,2,149,149,0,155,7120,7126,6,0
18318ref1,728,884,JUNC00000017,96,-,728,884,255;0;0,2,127,24,0,132,855,860,5,0
18318ref1,1243,1548,JUNC00000029,373,+,1243,1548,255;0;0,2,150,150,0,155,1393,1398,5,0
18318ref1,7725,7905,JUNC00000103,16,-,7725,7905,255;0;0,2,150,25,0,155,7875,7880,5,0
18318ref1,8773,9078,JUNC00000110,1882,+,8773,9078,255;0;0,2,150,150,0,155,8923,8928,5,0
18401ref1,388,701,JUNC00000001,192,-,388,701,255;0;0,2,150,147,0,166,538,554,16,0
18401ref1,408,828,JUNC00000002,207,-,408,828,255;0;0,2,150,148,0,272,558,680,122,0
18401ref1,568,1095,JUNC00000003,36,+,568,1095,255;0;0,2,40,110,0,417,608,985,377,0
18401ref1,570,842,JUNC00000004,29,+,570,842,255;0;0,2,57,148,0,124,627,694,67,0
18401ref1,596,941,JUNC00000005,70,+,596,941,255;0;0,2,60,148,0,197,656,793,137,0
18401ref1,646,843,JUNC00000006,20,+,646,843,255;0;0,2,21,149,0,48,667,694,27,0
18401ref1,646,846,JUNC00000007,11,+,646,846,255;0;0,2,21,150,0,50,667,696,29,0
18401ref1,666,838,JUNC00000008,2,+,666,838,255;0;0,2,8,144,0,28,674,694,20,0
18401ref1,696,1020,JUNC00000009,50,+,696,1020,255;0;0,2,21,149,0,175,717,871,154,0
18401ref1,702,927,JUNC00000010,1,+,702,927,255;0;0,2,36,115,0,110,738,812,74,0
18401ref1,588,1023,JUNC00000011,5,+,588,1023,255;0;0,2,150,148,0,287,738,875,137,0
18401ref1,763,9987,JUNC00000012,1,-,763,9987,255;0;0,2,22,129,0,9095,785,9858,9073,0
18401ref1,787,1016,JUNC00000013,44,+,787,1016,255;0;0,2,29,145,0,84,816,871,55,0
18401ref1,799,1139,JUNC00000014,1,+,799,1139,255;0;0,2,27,124,0,216,826,1015,189,0
18401ref1,840,1022,JUNC00000015,45,+,840,1022,255;0;0,2,27,144,0,38,867,878,11,0
18401ref1,823,1123,JUNC00000016,8,+,823,1123,255;0;0,2,146,147,0,153,969,976,7,0
18401ref1,1000,1302,JUNC00000017,4,-,1000,1302,255;0;0,2,150,147,0,155,1150,1155,5,0
18401ref1,1004,1308,JUNC00000018,79,-,1004,1308,255;0;0,2,146,150,0,154,1150,1158,8,0
18401ref1,1458,1626,JUNC00000019,9,+,1458,1626,255;0;0,2,147,8,0,160,1605,1618,13,0
18401ref1,1606,1972,JUNC00000020,404,-,1606,1972,255;0;0,2,145,146,0,220,1751,1826,75,0
18401ref1,1681,2012,JUNC00000021,4,-,1681,2012,255;0;0,2,145,100,0,231,1826,1912,86,0
18401ref1,1762,1968,JUNC00000022,2,+,1762,1968,255;0;0,2,88,50,0,156,1850,1918,68,0
18401ref1,1826,2061,JUNC00000023,2,-,1826,2061,255;0;0,2,34,149,0,86,1860,1912,52,0
18401ref1,1857,2160,JUNC00000024,12,+,1857,2160,255;0;0,2,150,146,0,157,2007,2014,7,0
18401ref1,2242,2491,JUNC00000025,1,-,2242,2491,255;0;0,2,143,8,0,241,2385,2483,98,0
18401ref1,2238,2574,JUNC00000026,14,-,2238,2574,255;0;0,2,150,150,0,186,2388,2424,36,0
18401ref1,2314,2643,JUNC00000027,15,+,2314,2643,255;0;0,2,148,146,0,183,2462,2497,35,0
18401ref1,2444,2746,JUNC00000028,4,+,2444,2746,255;0;0,2,149,147,0,155,2593,2599,6,0
18401ref1,2573,2771,JUNC00000029,15,-,2573,2771,255;0;0,2,25,150,0,48,2598,2621,23,0
18401ref1,2449,2782,JUNC00000030,103,-,2449,2782,255;0;0,2,149,149,0,184,2598,2633,35,0
18401ref1,2646,2878,JUNC00000031,2,+,2646,2878,255;0;0,2,24,127,0,105,2670,2751,81,0
18401ref1,2521,2974,JUNC00000032,7,-,2521,2974,255;0;0,2,149,149,0,304,2670,2825,155,0
18401ref1,2530,2940,JUNC00000033,9,-,2530,2940,255;0;0,2,150,149,0,261,2680,2791,111,0
18401ref1,2682,3005,JUNC00000034,27,+,2682,3005,255;0;0,2,145,149,0,174,2827,2856,29,0
18401ref1,2697,3011,JUNC00000035,26,+,2697,3011,255;0;0,2,149,149,0,165,2846,2862,16,0
18401ref1,2698,3016,JUNC00000036,15,+,2698,3016,255;0;0,2,150,150,0,168,2848,2866,18,0
18401ref1,2716,3031,JUNC00000037,26,+,2716,3031,255;0;0,2,149,150,0,165,2865,2881,16,0
18401ref1,2817,3331,JUNC00000038,31,-,2817,3331,255;0;0,2,150,150,0,364,2967,3181,214,0
18401ref1,3177,3355,JUNC00000039,1,-,3177,3355,255;0;0,2,80,71,0,107,3257,3284,27,0
18401ref1,3565,3966,JUNC00000040,104,+,3565,3966,255;0;0,2,77,150,0,251,3642,3816,174,0
18401ref1,3861,4192,JUNC00000041,152,+,3861,4192,255;0;0,2,41,150,0,181,3902,4042,140,0
18401ref1,3977,5538,JUNC00000042,148,-,3977,5538,255;0;0,2,140,147,0,1414,4117,5391,1274,0
18401ref1,4218,4427,JUNC00000043,4,-,4218,4427,255;0;0,2,21,150,0,59,4239,4277,38,0
18401ref1,4101,4492,JUNC00000044,3,+,4101,4492,255;0;0,2,149,149,0,242,4250,4343,93,0
18401ref1,4108,4477,JUNC00000045,19,+,4108,4477,255;0;0,2,149,150,0,219,4257,4327,70,0
18401ref1,4246,4712,JUNC00000046,15,+,4246,4712,255;0;0,2,132,127,0,339,4378,4585,207,0
18401ref1,4237,4715,JUNC00000047,200,-,4237,4715,255;0;0,2,145,127,0,351,4382,4588,206,0
18401ref1,4356,4621,JUNC00000048,76,-,4356,4621,255;0;0,2,110,143,0,122,4466,4478,12,0
18401ref1,4395,4765,JUNC00000049,183,-,4395,4765,255;0;0,2,144,91,0,279,4539,4674,135,0
18401ref1,4615,5150,JUNC00000050,1,-,4615,5150,255;0;0,2,131,20,0,515,4746,5130,384,0
18401ref1,5016,5336,JUNC00000051,883,-,5016,5336,255;0;0,2,150,150,0,170,5166,5186,20,0
18401ref1,5314,5795,JUNC00000052,3,+,5314,5795,255;0;0,2,104,47,0,434,5418,5748,330,0
18401ref1,5455,5782,JUNC00000053,10,-,5455,5782,255;0;0,2,145,149,0,178,5600,5633,33,0
18401ref1,5686,8463,JUNC00000054,1,-,5686,8463,255;0;0,2,128,23,0,2754,5814,8440,2626,0
18401ref1,5826,6057,JUNC00000055,3,-,5826,6057,255;0;0,2,146,45,0,186,5972,6012,40,0
18401ref1,5825,6160,JUNC00000056,39,-,5825,6160,255;0;0,2,149,146,0,189,5974,6014,40,0
18401ref1,7212,7543,JUNC00000057,3,-,7212,7543,255;0;0,2,123,147,0,184,7335,7396,61,0
18401ref1,7412,7700,JUNC00000058,3,+,7412,7700,255;0;0,2,73,149,0,139,7485,7551,66,0
18401ref1,7485,7581,JUNC00000059,1,+,7485,7581,255;0;0,2,9,21,0,75,7494,7560,66,0
18401ref1,7363,7632,JUNC00000060,53,-,7363,7632,255;0;0,2,148,54,0,215,7511,7578,67,0
18401ref1,7626,8041,JUNC00000061,955,-,7626,8041,255;0;0,2,150,150,0,265,7776,7891,115,0
18401ref1,7798,8164,JUNC00000062,4,+,7798,8164,255;0;0,2,27,148,0,218,7825,8016,191,0
18401ref1,7709,7885,JUNC00000063,2,+,7709,7885,255;0;0,2,148,21,0,155,7857,7864,7,0
18401ref1,7831,8036,JUNC00000064,137,+,7831,8036,255;0;0,2,42,148,0,57,7873,7888,15,0
18401ref1,7962,8279,JUNC00000065,599,-,7962,8279,255;0;0,2,150,150,0,167,8112,8129,17,0
18401ref1,8135,8325,JUNC00000066,9,+,8135,8325,255;0;0,2,19,149,0,41,8154,8176,22,0
18401ref1,8847,9233,JUNC00000067,17,+,8847,9233,255;0;0,2,74,150,0,236,8921,9083,162,0
18401ref1,8773,9078,JUNC00000068,698,+,8773,9078,255;0;0,2,150,150,0,155,8923,8928,5,0
18401ref1,9578,9862,JUNC00000069,345,+,9578,9862,255;0;0,2,116,148,0,136,9694,9714,20,0
18401ref1,9659,9970,JUNC00000070,1054,-,9659,9970,255;0;0,2,150,146,0,165,9809,9824,15,0
17385ref1,331,696,JUNC00000001,395,-,331,696,255;0;0,2,150,148,0,217,481,548,67,0
17385ref1,408,827,JUNC00000002,488,-,408,827,255;0;0,2,150,147,0,272,558,680,122,0
17385ref1,578,826,JUNC00000003,5,+,578,826,255;0;0,2,35,146,0,102,613,680,67,0
17385ref1,640,796,JUNC00000004,4,-,640,796,255;0;0,2,24,116,0,40,664,680,16,0
17385ref1,665,842,JUNC00000005,7,+,665,842,255;0;0,2,9,148,0,29,674,694,20,0
17385ref1,690,875,JUNC00000006,2,+,690,875,255;0;0,2,20,145,0,40,710,730,20,0
17385ref1,684,1013,JUNC00000007,8,+,684,1013,255;0;0,2,26,149,0,180,710,864,154,0
17385ref1,666,1019,JUNC00000008,68,+,666,1019,255;0;0,2,51,148,0,205,717,871,154,0
17385ref1,722,1040,JUNC00000009,13,+,722,1040,255;0;0,2,10,150,0,168,732,890,158,0
17385ref1,590,961,JUNC00000010,8,+,590,961,255;0;0,2,148,149,0,222,738,812,74,0
17385ref1,731,993,JUNC00000011,66,-,731,993,255;0;0,2,39,148,0,114,770,845,75,0
17385ref1,748,989,JUNC00000012,223,+,748,989,255;0;0,2,35,97,0,144,783,892,109,0
17385ref1,738,1027,JUNC00000013,48,-,738,1027,255;0;0,2,47,149,0,140,785,878,93,0
17385ref1,680,1012,JUNC00000014,21,+,680,1012,255;0;0,2,146,148,0,184,826,864,38,0
17385ref1,824,1124,JUNC00000015,145,+,824,1124,255;0;0,2,145,148,0,152,969,976,7,0
17385ref1,949,1292,JUNC00000016,8,-,949,1292,255;0;0,2,150,147,0,196,1099,1145,46,0
17385ref1,955,1242,JUNC00000017,912,-,955,1242,255;0;0,2,146,84,0,203,1101,1158,57,0
17385ref1,968,1269,JUNC00000018,5,+,968,1269,255;0;0,2,146,149,0,152,1114,1120,6,0
17385ref1,978,1292,JUNC00000019,23,+,978,1292,255;0;0,2,149,145,0,169,1127,1147,20,0
17385ref1,1000,1302,JUNC00000020,14,-,1000,1302,255;0;0,2,150,147,0,155,1150,1155,5,0
17385ref1,1004,1215,JUNC00000021,93,-,1004,1215,255;0;0,2,146,57,0,154,1150,1158,8,0
17385ref1,1282,1533,JUNC00000022,6,+,1282,1533,255;0;0,2,26,125,0,126,1308,1408,100,0
17385ref1,1448,2630,JUNC00000023,69,+,1448,2630,255;0;0,2,117,142,0,1040,1565,2488,923,0
17385ref1,1436,1695,JUNC00000024,4,+,1436,1695,255;0;0,2,147,77,0,182,1583,1618,35,0
17385ref1,1642,1824,JUNC00000025,65,+,1642,1824,255;0;0,2,107,49,0,133,1749,1775,26,0
17385ref1,1699,1925,JUNC00000026,100,+,1699,1925,255;0;0,2,52,148,0,78,1751,1777,26,0
17385ref1,1731,1967,JUNC00000027,1,+,1731,1967,255;0;0,2,69,82,0,154,1800,1885,85,0
17385ref1,1712,2057,JUNC00000028,64,-,1712,2057,255;0;0,2,114,145,0,200,1826,1912,86,0
17385ref1,1910,2283,JUNC00000029,518,+,1910,2283,255;0;0,2,124,133,0,240,2034,2150,116,0
17385ref1,1963,2239,JUNC00000030,15,+,1963,2239,255;0;0,2,116,150,0,126,2079,2089,10,0
17385ref1,2173,2597,JUNC00000031,4,+,2173,2597,255;0;0,2,149,146,0,278,2322,2451,129,0
17385ref1,2384,2561,JUNC00000032,68,-,2384,2561,255;0;0,2,22,150,0,27,2406,2411,5,0
17385ref1,2364,2770,JUNC00000033,22,-,2364,2770,255;0;0,2,48,149,0,257,2412,2621,209,0
17385ref1,2457,2650,JUNC00000034,11,+,2457,2650,255;0;0,2,24,149,0,44,2481,2501,20,0
17385ref1,2342,2661,JUNC00000035,6,+,2342,2661,255;0;0,2,149,149,0,170,2491,2512,21,0
17385ref1,2444,2746,JUNC00000036,4,+,2444,2746,255;0;0,2,149,147,0,155,2593,2599,6,0
17385ref1,2630,2988,JUNC00000037,51,+,2630,2988,255;0;0,2,67,148,0,210,2697,2840,143,0
17385ref1,2701,6093,JUNC00000038,1188,+,2701,6093,255;0;0,2,70,150,0,3242,2771,5943,3172,0
17385ref1,2666,2958,JUNC00000039,3,+,2666,2958,255;0;0,2,140,144,0,148,2806,2814,8,0
17385ref1,2668,2991,JUNC00000040,12,-,2668,2991,255;0;0,2,148,148,0,175,2816,2843,27,0
17385ref1,2668,3001,JUNC00000041,46,-,2668,3001,255;0;0,2,148,143,0,190,2816,2858,42,0
17385ref1,2700,3009,JUNC00000042,8,+,2700,3009,255;0;0,2,146,147,0,162,2846,2862,16,0
17385ref1,2716,3030,JUNC00000043,22,+,2716,3030,255;0;0,2,149,149,0,165,2865,2881,16,0
17385ref1,2868,8072,JUNC00000044,3179,+,2868,8072,255;0;0,2,51,150,0,5054,2919,7922,5003,0
17385ref1,3023,3351,JUNC00000045,309,-,3023,3351,255;0;0,2,150,150,0,178,3173,3201,28,0
17385ref1,3108,3433,JUNC00000046,21,-,3108,3433,255;0;0,2,149,149,0,176,3257,3284,27,0
17385ref1,3501,3827,JUNC00000047,515,+,3501,3827,255;0;0,2,150,149,0,177,3651,3678,27,0
17385ref1,3809,4018,JUNC00000048,2,-,3809,4018,255;0;0,2,45,149,0,60,3854,3869,15,0
17385ref1,3801,4056,JUNC00000049,1,-,3801,4056,255;0;0,2,53,98,0,157,3854,3958,104,0
17385ref1,3788,4173,JUNC00000050,405,+,3788,4173,255;0;0,2,116,148,0,237,3904,4025,121,0
17385ref1,3849,4097,JUNC00000051,100,-,3849,4097,255;0;0,2,66,149,0,99,3915,3948,33,0
17385ref1,3904,4110,JUNC00000052,74,+,3904,4110,255;0;0,2,52,149,0,57,3956,3961,5,0
17385ref1,3867,4471,JUNC00000053,116,+,3867,4471,255;0;0,2,126,148,0,456,3993,4323,330,0
17385ref1,3955,4338,JUNC00000054,1,+,3955,4338,255;0;0,2,70,81,0,302,4025,4257,232,0
17385ref1,3925,4262,JUNC00000055,1501,+,3925,4262,255;0;0,2,150,147,0,190,4075,4115,40,0
17385ref1,4064,4238,JUNC00000056,53,+,4064,4238,255;0;0,2,17,150,0,24,4081,4088,7,0
17385ref1,3933,4253,JUNC00000057,34,+,3933,4253,255;0;0,2,148,150,0,170,4081,4103,22,0
17385ref1,4230,4417,JUNC00000058,9,+,4230,4417,255;0;0,2,27,146,0,41,4257,4271,14,0
17385ref1,4262,4562,JUNC00000059,587,+,4262,4562,255;0;0,2,61,127,0,173,4323,4435,112,0
17385ref1,4311,4523,JUNC00000060,4,-,4311,4523,255;0;0,2,31,149,0,63,4342,4374,32,0
17385ref1,4388,4705,JUNC00000061,1860,-,4388,4705,255;0;0,2,109,150,0,167,4497,4555,58,0
17385ref1,4397,4683,JUNC00000062,1,-,4397,4683,255;0;0,2,142,9,0,277,4539,4674,135,0
17385ref1,4718,4927,JUNC00000063,6,+,4718,4927,255;0;0,2,47,144,0,65,4765,4783,18,0
17385ref1,5549,5735,JUNC00000064,2,+,5549,5735,255;0;0,2,18,148,0,38,5567,5587,20,0
17385ref1,5454,5774,JUNC00000065,597,-,5454,5774,255;0;0,2,150,146,0,174,5604,5628,24,0
17385ref1,5589,5923,JUNC00000066,53,+,5589,5923,255;0;0,2,147,148,0,186,5736,5775,39,0
17385ref1,6312,6640,JUNC00000067,642,+,6312,6640,255;0;0,2,150,149,0,179,6462,6491,29,0
17385ref1,6695,6889,JUNC00000068,60,+,6695,6889,255;0;0,2,25,147,0,47,6720,6742,22,0
17385ref1,6862,7088,JUNC00000069,51,-,6862,7088,255;0;0,2,30,147,0,79,6892,6941,49,0
17385ref1,6897,7191,JUNC00000070,102,+,6897,7191,255;0;0,2,129,148,0,146,7026,7043,17,0
17385ref1,6971,7283,JUNC00000071,5,-,6971,7283,255;0;0,2,147,149,0,163,7118,7134,16,0
17385ref1,7114,7437,JUNC00000072,271,-,7114,7437,255;0;0,2,99,150,0,173,7213,7287,74,0
17385ref1,7270,7525,JUNC00000073,108,-,7270,7525,255;0;0,2,55,149,0,106,7325,7376,51,0
17385ref1,7434,7630,JUNC00000074,1,-,7434,7630,255;0;0,2,77,74,0,122,7511,7556,45,0
17385ref1,7364,7616,JUNC00000075,55,-,7364,7616,255;0;0,2,147,38,0,214,7511,7578,67,0
17385ref1,7430,7902,JUNC00000076,9,+,7430,7902,255;0;0,2,146,35,0,437,7576,7867,291,0
17385ref1,7521,7805,JUNC00000077,6,+,7521,7805,255;0;0,2,139,109,0,175,7660,7696,36,0
17385ref1,7690,8012,JUNC00000078,4,+,7690,8012,255;0;0,2,150,148,0,174,7840,7864,24,0
17385ref1,7962,8291,JUNC00000079,124,-,7962,8291,255;0;0,2,150,150,0,179,8112,8141,29,0
17385ref1,8306,10161,JUNC00000080,1,+,8306,10161,255;0;0,2,91,60,0,1795,8397,10101,1704,0
17385ref1,8625,9018,JUNC00000081,259,+,8625,9018,255;0;0,2,150,133,0,260,8775,8885,110,0
17385ref1,8773,9078,JUNC00000082,1821,+,8773,9078,255;0;0,2,150,150,0,155,8923,8928,5,0
17385ref1,9032,9196,JUNC00000083,2,+,9032,9196,255;0;0,2,147,8,0,156,9179,9188,9,0
17385ref1,9736,9972,JUNC00000084,137,-,9736,9972,255;0;0,2,73,148,0,88,9809,9824,15,0
17385ref1,9736,10164,JUNC00000085,17,-,9736,10164,255;0;0,2,90,83,0,345,9826,10081,255,0
17385ref1,9790,10142,JUNC00000086,11,-,9790,10142,255;0;0,2,118,149,0,203,9908,9993,85,0
17385ref1,9828,10100,JUNC00000087,3,-,9828,10100,255;0;0,2,122,114,0,158,9950,9986,36,0
17385ref1,9808,10145,JUNC00000088,3,-,9808,10145,255;0;0,2,145,150,0,187,9953,9995,42,0
17385ref1,10009,10213,JUNC00000089,3,+,10009,10213,255;0;0,2,137,21,0,183,10146,10192,46,0
17206ref1,651,834,JUNC00000001,9,+,651,834,255;0;0,2,23,148,0,35,674,686,12,0
17206ref1,652,842,JUNC00000002,36,+,652,842,255;0;0,2,22,148,0,42,674,694,20,0
17206ref1,634,857,JUNC00000003,630,+,634,857,255;0;0,2,40,112,0,111,674,745,71,0
17206ref1,650,836,JUNC00000004,10,+,650,836,255;0;0,2,26,148,0,38,676,688,12,0
17206ref1,654,1012,JUNC00000005,28,+,654,1012,255;0;0,2,56,148,0,210,710,864,154,0
17206ref1,682,1018,JUNC00000006,57,+,682,1018,255;0;0,2,35,147,0,189,717,871,154,0
17206ref1,603,941,JUNC00000007,85,+,603,941,255;0;0,2,127,148,0,190,730,793,63,0
17206ref1,714,1025,JUNC00000008,35,+,714,1025,255;0;0,2,24,147,0,164,738,878,140,0
17206ref1,725,1894,JUNC00000009,301,-,725,1894,255;0;0,2,45,143,0,1026,770,1751,981,0
17206ref1,816,1019,JUNC00000010,45,+,816,1019,255;0;0,2,30,148,0,55,846,871,25,0
17206ref1,824,1124,JUNC00000011,23,+,824,1124,255;0;0,2,145,148,0,152,969,976,7,0
17206ref1,825,1169,JUNC00000012,6,+,825,1169,255;0;0,2,144,147,0,197,969,1022,53,0
17206ref1,871,1133,JUNC00000013,20,+,871,1133,255;0;0,2,144,78,0,184,1015,1055,40,0
17206ref1,933,1152,JUNC00000014,16,+,933,1152,255;0;0,2,150,24,0,195,1083,1128,45,0
17206ref1,955,1307,JUNC00000015,1392,-,955,1307,255;0;0,2,146,149,0,203,1101,1158,57,0
17206ref1,979,1166,JUNC00000016,10,-,979,1166,255;0;0,2,149,8,0,179,1128,1158,30,0
17206ref1,1000,1304,JUNC00000017,9,-,1000,1304,255;0;0,2,150,149,0,155,1150,1155,5,0
17206ref1,1002,1307,JUNC00000018,61,-,1002,1307,255;0;0,2,148,149,0,156,1150,1158,8,0
17206ref1,1521,1842,JUNC00000019,3,+,1521,1842,255;0;0,2,147,146,0,175,1668,1696,28,0
17206ref1,1745,1964,JUNC00000020,2,-,1745,1964,255;0;0,2,24,126,0,93,1769,1838,69,0
17206ref1,1784,2062,JUNC00000021,403,-,1784,2062,255;0;0,2,42,150,0,128,1826,1912,86,0
17206ref1,1721,2001,JUNC00000022,2,+,1721,2001,255;0;0,2,129,83,0,197,1850,1918,68,0
17206ref1,1786,7587,JUNC00000023,6,+,1786,7587,255;0;0,2,126,25,0,5776,1912,7562,5650,0
17206ref1,1858,2160,JUNC00000024,7,+,1858,2160,255;0;0,2,149,146,0,156,2007,2014,7,0
17206ref1,2238,2574,JUNC00000025,13,-,2238,2574,255;0;0,2,150,150,0,186,2388,2424,36,0
17206ref1,2238,2665,JUNC00000026,53,-,2238,2665,255;0;0,2,150,150,0,277,2388,2515,127,0
17206ref1,2402,5599,JUNC00000027,29,+,2402,5599,255;0;0,2,68,150,0,3047,2470,5449,2979,0
17206ref1,2437,2784,JUNC00000028,42,+,2437,2784,255;0;0,2,141,89,0,258,2578,2695,117,0
17206ref1,2433,2800,JUNC00000029,16,+,2433,2800,255;0;0,2,147,148,0,219,2580,2652,72,0
17206ref1,2434,2800,JUNC00000030,71,+,2434,2800,255;0;0,2,146,103,0,263,2580,2697,117,0
17206ref1,2449,2763,JUNC00000031,6,+,2449,2763,255;0;0,2,149,150,0,164,2598,2613,15,0
17206ref1,2449,2779,JUNC00000032,176,-,2449,2779,255;0;0,2,149,146,0,184,2598,2633,35,0
17206ref1,2657,2988,JUNC00000033,4,+,2657,2988,255;0;0,2,40,148,0,183,2697,2840,143,0
17206ref1,2786,2987,JUNC00000034,4,+,2786,2987,255;0;0,2,20,147,0,54,2806,2840,34,0
17206ref1,2697,3009,JUNC00000035,4,+,2697,3009,255;0;0,2,149,147,0,165,2846,2862,16,0
17206ref1,3234,3429,JUNC00000036,2,-,3234,3429,255;0;0,2,23,145,0,50,3257,3284,27,0
17206ref1,3584,3974,JUNC00000037,3,-,3584,3974,255;0;0,2,149,148,0,242,3733,3826,93,0
17206ref1,3682,4139,JUNC00000038,119,+,3682,4139,255;0;0,2,94,150,0,307,3776,3989,213,0
17206ref1,3695,3980,JUNC00000039,137,+,3695,3980,255;0;0,2,91,149,0,136,3786,3831,45,0
17206ref1,3791,6329,JUNC00000040,974,+,3791,6329,255;0;0,2,111,148,0,2390,3902,6181,2279,0
17206ref1,3770,4188,JUNC00000041,59,+,3770,4188,255;0;0,2,145,150,0,268,3915,4038,123,0
17206ref1,3872,4136,JUNC00000042,11,+,3872,4136,255;0;0,2,49,147,0,117,3921,3989,68,0
17206ref1,3891,4299,JUNC00000043,37,+,3891,4299,255;0;0,2,46,150,0,258,3937,4149,212,0
17206ref1,4214,4410,JUNC00000044,5,-,4214,4410,255;0;0,2,25,149,0,47,4239,4261,22,0
17206ref1,4107,4417,JUNC00000045,4,+,4107,4417,255;0;0,2,150,146,0,164,4257,4271,14,0
17206ref1,4262,4407,JUNC00000046,179,-,4262,4407,255;0;0,2,90,25,0,120,4352,4382,30,0
17206ref1,4386,4638,JUNC00000047,22,-,4386,4638,255;0;0,2,51,148,0,104,4437,4490,53,0
17206ref1,4427,4670,JUNC00000048,112,-,4427,4670,255;0;0,2,70,115,0,128,4497,4555,58,0
17206ref1,4830,5152,JUNC00000049,786,-,4830,5152,255;0;0,2,150,148,0,174,4980,5004,24,0
17206ref1,4849,5170,JUNC00000050,22,+,4849,5170,255;0;0,2,144,148,0,173,4993,5022,29,0
17206ref1,5011,6294,JUNC00000051,498,-,5011,6294,255;0;0,2,119,150,0,1133,5130,6144,1014,0
17206ref1,5850,6058,JUNC00000052,3,+,5850,6058,255;0;0,2,115,36,0,172,5965,6022,57,0
17206ref1,5827,6161,JUNC00000053,47,-,5827,6161,255;0;0,2,147,147,0,187,5974,6014,40,0
17206ref1,5959,6230,JUNC00000054,3,+,5959,6230,255;0;0,2,146,120,0,151,6105,6110,5,0
17206ref1,6620,7051,JUNC00000055,4,+,6620,7051,255;0;0,2,82,148,0,283,6702,6903,201,0
17206ref1,6711,6889,JUNC00000056,34,+,6711,6889,255;0;0,2,9,147,0,31,6720,6742,22,0
17206ref1,6747,7108,JUNC00000057,379,-,6747,7108,255;0;0,2,145,146,0,215,6892,6962,70,0
17206ref1,6816,7121,JUNC00000058,1257,+,6816,7121,255;0;0,2,150,150,0,155,6966,6971,5,0
17206ref1,6927,7640,JUNC00000059,4,+,6927,7640,255;0;0,2,146,146,0,567,7073,7494,421,0
17206ref1,7026,7342,JUNC00000060,53,-,7026,7342,255;0;0,2,134,150,0,166,7160,7192,32,0
17206ref1,7166,8072,JUNC00000061,2,-,7166,8072,255;0;0,2,97,148,0,758,7263,7924,661,0
17206ref1,7176,7537,JUNC00000062,68,-,7176,7537,255;0;0,2,137,150,0,211,7313,7387,74,0
17206ref1,7364,7725,JUNC00000063,49,-,7364,7725,255;0;0,2,147,147,0,214,7511,7578,67,0
17206ref1,7389,7698,JUNC00000064,115,-,7389,7698,255;0;0,2,138,142,0,167,7527,7556,29,0
17206ref1,7426,7736,JUNC00000065,14,+,7426,7736,255;0;0,2,150,148,0,162,7576,7588,12,0
17206ref1,7513,8925,JUNC00000066,110,+,7513,8925,255;0;0,2,147,150,0,1262,7660,8775,1115,0
17206ref1,7743,8035,JUNC00000067,28,-,7743,8035,255;0;0,2,33,144,0,148,7776,7891,115,0
17206ref1,7962,8279,JUNC00000068,783,-,7962,8279,255;0;0,2,150,150,0,167,8112,8129,17,0
17206ref1,8319,8638,JUNC00000069,1,+,8319,8638,255;0;0,2,119,32,0,287,8438,8606,168,0
17206ref1,8773,9231,JUNC00000070,11,+,8773,9231,255;0;0,2,148,148,0,310,8921,9083,162,0
17206ref1,8773,9078,JUNC00000071,1819,+,8773,9078,255;0;0,2,150,150,0,155,8923,8928,5,0
17206ref1,8880,9243,JUNC00000072,425,+,8880,9243,255;0;0,2,150,143,0,220,9030,9100,70,0
18364ref2,305,515,JUNC00000001,4,+,305,515,255;0;0,2,149,52,0,158,454,463,9,0
18364ref2,407,6265,JUNC00000002,2,-,407,6265,255;0;0,2,97,149,0,5709,504,6116,5612,0
18364ref2,641,823,JUNC00000003,9,+,641,823,255;0;0,2,26,149,0,33,667,674,7,0
18364ref2,641,880,JUNC00000004,11,+,641,880,255;0;0,2,26,150,0,89,667,730,63,0
18364ref2,650,844,JUNC00000005,105,+,650,844,255;0;0,2,24,148,0,46,674,696,22,0
18364ref2,543,886,JUNC00000006,299,+,543,886,255;0;0,2,131,141,0,202,674,745,71,0
18364ref2,657,1012,JUNC00000007,5,+,657,1012,255;0;0,2,53,148,0,207,710,864,154,0
18364ref2,689,1019,JUNC00000008,107,+,689,1019,255;0;0,2,28,148,0,182,717,871,154,0
18364ref2,711,1025,JUNC00000009,3,+,711,1025,255;0;0,2,19,147,0,167,730,878,148,0
18364ref2,619,1869,JUNC00000010,47,+,619,1869,255;0;0,2,149,150,0,1100,768,1719,951,0
18364ref2,727,1852,JUNC00000011,10,-,727,1852,255;0;0,2,58,140,0,985,785,1712,927,0
18364ref2,649,1876,JUNC00000012,176,-,649,1876,255;0;0,2,136,140,0,1087,785,1736,951,0
18364ref2,768,969,JUNC00000013,56,+,768,969,255;0;0,2,25,143,0,58,793,826,33,0
18364ref2,832,1012,JUNC00000014,10,+,832,1012,255;0;0,2,20,148,0,32,852,864,12,0
18364ref2,710,1009,JUNC00000015,19,-,710,1009,255;0;0,2,145,149,0,150,855,860,5,0
18364ref2,705,1013,JUNC00000016,16,-,705,1013,255;0;0,2,150,149,0,159,855,864,9,0
18364ref2,713,1013,JUNC00000017,4,-,713,1013,255;0;0,2,147,147,0,153,860,866,6,0
18364ref2,928,1092,JUNC00000018,3,+,928,1092,255;0;0,2,25,126,0,38,953,966,13,0
18364ref2,823,1124,JUNC00000019,46,+,823,1124,255;0;0,2,146,148,0,153,969,976,7,0
18364ref2,826,1171,JUNC00000020,10,+,826,1171,255;0;0,2,143,149,0,196,969,1022,53,0
18364ref2,871,1201,JUNC00000021,68,+,871,1201,255;0;0,2,144,146,0,184,1015,1055,40,0
18364ref2,877,1205,JUNC00000022,15,-,877,1205,255;0;0,2,149,148,0,180,1026,1057,31,0
18364ref2,945,1277,JUNC00000023,11,+,945,1277,255;0;0,2,150,149,0,183,1095,1128,33,0
18364ref2,956,1308,JUNC00000024,751,-,956,1308,255;0;0,2,145,150,0,202,1101,1158,57,0
18364ref2,970,1267,JUNC00000025,4,+,970,1267,255;0;0,2,144,145,0,152,1114,1122,8,0
18364ref2,1081,1418,JUNC00000026,3,+,1081,1418,255;0;0,2,33,148,0,189,1114,1270,156,0
18364ref2,978,1291,JUNC00000027,48,+,978,1291,255;0;0,2,149,144,0,169,1127,1147,20,0
18364ref2,1003,1308,JUNC00000028,64,-,1003,1308,255;0;0,2,147,150,0,155,1150,1158,8,0
18364ref2,1500,1896,JUNC00000029,2,+,1500,1896,255;0;0,2,48,147,0,249,1548,1749,201,0
18364ref2,1609,1827,JUNC00000030,37,+,1609,1827,255;0;0,2,59,147,0,71,1668,1680,12,0
18364ref2,1976,2300,JUNC00000031,3,-,1976,2300,255;0;0,2,149,150,0,174,2125,2150,25,0
18364ref2,2238,2572,JUNC00000032,25,-,2238,2572,255;0;0,2,150,148,0,186,2388,2424,36,0
18364ref2,2346,2763,JUNC00000033,14,-,2346,2763,255;0;0,2,147,147,0,270,2493,2616,123,0
18364ref2,2390,2777,JUNC00000034,8,-,2390,2777,255;0;0,2,146,148,0,239,2536,2629,93,0
18364ref2,2485,2992,JUNC00000035,40,+,2485,2992,255;0;0,2,62,147,0,360,2547,2845,298,0
18364ref2,2435,2799,JUNC00000036,32,+,2435,2799,255;0;0,2,145,147,0,217,2580,2652,72,0
18364ref2,2451,2763,JUNC00000037,3,+,2451,2763,255;0;0,2,147,150,0,162,2598,2613,15,0
18364ref2,2651,2988,JUNC00000038,12,+,2651,2988,255;0;0,2,46,148,0,189,2697,2840,143,0
18364ref2,2659,2988,JUNC00000039,136,+,2659,2988,255;0;0,2,147,148,0,181,2806,2840,34,0
18364ref2,2808,2983,JUNC00000040,4,-,2808,2983,255;0;0,2,8,143,0,32,2816,2840,24,0
18364ref2,2701,3009,JUNC00000041,14,+,2701,3009,255;0;0,2,145,147,0,161,2846,2862,16,0
18364ref2,2829,3069,JUNC00000042,60,+,2829,3069,255;0;0,2,64,150,0,90,2893,2919,26,0
18364ref2,2804,8003,JUNC00000043,420,+,2804,8003,255;0;0,2,115,81,0,5118,2919,7922,5003,0
18364ref2,2948,3137,JUNC00000044,3,+,2948,3137,255;0;0,2,8,148,0,41,2956,2989,33,0
18364ref2,3022,3346,JUNC00000045,109,+,3022,3346,255;0;0,2,149,150,0,174,3171,3196,25,0
18364ref2,3207,3432,JUNC00000046,4,-,3207,3432,255;0;0,2,50,148,0,77,3257,3284,27,0
18364ref2,3600,3917,JUNC00000047,1552,-,3600,3917,255;0;0,2,150,150,0,167,3750,3767,17,0
18364ref2,3793,4134,JUNC00000048,5,-,3793,4134,255;0;0,2,54,150,0,191,3847,3984,137,0
18364ref2,3801,8181,JUNC00000049,44,+,3801,8181,255;0;0,2,72,69,0,4311,3873,8112,4239,0
18364ref2,3874,8171,JUNC00000050,8,+,3874,8171,255;0;0,2,8,50,0,4247,3882,8121,4239,0
18364ref2,3885,4165,JUNC00000051,137,-,3885,4165,255;0;0,2,24,150,0,130,3909,4015,106,0
18364ref2,3930,4135,JUNC00000052,15,+,3930,4135,255;0;0,2,26,149,0,56,3956,3986,30,0
18364ref2,3842,9261,JUNC00000053,3,-,3842,9261,255;0;0,2,148,149,0,5270,3990,9112,5122,0
18364ref2,3980,4196,JUNC00000054,4,-,3980,4196,255;0;0,2,25,149,0,67,4005,4047,42,0
18364ref2,4012,4241,JUNC00000055,24,-,4012,4241,255;0;0,2,44,150,0,79,4056,4091,35,0
18364ref2,4039,4250,JUNC00000056,9,+,4039,4250,255;0;0,2,29,147,0,64,4068,4103,35,0
18364ref2,4092,4280,JUNC00000057,27,+,4092,4280,255;0;0,2,28,150,0,38,4120,4130,10,0
18364ref2,3999,4473,JUNC00000058,82,+,3999,4473,255;0;0,2,121,150,0,324,4120,4323,203,0
18364ref2,4016,4468,JUNC00000059,32,+,4016,4468,255;0;0,2,142,145,0,307,4158,4323,165,0
18364ref2,4036,4355,JUNC00000060,3,-,4036,4355,255;0;0,2,150,149,0,170,4186,4206,20,0
18364ref2,4168,4365,JUNC00000061,78,-,4168,4365,255;0;0,2,26,148,0,49,4194,4217,23,0
18364ref2,4181,4418,JUNC00000062,12,+,4181,4418,255;0;0,2,76,147,0,90,4257,4271,14,0
18364ref2,4245,4443,JUNC00000063,10,+,4245,4443,255;0;0,2,12,148,0,50,4257,4295,38,0
18364ref2,4232,4459,JUNC00000064,12,+,4232,4459,255;0;0,2,25,149,0,78,4257,4310,53,0
18364ref2,4286,4512,JUNC00000065,1,+,4286,4512,255;0;0,2,37,77,0,149,4323,4435,112,0
18364ref2,4308,4509,JUNC00000066,3,+,4308,4509,255;0;0,2,21,148,0,53,4329,4361,32,0
18364ref2,4291,4523,JUNC00000067,5,-,4291,4523,255;0;0,2,51,149,0,83,4342,4374,32,0
18364ref2,4217,4530,JUNC00000068,51,-,4217,4530,255;0;0,2,135,148,0,165,4352,4382,30,0
18364ref2,4294,4555,JUNC00000069,3,+,4294,4555,255;0;0,2,68,147,0,114,4362,4408,46,0
18364ref2,4340,4561,JUNC00000070,21,+,4340,4561,255;0;0,2,22,149,0,72,4362,4412,50,0
18364ref2,4233,4552,JUNC00000071,11,+,4233,4552,255;0;0,2,147,144,0,175,4380,4408,28,0
18364ref2,4317,4621,JUNC00000072,9,-,4317,4621,255;0;0,2,147,149,0,155,4464,4472,8,0
18364ref2,4460,4645,JUNC00000073,5,-,4460,4645,255;0;0,2,26,148,0,37,4486,4497,11,0
18364ref2,4387,4698,JUNC00000074,115,-,4387,4698,255;0;0,2,110,143,0,168,4497,4555,58,0
18364ref2,4407,4817,JUNC00000075,70,-,4407,4817,255;0;0,2,125,150,0,260,4532,4667,135,0
18364ref2,4950,5129,JUNC00000076,2,-,4950,5129,255;0;0,2,147,18,0,161,5097,5111,14,0
18364ref2,5017,5474,JUNC00000077,500,+,5017,5474,255;0;0,2,147,150,0,307,5164,5324,160,0
18364ref2,5346,5825,JUNC00000078,2,+,5346,5825,255;0;0,2,52,144,0,335,5398,5681,283,0
18364ref2,5287,5963,JUNC00000079,1,+,5287,5963,255;0;0,2,131,20,0,656,5418,5943,525,0
18364ref2,5708,5922,JUNC00000080,62,+,5708,5922,255;0;0,2,28,147,0,67,5736,5775,39,0
18364ref2,5752,5928,JUNC00000081,8,+,5752,5928,255;0;0,2,149,19,0,157,5901,5909,8,0
18364ref2,5785,6182,JUNC00000082,4,-,5785,6182,255;0;0,2,148,147,0,250,5933,6035,102,0
18364ref2,5827,6157,JUNC00000083,6,+,5827,6157,255;0;0,2,147,150,0,180,5974,6007,33,0
18364ref2,5849,6166,JUNC00000084,30,+,5849,6166,255;0;0,2,148,148,0,169,5997,6018,21,0
18364ref2,5986,6281,JUNC00000085,212,-,5986,6281,255;0;0,2,134,150,0,145,6120,6131,11,0
18364ref2,6158,10154,JUNC00000086,2,+,6158,10154,255;0;0,2,91,60,0,3936,6249,10094,3845,0
18364ref2,6362,6632,JUNC00000087,3,+,6362,6632,255;0;0,2,48,148,0,122,6410,6484,74,0
18364ref2,6556,6831,JUNC00000088,29,-,6556,6831,255;0;0,2,31,149,0,126,6587,6682,95,0
18364ref2,6662,6886,JUNC00000089,10,-,6662,6886,255;0;0,2,32,144,0,80,6694,6742,48,0
18364ref2,6691,6888,JUNC00000090,12,+,6691,6888,255;0;0,2,29,146,0,51,6720,6742,22,0
18364ref2,7130,7326,JUNC00000091,20,-,7130,7326,255;0;0,2,37,147,0,49,7167,7179,12,0
18364ref2,7176,7414,JUNC00000092,32,-,7176,7414,255;0;0,2,87,145,0,93,7263,7269,6,0
18364ref2,7238,7448,JUNC00000093,70,-,7238,7448,255;0;0,2,49,148,0,62,7287,7300,13,0
18364ref2,7179,7526,JUNC00000094,73,-,7179,7526,255;0;0,2,146,150,0,197,7325,7376,51,0
18364ref2,7259,7707,JUNC00000095,96,-,7259,7707,255;0;0,2,150,147,0,301,7409,7560,151,0
18364ref2,7289,7592,JUNC00000096,8,+,7289,7592,255;0;0,2,147,148,0,155,7436,7444,8,0
18364ref2,7383,7629,JUNC00000097,2,-,7383,7629,255;0;0,2,147,73,0,173,7530,7556,26,0
18364ref2,7408,7848,JUNC00000098,46,+,7408,7848,255;0;0,2,146,149,0,291,7554,7699,145,0
18364ref2,7423,7868,JUNC00000099,26,-,7423,7868,255;0;0,2,150,150,0,295,7573,7718,145,0
18364ref2,7531,7788,JUNC00000100,4,+,7531,7788,255;0;0,2,73,35,0,222,7604,7753,149,0
18364ref2,7727,7900,JUNC00000101,2,+,7727,7900,255;0;0,2,130,36,0,137,7857,7864,7,0
18364ref2,7718,8064,JUNC00000102,127,-,7718,8064,255;0;0,2,148,148,0,198,7866,7916,50,0
18364ref2,7771,8025,JUNC00000103,2,-,7771,8025,255;0;0,2,104,145,0,109,7875,7880,5,0
18364ref2,7869,8066,JUNC00000104,1,-,7869,8066,255;0;0,2,95,24,0,173,7964,8042,78,0
18364ref2,7865,8986,JUNC00000105,3,+,7865,8986,255;0;0,2,129,71,0,1050,7994,8915,921,0
18364ref2,7890,8109,JUNC00000106,2,+,7890,8109,255;0;0,2,144,65,0,154,8034,8044,10,0
18364ref2,7963,8279,JUNC00000107,56,-,7963,8279,255;0;0,2,149,150,0,166,8112,8129,17,0
18364ref2,8524,8886,JUNC00000108,994,+,8524,8886,255;0;0,2,150,150,0,212,8674,8736,62,0
18364ref2,8545,8903,JUNC00000109,27,+,8545,8903,255;0;0,2,149,150,0,208,8694,8753,59,0
18364ref2,8771,9233,JUNC00000110,29,+,8771,9233,255;0;0,2,150,150,0,312,8921,9083,162,0
18364ref2,8773,9078,JUNC00000111,2092,+,8773,9078,255;0;0,2,150,150,0,155,8923,8928,5,0
18364ref2,9043,9255,JUNC00000112,4,-,9043,9255,255;0;0,2,35,123,0,89,9078,9132,54,0
18364ref2,9563,9901,JUNC00000113,195,-,9563,9901,255;0;0,2,150,150,0,188,9713,9751,38,0
18364ref2,9666,10065,JUNC00000114,21,+,9666,10065,255;0;0,2,146,149,0,250,9812,9916,104,0
18364ref2,9784,10142,JUNC00000115,34,-,9784,10142,255;0;0,2,124,149,0,209,9908,9993,85,0
17221ref1,676,969,JUNC00000001,137,+,676,969,255;0;0,2,117,143,0,150,793,826,33,0
17221ref1,741,1022,JUNC00000002,57,+,741,1022,255;0;0,2,85,144,0,137,826,878,52,0
17221ref1,847,1013,JUNC00000003,6,-,847,1013,255;0;0,2,8,147,0,19,855,866,11,0
17221ref1,713,1027,JUNC00000004,47,-,713,1027,255;0;0,2,147,149,0,165,860,878,18,0
17221ref1,842,1028,JUNC00000005,32,+,842,1028,255;0;0,2,25,150,0,36,867,878,11,0
17221ref1,796,983,JUNC00000006,7,-,796,983,255;0;0,2,147,28,0,159,943,955,12,0
17221ref1,824,1126,JUNC00000007,254,+,824,1126,255;0;0,2,145,150,0,152,969,976,7,0
17221ref1,825,1170,JUNC00000008,13,+,825,1170,255;0;0,2,144,148,0,197,969,1022,53,0
17221ref1,848,4928,JUNC00000009,15,+,848,4928,255;0;0,2,148,148,0,3932,996,4780,3784,0
17221ref1,955,1308,JUNC00000010,721,-,955,1308,255;0;0,2,146,150,0,203,1101,1158,57,0
17221ref1,963,1286,JUNC00000011,10,+,963,1286,255;0;0,2,148,149,0,174,1111,1137,26,0
17221ref1,963,1295,JUNC00000012,4,+,963,1295,255;0;0,2,148,150,0,182,1111,1145,34,0
17221ref1,969,1283,JUNC00000013,8,+,969,1283,255;0;0,2,147,150,0,164,1116,1133,17,0
17221ref1,976,4469,JUNC00000014,128,+,976,4469,255;0;0,2,146,146,0,3347,1122,4323,3201,0
17221ref1,977,1293,JUNC00000015,122,+,977,1293,255;0;0,2,150,146,0,170,1127,1147,20,0
17221ref1,1518,1826,JUNC00000016,379,+,1518,1826,255;0;0,2,150,146,0,162,1668,1680,12,0
17221ref1,1606,1973,JUNC00000017,75,-,1606,1973,255;0;0,2,145,147,0,220,1751,1826,75,0
17221ref1,1803,2014,JUNC00000018,3,+,1803,2014,255;0;0,2,21,122,0,89,1824,1892,68,0
17221ref1,1714,2058,JUNC00000019,56,-,1714,2058,255;0;0,2,112,146,0,198,1826,1912,86,0
17221ref1,1777,1996,JUNC00000020,2,+,1777,1996,255;0;0,2,73,78,0,141,1850,1918,68,0
17221ref1,1764,2061,JUNC00000021,3,-,1764,2061,255;0;0,2,96,149,0,148,1860,1912,52,0
17221ref1,1914,2300,JUNC00000022,893,+,1914,2300,255;0;0,2,120,150,0,236,2034,2150,116,0
17221ref1,1919,6294,JUNC00000023,116,-,1919,6294,255;0;0,2,144,150,0,4225,2063,6144,4081,0
17221ref1,2168,2493,JUNC00000024,3,-,2168,2493,255;0;0,2,148,150,0,175,2316,2343,27,0
17221ref1,2292,2470,JUNC00000025,1,+,2292,2470,255;0;0,2,35,116,0,62,2327,2354,27,0
17221ref1,2238,2556,JUNC00000026,98,+,2238,2556,255;0;0,2,150,149,0,169,2388,2407,19,0
17221ref1,2498,2797,JUNC00000027,6,-,2498,2797,255;0;0,2,38,145,0,154,2536,2652,116,0
17221ref1,2397,2785,JUNC00000028,13,-,2397,2785,255;0;0,2,147,149,0,239,2544,2636,92,0
17221ref1,2543,2750,JUNC00000029,2,+,2543,2750,255;0;0,2,22,144,0,63,2565,2606,41,0
17221ref1,2450,2763,JUNC00000030,15,+,2450,2763,255;0;0,2,148,150,0,163,2598,2613,15,0
17221ref1,2549,2890,JUNC00000031,170,+,2549,2890,255;0;0,2,148,147,0,194,2697,2743,46,0
17221ref1,2668,2962,JUNC00000032,3,+,2668,2962,255;0;0,2,138,148,0,146,2806,2814,8,0
17221ref1,2658,2984,JUNC00000033,3,+,2658,2984,255;0;0,2,148,144,0,182,2806,2840,34,0
17221ref1,2669,2988,JUNC00000034,13,-,2669,2988,255;0;0,2,147,148,0,171,2816,2840,24,0
17221ref1,2680,2993,JUNC00000035,24,+,2680,2993,255;0;0,2,150,148,0,165,2830,2845,15,0
17221ref1,2697,3009,JUNC00000036,13,+,2697,3009,255;0;0,2,149,147,0,165,2846,2862,16,0
17221ref1,2700,3093,JUNC00000037,30,-,2700,3093,255;0;0,2,148,144,0,249,2848,2949,101,0
17221ref1,2850,2985,JUNC00000038,3,-,2850,2985,255;0;0,2,41,66,0,69,2891,2919,28,0
17221ref1,2856,3110,JUNC00000039,9,+,2856,3110,255;0;0,2,144,8,0,246,3000,3102,102,0
17221ref1,2960,3194,JUNC00000040,8,+,2960,3194,255;0;0,2,52,147,0,87,3012,3047,35,0
17221ref1,2947,3159,JUNC00000041,1,+,2947,3159,255;0;0,2,100,51,0,161,3047,3108,61,0
17221ref1,2995,3317,JUNC00000042,8,+,2995,3317,255;0;0,2,149,148,0,174,3144,3169,25,0
17221ref1,3022,3345,JUNC00000043,115,+,3022,3345,255;0;0,2,149,149,0,174,3171,3196,25,0
17221ref1,3047,3358,JUNC00000044,40,-,3047,3358,255;0;0,2,150,150,0,161,3197,3208,11,0
17221ref1,3204,3433,JUNC00000045,6,-,3204,3433,255;0;0,2,53,149,0,80,3257,3284,27,0
17221ref1,3704,4076,JUNC00000046,1262,-,3704,4076,255;0;0,2,150,150,0,222,3854,3926,72,0
17221ref1,3720,4043,JUNC00000047,7714,+,3720,4043,255;0;0,2,150,149,0,174,3870,3894,24,0
17221ref1,3781,4121,JUNC00000048,25,+,3781,4121,255;0;0,2,146,147,0,193,3927,3974,47,0
17221ref1,3809,4100,JUNC00000049,85,-,3809,4100,255;0;0,2,123,150,0,141,3932,3950,18,0
17221ref1,3886,4097,JUNC00000050,233,-,3886,4097,255;0;0,2,49,149,0,62,3935,3948,13,0
17221ref1,3857,4304,JUNC00000051,55,-,3857,4304,255;0;0,2,144,147,0,300,4001,4157,156,0
17221ref1,3970,4274,JUNC00000052,22,+,3970,4274,255;0;0,2,150,149,0,155,4120,4125,5,0
17221ref1,4097,4308,JUNC00000053,11,-,4097,4308,255;0;0,2,36,148,0,63,4133,4160,27,0
17221ref1,4024,4333,JUNC00000054,234,-,4024,4333,255;0;0,2,126,149,0,160,4150,4184,34,0
17221ref1,4186,4394,JUNC00000055,7,+,4186,4394,255;0;0,2,26,147,0,61,4212,4247,35,0
17221ref1,4206,10122,JUNC00000056,382,-,4206,10122,255;0;0,2,46,150,0,5766,4252,9972,5720,0
17221ref1,4235,4443,JUNC00000057,298,-,4235,4443,255;0;0,2,147,55,0,153,4382,4388,6,0
17221ref1,4358,4700,JUNC00000058,113,-,4358,4700,255;0;0,2,139,145,0,197,4497,4555,58,0
17221ref1,4478,4681,JUNC00000059,31,+,4478,4681,255;0;0,2,51,17,0,186,4529,4664,135,0
17221ref1,4461,4779,JUNC00000060,200,-,4461,4779,255;0;0,2,71,112,0,206,4532,4667,135,0
17221ref1,4397,4824,JUNC00000061,73,-,4397,4824,255;0;0,2,142,150,0,277,4539,4674,135,0
17221ref1,4542,5326,JUNC00000062,1,-,4542,5326,255;0;0,2,125,26,0,758,4667,5300,633,0
17221ref1,4845,5161,JUNC00000063,4,+,4845,5161,255;0;0,2,46,144,0,172,4891,5017,126,0
17221ref1,4890,4987,JUNC00000064,13,+,4890,4987,255;0;0,2,45,43,0,54,4935,4944,9,0
17221ref1,5023,8629,JUNC00000065,3,-,5023,8629,255;0;0,2,119,32,0,3574,5142,8597,3455,0
17221ref1,5367,5893,JUNC00000066,229,+,5367,5893,255;0;0,2,150,149,0,377,5517,5744,227,0
17221ref1,5472,5778,JUNC00000067,16,-,5472,5778,255;0;0,2,128,145,0,161,5600,5633,33,0
17221ref1,5633,5997,JUNC00000068,2,-,5633,5997,255;0;0,2,143,145,0,219,5776,5852,76,0
17221ref1,5698,6098,JUNC00000069,2,+,5698,6098,255;0;0,2,146,118,0,282,5844,5980,136,0
17221ref1,6002,6273,JUNC00000070,55,-,6002,6273,255;0;0,2,113,147,0,124,6115,6126,11,0
17221ref1,6091,6279,JUNC00000071,120,-,6091,6279,255;0;0,2,29,148,0,40,6120,6131,11,0
17221ref1,5997,6216,JUNC00000072,2,-,5997,6216,255;0;0,2,147,18,0,201,6144,6198,54,0
17221ref1,6112,6409,JUNC00000073,8,-,6112,6409,255;0;0,2,143,146,0,151,6255,6263,8,0
17221ref1,6106,6434,JUNC00000074,73,+,6106,6434,255;0;0,2,149,150,0,178,6255,6284,29,0
17221ref1,6648,6814,JUNC00000075,1,-,6648,6814,255;0;0,2,9,122,0,44,6657,6692,35,0
17221ref1,6547,6892,JUNC00000076,32,-,6547,6892,255;0;0,2,147,150,0,195,6694,6742,48,0
17221ref1,6711,6891,JUNC00000077,32,+,6711,6891,255;0;0,2,9,149,0,31,6720,6742,22,0
17221ref1,6971,7363,JUNC00000078,12,+,6971,7363,255;0;0,2,149,149,0,243,7120,7214,94,0
17221ref1,7295,7525,JUNC00000079,206,-,7295,7525,255;0;0,2,30,149,0,81,7325,7376,51,0
17221ref1,7320,7537,JUNC00000080,29,-,7320,7537,255;0;0,2,45,150,0,67,7365,7387,22,0
17221ref1,7299,7550,JUNC00000081,7,-,7299,7550,255;0;0,2,82,147,0,104,7381,7403,22,0
17221ref1,7361,7725,JUNC00000082,116,-,7361,7725,255;0;0,2,150,147,0,217,7511,7578,67,0
17221ref1,7392,7712,JUNC00000083,91,+,7392,7712,255;0;0,2,147,150,0,170,7539,7562,23,0
17221ref1,7405,7867,JUNC00000084,41,+,7405,7867,255;0;0,2,149,147,0,315,7554,7720,166,0
17221ref1,7651,8033,JUNC00000085,29,+,7651,8033,255;0;0,2,149,148,0,234,7800,7885,85,0
17221ref1,7711,8044,JUNC00000086,44,+,7711,8044,255;0;0,2,146,150,0,183,7857,7894,37,0
17221ref1,7769,9589,JUNC00000087,1,-,7769,9589,255;0;0,2,106,44,0,1776,7875,9545,1670,0
17221ref1,8281,8588,JUNC00000088,1492,+,8281,8588,255;0;0,2,150,150,0,157,8431,8438,7,0
17221ref1,8290,8756,JUNC00000089,90,+,8290,8756,255;0;0,2,148,150,0,316,8438,8606,168,0
17221ref1,8844,9141,JUNC00000090,2,+,8844,9141,255;0;0,2,71,144,0,153,8915,8997,82,0
17221ref1,8855,9231,JUNC00000091,110,+,8855,9231,255;0;0,2,66,148,0,228,8921,9083,162,0
17221ref1,8854,9078,JUNC00000092,1953,+,8854,9078,255;0;0,2,69,150,0,74,8923,8928,5,0
17221ref1,9033,9220,JUNC00000093,2,-,9033,9220,255;0;0,2,41,88,0,99,9074,9132,58,0
17221ref1,9939,10272,JUNC00000094,1,+,9939,10272,255;0;0,2,56,95,0,238,9995,10177,182,0
17221ref1,10014,10268,JUNC00000095,1378,+,10014,10268,255;0;0,2,150,76,0,178,10164,10192,28,0
17881ref1,225,687,JUNC00000001,62,+,225,687,255;0;0,2,150,145,0,317,375,542,167,0
17881ref1,444,2940,JUNC00000002,24,+,444,2940,255;0;0,2,27,124,0,2372,471,2816,2345,0
17881ref1,421,1293,JUNC00000003,2,-,421,1293,255;0;0,2,81,48,0,824,502,1245,743,0
17881ref1,398,878,JUNC00000004,106,+,398,878,255;0;0,2,136,148,0,332,534,730,196,0
17881ref1,426,726,JUNC00000005,8,+,426,726,255;0;0,2,145,149,0,151,571,577,6,0
17881ref1,616,779,JUNC00000006,78,+,616,779,255;0;0,2,11,146,0,17,627,633,6,0
17881ref1,513,821,JUNC00000007,35,+,513,821,255;0;0,2,143,147,0,161,656,674,18,0
17881ref1,581,1091,JUNC00000008,45,+,581,1091,255;0;0,2,75,76,0,434,656,1015,359,0
17881ref1,521,823,JUNC00000009,13,+,521,823,255;0;0,2,146,149,0,153,667,674,7,0
17881ref1,518,895,JUNC00000010,5,+,518,895,255;0;0,2,149,150,0,227,667,745,78,0
17881ref1,546,888,JUNC00000011,45,+,546,888,255;0;0,2,128,143,0,199,674,745,71,0
17881ref1,555,796,JUNC00000012,18,+,555,796,255;0;0,2,119,44,0,197,674,752,78,0
17881ref1,542,972,JUNC00000013,27,+,542,972,255;0;0,2,132,146,0,284,674,826,152,0
17881ref1,583,744,JUNC00000014,1,+,583,744,255;0;0,2,98,53,0,108,681,691,10,0
17881ref1,633,870,JUNC00000015,306,+,633,870,255;0;0,2,77,149,0,88,710,721,11,0
17881ref1,584,905,JUNC00000016,52,+,584,905,255;0;0,2,146,147,0,174,730,758,28,0
17881ref1,715,962,JUNC00000017,4,+,715,962,255;0;0,2,23,150,0,97,738,812,74,0
17881ref1,698,937,JUNC00000018,101,+,698,937,255;0;0,2,66,144,0,95,764,793,29,0
17881ref1,620,1123,JUNC00000019,47,+,620,1123,255;0;0,2,144,108,0,395,764,1015,251,0
17881ref1,628,1898,JUNC00000020,76,-,628,1898,255;0;0,2,142,147,0,1123,770,1751,981,0
17881ref1,640,1027,JUNC00000021,92,-,640,1027,255;0;0,2,145,149,0,238,785,878,93,0
17881ref1,802,1061,JUNC00000022,246,+,802,1061,255;0;0,2,24,147,0,112,826,914,88,0
17881ref1,698,1020,JUNC00000023,95,+,698,1020,255;0;0,2,148,149,0,173,846,871,25,0
17881ref1,710,1009,JUNC00000024,34,-,710,1009,255;0;0,2,145,149,0,150,855,860,5,0
17881ref1,729,1114,JUNC00000025,55,+,729,1114,255;0;0,2,149,148,0,237,878,966,88,0
17881ref1,752,1027,JUNC00000026,1,+,752,1027,255;0;0,2,126,25,0,250,878,1002,124,0
17881ref1,773,1084,JUNC00000027,5,-,773,1084,255;0;0,2,149,149,0,162,922,935,13,0
17881ref1,823,1125,JUNC00000028,77,+,823,1125,255;0;0,2,146,149,0,153,969,976,7,0
17881ref1,956,3433,JUNC00000029,1,+,956,3433,255;0;0,2,22,129,0,2348,978,3304,2326,0
17881ref1,852,1133,JUNC00000030,62,+,852,1133,255;0;0,2,150,102,0,179,1002,1031,29,0
17881ref1,974,9000,JUNC00000031,68,+,974,9000,255;0;0,2,28,123,0,7903,1002,8877,7875,0
17881ref1,871,1201,JUNC00000032,28,+,871,1201,255;0;0,2,144,146,0,184,1015,1055,40,0
17881ref1,871,1393,JUNC00000033,62,+,871,1393,255;0;0,2,144,85,0,437,1015,1308,293,0
17881ref1,871,2831,JUNC00000034,384,+,871,2831,255;0;0,2,144,60,0,1900,1015,2771,1756,0
17881ref1,875,4063,JUNC00000035,7,+,875,4063,255;0;0,2,149,150,0,3038,1024,3913,2889,0
17881ref1,918,1237,JUNC00000036,3,-,918,1237,255;0;0,2,150,147,0,172,1068,1090,22,0
17881ref1,945,1277,JUNC00000037,34,+,945,1277,255;0;0,2,150,149,0,183,1095,1128,33,0
17881ref1,962,1283,JUNC00000038,42,+,962,1283,255;0;0,2,149,150,0,171,1111,1133,22,0
17881ref1,964,1268,JUNC00000039,6,+,964,1268,255;0;0,2,150,148,0,156,1114,1120,6,0
17881ref1,1089,1270,JUNC00000040,2,+,1089,1270,255;0;0,2,25,148,0,33,1114,1122,8,0
17881ref1,969,1283,JUNC00000041,8,+,969,1283,255;0;0,2,147,150,0,164,1116,1133,17,0
17881ref1,978,1267,JUNC00000042,44,+,978,1267,255;0;0,2,149,120,0,169,1127,1147,20,0
17881ref1,979,1169,JUNC00000043,65,-,979,1169,255;0;0,2,149,11,0,179,1128,1158,30,0
17881ref1,1000,1301,JUNC00000044,3,-,1000,1301,255;0;0,2,150,146,0,155,1150,1155,5,0
17881ref1,1002,1307,JUNC00000045,146,-,1002,1307,255;0;0,2,148,149,0,156,1150,1158,8,0
17881ref1,1077,1380,JUNC00000046,16,+,1077,1380,255;0;0,2,147,148,0,155,1224,1232,8,0
17881ref1,1124,1465,JUNC00000047,547,+,1124,1465,255;0;0,2,146,150,0,191,1270,1315,45,0
17881ref1,1398,1730,JUNC00000048,7,-,1398,1730,255;0;0,2,132,149,0,183,1530,1581,51,0
17881ref1,1560,1942,JUNC00000049,2449,+,1560,1942,255;0;0,2,150,149,0,233,1710,1793,83,0
17881ref1,1599,2122,JUNC00000050,2124,+,1599,2122,255;0;0,2,150,150,0,373,1749,1972,223,0
17881ref1,1741,2013,JUNC00000051,37,-,1741,2013,255;0;0,2,85,101,0,171,1826,1912,86,0
17881ref1,1812,2016,JUNC00000052,27,+,1812,2016,255;0;0,2,48,150,0,54,1860,1866,6,0
17881ref1,1867,2147,JUNC00000053,42,-,1867,2147,255;0;0,2,110,146,0,134,1977,2001,24,0
17881ref1,1878,2184,JUNC00000054,18,-,1878,2184,255;0;0,2,150,148,0,158,2028,2036,8,0
17881ref1,1955,2127,JUNC00000055,4,+,1955,2127,255;0;0,2,149,8,0,164,2104,2119,15,0
17881ref1,1976,2298,JUNC00000056,5,-,1976,2298,255;0;0,2,149,148,0,174,2125,2150,25,0
17881ref1,1989,2296,JUNC00000057,11,+,1989,2296,255;0;0,2,147,149,0,158,2136,2147,11,0
17881ref1,2140,2374,JUNC00000058,65,+,2140,2374,255;0;0,2,64,149,0,85,2204,2225,21,0
17881ref1,2205,6011,JUNC00000059,11,-,2205,6011,255;0;0,2,149,124,0,3682,2354,5887,3533,0
17881ref1,2445,2659,JUNC00000060,10,+,2445,2659,255;0;0,2,19,150,0,64,2464,2509,45,0
17881ref1,2329,2720,JUNC00000061,13,+,2329,2720,255;0;0,2,146,50,0,341,2475,2670,195,0
17881ref1,2395,2781,JUNC00000062,41,-,2395,2781,255;0;0,2,149,145,0,241,2544,2636,92,0
17881ref1,2418,2734,JUNC00000063,14,-,2418,2734,255;0;0,2,148,148,0,168,2566,2586,20,0
17881ref1,2432,2776,JUNC00000064,6,+,2432,2776,255;0;0,2,148,147,0,197,2580,2629,49,0
17881ref1,2435,2783,JUNC00000065,37,+,2435,2783,255;0;0,2,145,86,0,262,2580,2697,117,0
17881ref1,2444,2746,JUNC00000066,3,+,2444,2746,255;0;0,2,149,147,0,155,2593,2599,6,0
17881ref1,2449,2763,JUNC00000067,9,+,2449,2763,255;0;0,2,149,150,0,164,2598,2613,15,0
17881ref1,2643,2971,JUNC00000068,6,-,2643,2971,255;0;0,2,32,146,0,182,2675,2825,150,0
17881ref1,2649,2991,JUNC00000069,5,+,2649,2991,255;0;0,2,26,149,0,193,2675,2842,167,0
17881ref1,2696,2891,JUNC00000070,186,-,2696,2891,255;0;0,2,34,148,0,47,2730,2743,13,0
17881ref1,2660,2957,JUNC00000071,160,+,2660,2957,255;0;0,2,146,143,0,154,2806,2814,8,0
17881ref1,2659,2989,JUNC00000072,162,+,2659,2989,255;0;0,2,147,149,0,181,2806,2840,34,0
17881ref1,2669,3074,JUNC00000073,4,-,2669,3074,255;0;0,2,147,9,0,396,2816,3065,249,0
17881ref1,2671,3002,JUNC00000074,7,-,2671,3002,255;0;0,2,149,144,0,187,2820,2858,38,0
17881ref1,2680,2994,JUNC00000075,26,+,2680,2994,255;0;0,2,150,149,0,165,2830,2845,15,0
17881ref1,2684,3033,JUNC00000076,98,+,2684,3033,255;0;0,2,146,149,0,200,2830,2884,54,0
17881ref1,2778,3183,JUNC00000077,2,+,2778,3183,255;0;0,2,52,104,0,301,2830,3079,249,0
17881ref1,2698,3252,JUNC00000078,44,+,2698,3252,255;0;0,2,150,150,0,404,2848,3102,254,0
17881ref1,2724,3196,JUNC00000079,8,-,2724,3196,255;0;0,2,149,149,0,323,2873,3047,174,0
17881ref1,2872,3044,JUNC00000080,1,-,2872,3044,255;0;0,2,19,132,0,40,2891,2912,21,0
17881ref1,2803,2982,JUNC00000081,1,-,2803,2982,255;0;0,2,88,63,0,116,2891,2919,28,0
17881ref1,2883,3215,JUNC00000082,7,-,2883,3215,255;0;0,2,8,150,0,182,2891,3065,174,0
17881ref1,2854,2943,JUNC00000083,11,-,2854,2943,255;0;0,2,50,20,0,69,2904,2923,19,0
17881ref1,2878,3168,JUNC00000084,8,+,2878,3168,255;0;0,2,41,123,0,167,2919,3045,126,0
17881ref1,2884,3196,JUNC00000085,17,+,2884,3196,255;0;0,2,37,149,0,163,2921,3047,126,0
17881ref1,2911,3163,JUNC00000086,38,-,2911,3163,255;0;0,2,45,149,0,103,2956,3014,58,0
17881ref1,3008,3171,JUNC00000087,8,-,3008,3171,255;0;0,2,8,150,0,13,3016,3021,5,0
17881ref1,2891,9378,JUNC00000088,61,+,2891,9378,255;0;0,2,149,148,0,6339,3040,9230,6190,0
17881ref1,2945,9303,JUNC00000089,25,+,2945,9303,255;0;0,2,102,66,0,6292,3047,9237,6190,0
17881ref1,3022,3286,JUNC00000090,144,+,3022,3286,255;0;0,2,149,90,0,174,3171,3196,25,0
17881ref1,3107,3434,JUNC00000091,45,-,3107,3434,255;0;0,2,150,150,0,177,3257,3284,27,0
17881ref1,3418,3993,JUNC00000092,112,+,3418,3993,255;0;0,2,150,99,0,476,3568,3894,326,0
17881ref1,3617,3931,JUNC00000093,1133,-,3617,3931,255;0;0,2,150,143,0,171,3767,3788,21,0
17881ref1,3822,4106,JUNC00000094,15,-,3822,4106,255;0;0,2,129,150,0,134,3951,3956,5,0
17881ref1,3846,4131,JUNC00000095,38,+,3846,4131,255;0;0,2,122,145,0,140,3968,3986,18,0
17881ref1,3947,4164,JUNC00000096,60,+,3947,4164,255;0;0,2,21,149,0,68,3968,4015,47,0
17881ref1,3841,4166,JUNC00000097,12,-,3841,4166,255;0;0,2,149,148,0,177,3990,4018,28,0
17881ref1,4020,4235,JUNC00000098,56,+,4020,4235,255;0;0,2,48,147,0,68,4068,4088,20,0
17881ref1,3932,4253,JUNC00000099,77,+,3932,4253,255;0;0,2,149,150,0,171,4081,4103,22,0
17881ref1,4099,4351,JUNC00000100,31,-,4099,4351,255;0;0,2,62,148,0,104,4161,4203,42,0
17881ref1,4081,4395,JUNC00000101,4,-,4081,4395,255;0;0,2,150,148,0,166,4231,4247,16,0
17881ref1,4128,4418,JUNC00000102,7,+,4128,4418,255;0;0,2,129,147,0,143,4257,4271,14,0
17881ref1,4293,4523,JUNC00000103,10,-,4293,4523,255;0;0,2,49,149,0,81,4342,4374,32,0
17881ref1,4224,4564,JUNC00000104,11,+,4224,4564,255;0;0,2,148,150,0,190,4372,4414,42,0
17881ref1,4229,4403,JUNC00000105,17,-,4229,4403,255;0;0,2,146,21,0,153,4375,4382,7,0
17881ref1,4229,4927,JUNC00000106,15,+,4229,4927,255;0;0,2,149,150,0,548,4378,4777,399,0
17881ref1,4423,4703,JUNC00000107,152,-,4423,4703,255;0;0,2,74,148,0,132,4497,4555,58,0
17881ref1,4470,4654,JUNC00000108,1,-,4470,4654,255;0;0,2,36,115,0,69,4506,4539,33,0
17881ref1,4395,4813,JUNC00000109,19,-,4395,4813,255;0;0,2,144,139,0,279,4539,4674,135,0
17881ref1,4713,5077,JUNC00000110,426,+,4713,5077,255;0;0,2,102,150,0,214,4815,4927,112,0
17881ref1,4715,5237,JUNC00000111,156,-,4715,5237,255;0;0,2,148,150,0,372,4863,5087,224,0
17881ref1,4750,7574,JUNC00000112,35,-,4750,7574,255;0;0,2,148,147,0,2677,4898,7427,2529,0
17881ref1,5378,5859,JUNC00000113,2,+,5378,5859,255;0;0,2,40,111,0,370,5418,5748,330,0
17881ref1,5281,5586,JUNC00000114,57,+,5281,5586,255;0;0,2,149,150,0,155,5430,5436,6,0
17881ref1,5681,6027,JUNC00000115,3,+,5681,6027,255;0;0,2,149,148,0,198,5830,5879,49,0
17881ref1,5701,6003,JUNC00000116,14,+,5701,6003,255;0;0,2,140,149,0,153,5841,5854,13,0
17881ref1,5729,6031,JUNC00000117,5,+,5729,6031,255;0;0,2,149,147,0,155,5878,5884,6,0
17881ref1,6334,6641,JUNC00000118,2407,+,6334,6641,255;0;0,2,150,150,0,157,6484,6491,7,0
17881ref1,6514,6819,JUNC00000119,571,+,6514,6819,255;0;0,2,150,149,0,156,6664,6670,6,0
17881ref1,6954,7216,JUNC00000120,24,+,6954,7216,255;0;0,2,57,150,0,112,7011,7066,55,0
17881ref1,6989,7287,JUNC00000121,30,+,6989,7287,255;0;0,2,148,145,0,153,7137,7142,5,0
17881ref1,7064,7344,JUNC00000122,9,+,7064,7344,255;0;0,2,106,149,0,131,7170,7195,25,0
17881ref1,7129,7431,JUNC00000123,6,-,7129,7431,255;0;0,2,149,148,0,154,7278,7283,5,0
17881ref1,7206,7549,JUNC00000124,3,+,7206,7549,255;0;0,2,148,147,0,196,7354,7402,48,0
17881ref1,7319,7825,JUNC00000125,54,-,7319,7825,255;0;0,2,90,140,0,366,7409,7685,276,0
17881ref1,7361,7618,JUNC00000126,104,-,7361,7618,255;0;0,2,150,40,0,217,7511,7578,67,0
17881ref1,7427,7604,JUNC00000127,16,-,7427,7604,255;0;0,2,103,48,0,129,7530,7556,26,0
17881ref1,7404,9342,JUNC00000128,33,+,7404,9342,255;0;0,2,150,28,0,1910,7554,9314,1760,0
17881ref1,7513,7817,JUNC00000129,6,-,7513,7817,255;0;0,2,147,150,0,154,7660,7667,7,0
17881ref1,7529,7833,JUNC00000130,4,+,7529,7833,255;0;0,2,149,148,0,156,7678,7685,7,0
17881ref1,7539,7845,JUNC00000131,12,+,7539,7845,255;0;0,2,150,149,0,157,7689,7696,7,0
17881ref1,7676,8038,JUNC00000132,50,+,7676,8038,255;0;0,2,57,150,0,212,7733,7888,155,0
17881ref1,7736,7934,JUNC00000133,70,-,7736,7934,255;0;0,2,40,148,0,50,7776,7786,10,0
17881ref1,7730,8039,JUNC00000134,23,-,7730,8039,255;0;0,2,46,148,0,161,7776,7891,115,0
17881ref1,7744,8043,JUNC00000135,43,+,7744,8043,255;0;0,2,35,149,0,150,7779,7894,115,0
17881ref1,7692,7881,JUNC00000136,6,+,7692,7881,255;0;0,2,148,27,0,162,7840,7854,14,0
17881ref1,7710,8014,JUNC00000137,3,+,7710,8014,255;0;0,2,147,150,0,154,7857,7864,7,0
17881ref1,7888,8207,JUNC00000138,635,+,7888,8207,255;0;0,2,146,150,0,169,8034,8057,23,0
17881ref1,8200,8541,JUNC00000139,6,+,8200,8541,255;0;0,2,147,149,0,192,8347,8392,45,0
17881ref1,8796,9262,JUNC00000140,3,+,8796,9262,255;0;0,2,45,147,0,319,8841,9115,274,0
17881ref1,8789,9076,JUNC00000141,3,+,8789,9076,255;0;0,2,126,148,0,139,8915,8928,13,0
17881ref1,8864,9233,JUNC00000142,95,+,8864,9233,255;0;0,2,57,150,0,219,8921,9083,162,0
17881ref1,8893,9237,JUNC00000143,21,+,8893,9237,255;0;0,2,28,149,0,195,8921,9088,167,0
17881ref1,8789,9078,JUNC00000144,2496,+,8789,9078,255;0;0,2,134,150,0,139,8923,8928,5,0
17881ref1,8864,9186,JUNC00000145,11,+,8864,9186,255;0;0,2,149,149,0,173,9013,9037,24,0
17881ref1,8908,9227,JUNC00000146,2,-,8908,9227,255;0;0,2,148,124,0,195,9056,9103,47,0
17881ref1,8954,9278,JUNC00000147,7,+,8954,9278,255;0;0,2,150,150,0,174,9104,9128,24,0
17881ref1,9069,9259,JUNC00000148,1,+,9069,9259,255;0;0,2,128,22,0,168,9197,9237,40,0
17881ref1,9091,9766,JUNC00000149,92,+,9091,9766,255;0;0,2,146,148,0,527,9237,9618,381,0
17881ref1,9176,9367,JUNC00000150,1,+,9176,9367,255;0;0,2,94,35,0,156,9270,9332,62,0
17881ref1,9184,9493,JUNC00000151,4,-,9184,9493,255;0;0,2,149,149,0,160,9333,9344,11,0
17881ref1,9627,10089,JUNC00000152,128,+,9627,10089,255;0;0,2,82,119,0,343,9709,9970,261,0
17881ref1,9695,10441,JUNC00000153,1,-,9695,10441,255;0;0,2,129,22,0,724,9824,10419,595,0
17881ref1,9727,10133,JUNC00000154,1,-,9727,10133,255;0;0,2,99,52,0,354,9826,10081,255,0
17881ref1,9871,10064,JUNC00000155,6,+,9871,10064,255;0;0,2,23,148,0,45,9894,9916,22,0
17881ref1,9851,10207,JUNC00000156,1,+,9851,10207,255;0;0,2,43,108,0,248,9894,10099,205,0
17881ref1,9830,10072,JUNC00000157,93,+,9830,10072,255;0;0,2,73,147,0,95,9903,9925,22,0
17881ref1,9922,10185,JUNC00000158,3,-,9922,10185,255;0;0,2,129,22,0,241,10051,10163,112,0
16907ref1,44,2503,JUNC00000001,691,-,44,2503,255;0;0,2,150,149,0,2310,194,2354,2160,0
16907ref1,247,1410,JUNC00000002,3,+,247,1410,255;0;0,2,144,8,0,1155,391,1402,1011,0
16907ref1,498,779,JUNC00000003,39,+,498,779,255;0;0,2,129,146,0,135,627,633,6,0
16907ref1,537,1133,JUNC00000004,100,+,537,1133,255;0;0,2,90,131,0,465,627,1002,375,0
16907ref1,619,823,JUNC00000005,23,+,619,823,255;0;0,2,48,149,0,55,667,674,7,0
16907ref1,619,843,JUNC00000006,29,+,619,843,255;0;0,2,48,149,0,75,667,694,27,0
16907ref1,619,846,JUNC00000007,16,+,619,846,255;0;0,2,48,150,0,77,667,696,29,0
16907ref1,546,862,JUNC00000008,71,+,546,862,255;0;0,2,128,117,0,199,674,745,71,0
16907ref1,666,1020,JUNC00000009,102,+,666,1020,255;0;0,2,51,149,0,205,717,871,154,0
16907ref1,678,982,JUNC00000010,36,+,678,982,255;0;0,2,54,150,0,154,732,832,100,0
16907ref1,612,6652,JUNC00000011,2,-,612,6652,255;0;0,2,132,19,0,6021,744,6633,5889,0
16907ref1,609,1071,JUNC00000012,6,-,609,1071,255;0;0,2,148,148,0,314,757,923,166,0
16907ref1,699,2985,JUNC00000013,38,+,699,2985,255;0;0,2,65,145,0,2141,764,2840,2076,0
16907ref1,649,969,JUNC00000014,74,+,649,969,255;0;0,2,144,143,0,177,793,826,33,0
16907ref1,763,976,JUNC00000015,106,+,763,976,255;0;0,2,41,150,0,63,804,826,22,0
16907ref1,709,1009,JUNC00000016,18,-,709,1009,255;0;0,2,146,149,0,151,855,860,5,0
16907ref1,782,1085,JUNC00000017,48,+,782,1085,255;0;0,2,148,150,0,153,930,935,5,0
16907ref1,794,1102,JUNC00000018,11,-,794,1102,255;0;0,2,149,149,0,159,943,953,10,0
16907ref1,794,1109,JUNC00000019,69,-,794,1109,255;0;0,2,149,149,0,166,943,960,17,0
16907ref1,823,1126,JUNC00000020,142,+,823,1126,255;0;0,2,146,150,0,153,969,976,7,0
16907ref1,866,1375,JUNC00000021,12,+,866,1375,255;0;0,2,136,145,0,364,1002,1230,228,0
16907ref1,978,9019,JUNC00000022,66,+,978,9019,255;0;0,2,24,142,0,7899,1002,8877,7875,0
16907ref1,858,8977,JUNC00000023,4,+,858,8977,255;0;0,2,147,97,0,8022,1005,8880,7875,0
16907ref1,871,1133,JUNC00000024,25,+,871,1133,255;0;0,2,144,78,0,184,1015,1055,40,0
16907ref1,871,2029,JUNC00000025,51,+,871,2029,255;0;0,2,144,144,0,1014,1015,1885,870,0
16907ref1,923,1093,JUNC00000026,2,-,923,1093,255;0;0,2,145,8,0,162,1068,1085,17,0
16907ref1,953,1306,JUNC00000027,689,-,953,1306,255;0;0,2,148,148,0,205,1101,1158,57,0
16907ref1,965,9264,JUNC00000028,5,+,965,9264,255;0;0,2,144,113,0,8186,1109,9151,8042,0
16907ref1,964,1286,JUNC00000029,17,+,964,1286,255;0;0,2,147,149,0,173,1111,1137,26,0
16907ref1,971,1286,JUNC00000030,21,+,971,1286,255;0;0,2,145,149,0,166,1116,1137,21,0
16907ref1,977,1292,JUNC00000031,95,+,977,1292,255;0;0,2,150,145,0,170,1127,1147,20,0
16907ref1,979,1141,JUNC00000032,127,-,979,1141,255;0;0,2,149,8,0,154,1128,1133,5,0
16907ref1,1003,1304,JUNC00000033,8,-,1003,1304,255;0;0,2,147,149,0,152,1150,1155,5,0
16907ref1,1001,1307,JUNC00000034,102,-,1001,1307,255;0;0,2,149,149,0,157,1150,1158,8,0
16907ref1,1004,2658,JUNC00000035,47,-,1004,2658,255;0;0,2,150,146,0,1508,1154,2512,1358,0
16907ref1,1064,9291,JUNC00000036,3,-,1064,9291,255;0;0,2,110,41,0,8186,1174,9250,8076,0
16907ref1,1077,1380,JUNC00000037,23,+,1077,1380,255;0;0,2,147,148,0,155,1224,1232,8,0
16907ref1,1191,9689,JUNC00000038,1,+,1191,9689,255;0;0,2,65,71,0,8427,1256,9618,8362,0
16907ref1,1124,1404,JUNC00000039,20,+,1124,1404,255;0;0,2,146,89,0,191,1270,1315,45,0
16907ref1,1121,7558,JUNC00000040,37,+,1121,7558,255;0;0,2,149,50,0,6387,1270,7508,6238,0
16907ref1,1244,1555,JUNC00000041,22,+,1244,1555,255;0;0,2,149,147,0,164,1393,1408,15,0
16907ref1,1281,2732,JUNC00000042,6,+,1281,2732,255;0;0,2,138,35,0,1416,1419,2697,1278,0
16907ref1,1361,1713,JUNC00000043,2,-,1361,1713,255;0;0,2,150,150,0,202,1511,1563,52,0
16907ref1,1431,1739,JUNC00000044,4,-,1431,1739,255;0;0,2,126,145,0,163,1557,1594,37,0
16907ref1,1519,4467,JUNC00000045,101,+,1519,4467,255;0;0,2,147,146,0,2802,1666,4321,2655,0
16907ref1,1522,4472,JUNC00000046,2,+,1522,4472,255;0;0,2,146,149,0,2801,1668,4323,2655,0
16907ref1,1537,1854,JUNC00000047,24,+,1537,1854,255;0;0,2,149,149,0,168,1686,1705,19,0
16907ref1,1607,1974,JUNC00000048,79,-,1607,1974,255;0;0,2,144,148,0,219,1751,1826,75,0
16907ref1,1605,3333,JUNC00000049,269,+,1605,3333,255;0;0,2,149,150,0,1578,1754,3183,1429,0
16907ref1,1613,1917,JUNC00000050,2,-,1613,1917,255;0;0,2,150,149,0,155,1763,1768,5,0
16907ref1,1613,1923,JUNC00000051,38,-,1613,1923,255;0;0,2,150,148,0,162,1763,1775,12,0
16907ref1,1613,2084,JUNC00000052,42,-,1613,2084,255;0;0,2,150,72,0,399,1763,2012,249,0
16907ref1,1634,1954,JUNC00000053,3,-,1634,1954,255;0;0,2,148,148,0,172,1782,1806,24,0
16907ref1,1857,2232,JUNC00000054,27,+,1857,2232,255;0;0,2,150,149,0,226,2007,2083,76,0
16907ref1,1857,2658,JUNC00000055,17,+,1857,2658,255;0;0,2,150,149,0,652,2007,2509,502,0
16907ref1,1914,2240,JUNC00000056,181,+,1914,2240,255;0;0,2,120,90,0,236,2034,2150,116,0
16907ref1,1918,2185,JUNC00000057,1,+,1918,2185,255;0;0,2,122,29,0,238,2040,2156,116,0
16907ref1,1900,8047,JUNC00000058,138,-,1900,8047,255;0;0,2,147,141,0,6006,2047,7906,5859,0
16907ref1,1955,2477,JUNC00000059,3,-,1955,2477,255;0;0,2,150,150,0,372,2105,2327,222,0
16907ref1,1988,7728,JUNC00000060,4,+,1988,7728,255;0;0,2,148,147,0,5593,2136,7581,5445,0
16907ref1,2183,2366,JUNC00000061,2,-,2183,2366,255;0;0,2,24,105,0,78,2207,2261,54,0
16907ref1,2188,2404,JUNC00000062,1,+,2188,2404,255;0;0,2,29,69,0,147,2217,2335,118,0
16907ref1,2220,2557,JUNC00000063,59,+,2220,2557,255;0;0,2,146,150,0,187,2366,2407,41,0
16907ref1,2353,2641,JUNC00000064,50,-,2353,2641,255;0;0,2,26,148,0,140,2379,2493,114,0
16907ref1,2347,6213,JUNC00000065,12,+,2347,6213,255;0;0,2,49,147,0,3719,2396,6066,3670,0
16907ref1,2310,2656,JUNC00000066,9,+,2310,2656,255;0;0,2,108,147,0,199,2418,2509,91,0
16907ref1,2424,9079,JUNC00000067,100,-,2424,9079,255;0;0,2,16,149,0,6506,2440,8930,6490,0
16907ref1,2353,2782,JUNC00000068,129,+,2353,2782,255;0;0,2,148,146,0,283,2501,2636,135,0
16907ref1,2451,2800,JUNC00000069,2,-,2451,2800,255;0;0,2,85,148,0,201,2536,2652,116,0
16907ref1,2404,2727,JUNC00000070,67,+,2404,2727,255;0;0,2,143,149,0,174,2547,2578,31,0
16907ref1,2434,2776,JUNC00000071,13,+,2434,2776,255;0;0,2,146,147,0,195,2580,2629,49,0
16907ref1,2435,2749,JUNC00000072,12,+,2435,2749,255;0;0,2,149,150,0,164,2584,2599,15,0
16907ref1,2449,2763,JUNC00000073,20,+,2449,2763,255;0;0,2,149,150,0,164,2598,2613,15,0
16907ref1,2617,2893,JUNC00000074,144,+,2617,2893,255;0;0,2,53,142,0,134,2670,2751,81,0
16907ref1,2659,2958,JUNC00000075,96,+,2659,2958,255;0;0,2,147,144,0,155,2806,2814,8,0
16907ref1,2662,5003,JUNC00000076,625,+,2662,5003,255;0;0,2,144,150,0,2191,2806,4853,2047,0
16907ref1,2667,2909,JUNC00000077,40,-,2667,2909,255;0;0,2,149,77,0,165,2816,2832,16,0
16907ref1,2680,2994,JUNC00000078,25,+,2680,2994,255;0;0,2,150,149,0,165,2830,2845,15,0
16907ref1,2703,3051,JUNC00000079,59,-,2703,3051,255;0;0,2,145,102,0,246,2848,2949,101,0
16907ref1,2826,3161,JUNC00000080,50,-,2826,3161,255;0;0,2,22,147,0,188,2848,3014,166,0
16907ref1,2704,7157,JUNC00000081,51,-,2704,7157,255;0;0,2,144,146,0,4307,2848,7011,4163,0
16907ref1,2727,3196,JUNC00000082,73,-,2727,3196,255;0;0,2,150,149,0,320,2877,3047,170,0
16907ref1,2819,3075,JUNC00000083,87,+,2819,3075,255;0;0,2,74,28,0,228,2893,3047,154,0
16907ref1,2960,3129,JUNC00000084,124,-,2960,3129,255;0;0,2,12,145,0,24,2972,2984,12,0
16907ref1,2929,3189,JUNC00000085,7,+,2929,3189,255;0;0,2,149,62,0,198,3078,3127,49,0
16907ref1,3207,3434,JUNC00000086,70,-,3207,3434,255;0;0,2,50,150,0,77,3257,3284,27,0
16907ref1,3532,3939,JUNC00000087,2757,+,3532,3939,255;0;0,2,150,143,0,264,3682,3796,114,0
16907ref1,3649,3965,JUNC00000088,30,-,3649,3965,255;0;0,2,93,144,0,172,3742,3821,79,0
16907ref1,3767,3964,JUNC00000089,136,+,3767,3964,255;0;0,2,19,148,0,49,3786,3816,30,0
16907ref1,3717,4165,JUNC00000090,2,+,3717,4165,255;0;0,2,150,150,0,298,3867,4015,148,0
16907ref1,3724,4043,JUNC00000091,27,+,3724,4043,255;0;0,2,146,149,0,170,3870,3894,24,0
16907ref1,3736,4040,JUNC00000092,12,+,3736,4040,255;0;0,2,149,150,0,154,3885,3890,5,0
16907ref1,3826,4170,JUNC00000093,22,+,3826,4170,255;0;0,2,68,145,0,199,3894,4025,131,0
16907ref1,3822,7683,JUNC00000094,1,+,3822,7683,255;0;0,2,82,69,0,3792,3904,7614,3710,0
16907ref1,3889,4296,JUNC00000095,11,-,3889,4296,255;0;0,2,26,150,0,257,3915,4146,231,0
16907ref1,3984,4183,JUNC00000096,3,+,3984,4183,255;0;0,2,9,148,0,51,3993,4035,42,0
16907ref1,3853,4184,JUNC00000097,52,+,3853,4184,255;0;0,2,146,149,0,182,3999,4035,36,0
16907ref1,3852,6315,JUNC00000098,6,+,3852,6315,255;0;0,2,147,148,0,2315,3999,6167,2168,0
16907ref1,3852,4191,JUNC00000099,24,+,3852,4191,255;0;0,2,149,149,0,190,4001,4042,41,0
16907ref1,3879,4182,JUNC00000100,22,-,3879,4182,255;0;0,2,149,149,0,154,4028,4033,5,0
16907ref1,4015,4221,JUNC00000101,7,+,4015,4221,255;0;0,2,26,146,0,60,4041,4075,34,0
16907ref1,4047,4237,JUNC00000102,155,+,4047,4237,255;0;0,2,21,149,0,41,4068,4088,20,0
16907ref1,3925,4262,JUNC00000103,155,+,3925,4262,255;0;0,2,150,147,0,190,4075,4115,40,0
16907ref1,4056,4238,JUNC00000104,90,+,4056,4238,255;0;0,2,25,150,0,32,4081,4088,7,0
16907ref1,3947,4267,JUNC00000105,387,+,3947,4267,255;0;0,2,145,149,0,171,4092,4118,26,0
16907ref1,4088,5924,JUNC00000106,59,+,4088,5924,255;0;0,2,142,149,0,1687,4230,5775,1545,0
16907ref1,4218,4407,JUNC00000107,10,-,4218,4407,255;0;0,2,21,150,0,39,4239,4257,18,0
16907ref1,4089,4411,JUNC00000108,13,-,4089,4411,255;0;0,2,150,150,0,172,4239,4261,22,0
16907ref1,4186,4418,JUNC00000109,19,+,4186,4418,255;0;0,2,71,147,0,85,4257,4271,14,0
16907ref1,4296,4577,JUNC00000110,90,+,4296,4577,255;0;0,2,27,142,0,139,4323,4435,112,0
16907ref1,4182,4511,JUNC00000111,9,+,4182,4511,255;0;0,2,149,150,0,179,4331,4361,30,0
16907ref1,4217,4531,JUNC00000112,38,-,4217,4531,255;0;0,2,135,149,0,165,4352,4382,30,0
16907ref1,4223,7742,JUNC00000113,3,+,4223,7742,255;0;0,2,149,150,0,3369,4372,7592,3220,0
16907ref1,4226,4569,JUNC00000114,10,-,4226,4569,255;0;0,2,149,148,0,195,4375,4421,46,0
16907ref1,4264,4568,JUNC00000115,179,-,4264,4568,255;0;0,2,149,150,0,154,4413,4418,5,0
16907ref1,4455,4643,JUNC00000116,16,+,4455,4643,255;0;0,2,30,37,0,151,4485,4606,121,0
16907ref1,4381,4694,JUNC00000117,139,-,4381,4694,255;0;0,2,116,139,0,174,4497,4555,58,0
16907ref1,4380,4686,JUNC00000118,8,+,4380,4686,255;0;0,2,149,22,0,284,4529,4664,135,0
16907ref1,4400,4732,JUNC00000119,30,-,4400,4732,255;0;0,2,139,58,0,274,4539,4674,135,0
16907ref1,4526,7846,JUNC00000120,43,+,4526,7846,255;0;0,2,144,147,0,3173,4670,7699,3029,0
16907ref1,4543,5162,JUNC00000121,12,-,4543,5162,255;0;0,2,148,150,0,469,4691,5012,321,0
16907ref1,4737,4990,JUNC00000122,1,+,4737,4990,255;0;0,2,78,63,0,190,4815,4927,112,0
16907ref1,4785,5094,JUNC00000123,468,+,4785,5094,255;0;0,2,150,150,0,159,4935,4944,9,0
16907ref1,4844,5127,JUNC00000124,43,+,4844,5127,255;0;0,2,149,105,0,178,4993,5022,29,0
16907ref1,4948,5247,JUNC00000125,3,-,4948,5247,255;0;0,2,149,144,0,155,5097,5103,6,0
16907ref1,5076,7873,JUNC00000126,2,-,5076,7873,255;0;0,2,54,97,0,2700,5130,7776,2646,0
16907ref1,5006,10251,JUNC00000127,199,+,5006,10251,255;0;0,2,148,150,0,5095,5154,10101,4947,0
16907ref1,5017,8638,JUNC00000128,89,-,5017,8638,255;0;0,2,149,145,0,3476,5166,8493,3327,0
16907ref1,5154,7764,JUNC00000129,30,-,5154,7764,255;0;0,2,67,150,0,2460,5221,7614,2393,0
16907ref1,5214,5662,JUNC00000130,680,-,5214,5662,255;0;0,2,144,150,0,298,5358,5512,154,0
16907ref1,5347,5941,JUNC00000131,176,-,5347,5941,255;0;0,2,150,148,0,446,5497,5793,296,0
16907ref1,5571,5775,JUNC00000132,31,-,5571,5775,255;0;0,2,33,147,0,57,5604,5628,24,0
16907ref1,5590,5924,JUNC00000133,34,+,5590,5924,255;0;0,2,146,149,0,185,5736,5775,39,0
16907ref1,5673,6018,JUNC00000134,3,-,5673,6018,255;0;0,2,147,148,0,197,5820,5870,50,0
16907ref1,5764,6103,JUNC00000135,69,-,5764,6103,255;0;0,2,109,150,0,189,5873,5953,80,0
16907ref1,5727,6121,JUNC00000136,7,-,5727,6121,255;0;0,2,148,148,0,246,5875,5973,98,0
16907ref1,5729,6029,JUNC00000137,26,+,5729,6029,255;0;0,2,149,145,0,155,5878,5884,6,0
16907ref1,5751,6080,JUNC00000138,34,-,5751,6080,255;0;0,2,150,149,0,180,5901,5931,30,0
16907ref1,5805,6141,JUNC00000139,2,-,5805,6141,255;0;0,2,148,148,0,188,5953,5993,40,0
16907ref1,5825,6236,JUNC00000140,6,-,5825,6236,255;0;0,2,149,148,0,263,5974,6088,114,0
16907ref1,5972,6278,JUNC00000141,3,+,5972,6278,255;0;0,2,110,144,0,162,6082,6134,52,0
16907ref1,6008,6177,JUNC00000142,24,-,6008,6177,255;0;0,2,118,33,0,136,6126,6144,18,0
16907ref1,6099,7951,JUNC00000143,106,-,6099,7951,255;0;0,2,27,145,0,1707,6126,7806,1680,0
16907ref1,6079,6249,JUNC00000144,9,+,6079,6249,255;0;0,2,102,46,0,124,6181,6203,22,0
16907ref1,6061,6404,JUNC00000145,27,+,6061,6404,255;0;0,2,145,127,0,216,6206,6277,71,0
16907ref1,6069,6375,JUNC00000146,9,+,6069,6375,255;0;0,2,150,150,0,156,6219,6225,6,0
16907ref1,6108,9765,JUNC00000147,31,-,6108,9765,255;0;0,2,147,150,0,3507,6255,9615,3360,0
16907ref1,6576,6892,JUNC00000148,6,+,6576,6892,255;0;0,2,101,147,0,169,6677,6745,68,0
16907ref1,6616,6916,JUNC00000149,139,+,6616,6916,255;0;0,2,150,145,0,155,6766,6771,5,0
16907ref1,6737,6996,JUNC00000150,1,+,6737,6996,255;0;0,2,58,93,0,166,6795,6903,108,0
16907ref1,6726,7347,JUNC00000151,64,+,6726,7347,255;0;0,2,150,149,0,472,6876,7198,322,0
16907ref1,6743,7322,JUNC00000152,125,-,6743,7322,255;0;0,2,149,108,0,471,6892,7214,322,0
16907ref1,6825,7034,JUNC00000153,94,+,6825,7034,255;0;0,2,78,75,0,134,6903,6959,56,0
16907ref1,6785,7739,JUNC00000154,5,+,6785,7739,255;0;0,2,148,149,0,805,6933,7590,657,0
16907ref1,6963,7126,JUNC00000155,251,-,6963,7126,255;0;0,2,48,74,0,89,7011,7052,41,0
16907ref1,7049,7238,JUNC00000156,3,+,7049,7238,255;0;0,2,24,149,0,40,7073,7089,16,0
16907ref1,6936,7281,JUNC00000157,9,+,6936,7281,255;0;0,2,147,147,0,198,7083,7134,51,0
16907ref1,6968,7363,JUNC00000158,38,-,6968,7363,255;0;0,2,150,149,0,246,7118,7214,96,0
16907ref1,6988,7297,JUNC00000159,48,+,6988,7297,255;0;0,2,149,149,0,160,7137,7148,11,0
16907ref1,7164,7473,JUNC00000160,37,+,7164,7473,255;0;0,2,149,150,0,159,7313,7323,10,0
16907ref1,7436,7626,JUNC00000161,2,-,7436,7626,255;0;0,2,24,148,0,42,7460,7478,18,0
16907ref1,7435,9222,JUNC00000162,3,+,7435,9222,255;0;0,2,59,102,0,1685,7494,9120,1626,0
16907ref1,7361,7701,JUNC00000163,122,-,7361,7701,255;0;0,2,150,123,0,217,7511,7578,67,0
16907ref1,7394,7712,JUNC00000164,28,+,7394,7712,255;0;0,2,145,150,0,168,7539,7562,23,0
16907ref1,7405,7868,JUNC00000165,63,+,7405,7868,255;0;0,2,149,148,0,315,7554,7720,166,0
16907ref1,7423,7596,JUNC00000166,18,-,7423,7596,255;0;0,2,150,18,0,155,7573,7578,5,0
16907ref1,7511,7771,JUNC00000167,33,+,7511,7771,255;0;0,2,149,75,0,185,7660,7696,36,0
16907ref1,7651,7832,JUNC00000168,2,+,7651,7832,255;0;0,2,23,150,0,31,7674,7682,8,0
16907ref1,7535,7839,JUNC00000169,4,-,7535,7839,255;0;0,2,150,148,0,156,7685,7691,6,0
16907ref1,7550,7789,JUNC00000170,23,+,7550,7789,255;0;0,2,149,78,0,161,7699,7711,12,0
16907ref1,7696,8143,JUNC00000171,19,+,7696,8143,255;0;0,2,141,149,0,298,7837,7994,157,0
16907ref1,7723,8040,JUNC00000172,69,-,7723,8040,255;0;0,2,143,124,0,193,7866,7916,50,0
16907ref1,7725,7954,JUNC00000173,32,-,7725,7954,255;0;0,2,150,74,0,155,7875,7880,5,0
16907ref1,7800,8151,JUNC00000174,42,+,7800,8151,255;0;0,2,122,144,0,207,7922,8007,85,0
16907ref1,7835,8139,JUNC00000175,2,-,7835,8139,255;0;0,2,150,147,0,157,7985,7992,7,0
16907ref1,7909,8257,JUNC00000176,6,-,7909,8257,255;0;0,2,149,149,0,199,8058,8108,50,0
16907ref1,7963,8225,JUNC00000177,54,-,7963,8225,255;0;0,2,149,96,0,166,8112,8129,17,0
16907ref1,7966,8270,JUNC00000178,36,-,7966,8270,255;0;0,2,149,149,0,155,8115,8121,6,0
16907ref1,7966,8280,JUNC00000179,49,-,7966,8280,255;0;0,2,149,149,0,165,8115,8131,16,0
16907ref1,8202,8422,JUNC00000180,3,-,8202,8422,255;0;0,2,80,119,0,101,8282,8303,21,0
16907ref1,8290,8737,JUNC00000181,263,+,8290,8737,255;0;0,2,148,150,0,297,8438,8587,149,0
16907ref1,8344,9035,JUNC00000182,3,+,8344,9035,255;0;0,2,144,58,0,633,8488,8977,489,0
16907ref1,8597,8925,JUNC00000183,243,+,8597,8925,255;0;0,2,150,150,0,178,8747,8775,28,0
16907ref1,8878,9233,JUNC00000184,244,+,8878,9233,255;0;0,2,43,150,0,205,8921,9083,162,0
16907ref1,8775,9078,JUNC00000185,3433,+,8775,9078,255;0;0,2,148,150,0,153,8923,8928,5,0
16907ref1,8980,9276,JUNC00000186,21,+,8980,9276,255;0;0,2,50,146,0,150,9030,9130,100,0
16907ref1,8944,9152,JUNC00000187,1,-,8944,9152,255;0;0,2,130,20,0,188,9074,9132,58,0
16907ref1,9479,9779,JUNC00000188,3,+,9479,9779,255;0;0,2,148,147,0,153,9627,9632,5,0
16907ref1,9665,9974,JUNC00000189,890,-,9665,9974,255;0;0,2,144,150,0,159,9809,9824,15,0
16907ref1,9790,10133,JUNC00000190,158,+,9790,10133,255;0;0,2,130,147,0,196,9920,9986,66,0
16907ref1,9864,10110,JUNC00000191,972,-,9864,10110,255;0;0,2,150,74,0,172,10014,10036,22,0
16907ref1,10118,10426,JUNC00000192,286,+,10118,10426,255;0;0,2,150,150,0,158,10268,10276,8,0
18308ref1,442,804,JUNC00000001,131,+,442,804,255;0;0,2,92,148,0,214,534,656,122,0
18308ref1,526,814,JUNC00000002,6,-,526,814,255;0;0,2,17,149,0,139,543,665,122,0
18308ref1,480,827,JUNC00000003,22,-,480,827,255;0;0,2,63,147,0,200,543,680,137,0
18308ref1,535,823,JUNC00000004,44,+,535,823,255;0;0,2,54,149,0,139,589,674,85,0
18308ref1,451,831,JUNC00000005,92,-,451,831,255;0;0,2,147,148,0,232,598,683,85,0
18308ref1,588,829,JUNC00000006,38,-,588,829,255;0;0,2,56,149,0,92,644,680,36,0
18308ref1,615,825,JUNC00000007,5,-,615,825,255;0;0,2,45,149,0,61,660,676,16,0
18308ref1,666,842,JUNC00000008,11,+,666,842,255;0;0,2,8,148,0,28,674,694,20,0
18308ref1,573,1019,JUNC00000009,61,+,573,1019,255;0;0,2,144,148,0,298,717,871,154,0
18308ref1,702,909,JUNC00000010,176,+,702,909,255;0;0,2,28,145,0,62,730,764,34,0
18308ref1,602,1040,JUNC00000011,33,+,602,1040,255;0;0,2,130,150,0,288,732,890,158,0
18308ref1,756,955,JUNC00000012,80,+,756,955,255;0;0,2,8,143,0,56,764,812,48,0
18308ref1,737,1098,JUNC00000013,147,+,737,1098,255;0;0,2,58,149,0,212,795,949,154,0
18308ref1,813,1019,JUNC00000014,12,+,813,1019,255;0;0,2,33,148,0,58,846,871,25,0
18308ref1,732,958,JUNC00000015,3,+,732,958,255;0;0,2,146,48,0,178,878,910,32,0
18308ref1,824,1125,JUNC00000016,33,+,824,1125,255;0;0,2,145,149,0,152,969,976,7,0
18308ref1,825,1171,JUNC00000017,8,+,825,1171,255;0;0,2,144,149,0,197,969,1022,53,0
18308ref1,946,1276,JUNC00000018,37,+,946,1276,255;0;0,2,149,148,0,182,1095,1128,33,0
18308ref1,955,1308,JUNC00000019,558,-,955,1308,255;0;0,2,146,150,0,203,1101,1158,57,0
18308ref1,965,1295,JUNC00000020,6,+,965,1295,255;0;0,2,146,150,0,180,1111,1145,34,0
18308ref1,978,1293,JUNC00000021,37,+,978,1293,255;0;0,2,149,146,0,169,1127,1147,20,0
18308ref1,1005,1308,JUNC00000022,98,-,1005,1308,255;0;0,2,145,150,0,153,1150,1158,8,0
18308ref1,1157,7708,JUNC00000023,58,+,1157,7708,255;0;0,2,45,146,0,6405,1202,7562,6360,0
18308ref1,1670,1931,JUNC00000024,2,-,1670,1931,255;0;0,2,19,149,0,112,1689,1782,93,0
18308ref1,1804,2062,JUNC00000025,351,-,1804,2062,255;0;0,2,22,150,0,108,1826,1912,86,0
18308ref1,1822,8877,JUNC00000026,647,+,1822,8877,255;0;0,2,150,139,0,6916,1972,8738,6766,0
18308ref1,2346,2504,JUNC00000027,21,-,2346,2504,255;0;0,2,8,145,0,13,2354,2359,5,0
18308ref1,2240,2556,JUNC00000028,11,+,2240,2556,255;0;0,2,148,149,0,167,2388,2407,19,0
18308ref1,2427,2640,JUNC00000029,15,+,2427,2640,255;0;0,2,35,150,0,63,2462,2490,28,0
18308ref1,2411,2779,JUNC00000030,18,+,2411,2779,255;0;0,2,51,150,0,218,2462,2629,167,0
18308ref1,2344,2763,JUNC00000031,23,+,2344,2763,255;0;0,2,149,150,0,269,2493,2613,120,0
18308ref1,2490,2779,JUNC00000032,7,+,2490,2779,255;0;0,2,23,150,0,139,2513,2629,116,0
18308ref1,2392,3259,JUNC00000033,6,-,2392,3259,255;0;0,2,144,149,0,718,2536,3110,574,0
18308ref1,2396,3005,JUNC00000034,9,-,2396,3005,255;0;0,2,148,149,0,460,2544,2856,312,0
18308ref1,2511,2994,JUNC00000035,35,+,2511,2994,255;0;0,2,36,149,0,334,2547,2845,298,0
18308ref1,2513,2753,JUNC00000036,24,+,2513,2753,255;0;0,2,43,150,0,90,2556,2603,47,0
18308ref1,2520,2816,JUNC00000037,13,+,2520,2816,255;0;0,2,58,121,0,175,2578,2695,117,0
18308ref1,2433,2713,JUNC00000038,2,+,2433,2713,255;0;0,2,147,16,0,264,2580,2697,117,0
18308ref1,2449,2783,JUNC00000039,156,-,2449,2783,255;0;0,2,149,150,0,184,2598,2633,35,0
18308ref1,2470,2785,JUNC00000040,13,+,2470,2785,255;0;0,2,149,149,0,166,2619,2636,17,0
18308ref1,2482,2830,JUNC00000041,5,+,2482,2830,255;0;0,2,149,149,0,199,2631,2681,50,0
18308ref1,2563,2876,JUNC00000042,1,+,2563,2876,255;0;0,2,89,62,0,251,2652,2814,162,0
18308ref1,2630,2726,JUNC00000043,35,+,2630,2726,255;0;0,2,45,22,0,74,2675,2704,29,0
18308ref1,2639,2839,JUNC00000044,47,+,2639,2839,255;0;0,2,46,149,0,51,2685,2690,5,0
18308ref1,2722,2958,JUNC00000045,2,-,2722,2958,255;0;0,2,37,147,0,89,2759,2811,52,0
18308ref1,2671,3006,JUNC00000046,4,-,2671,3006,255;0;0,2,149,148,0,187,2820,2858,38,0
18308ref1,2772,2989,JUNC00000047,33,+,2772,2989,255;0;0,2,51,149,0,68,2823,2840,17,0
18308ref1,2697,3005,JUNC00000048,54,+,2697,3005,255;0;0,2,149,149,0,159,2846,2856,10,0
18308ref1,2697,3009,JUNC00000049,20,+,2697,3009,255;0;0,2,149,147,0,165,2846,2862,16,0
18308ref1,2716,3031,JUNC00000050,30,+,2716,3031,255;0;0,2,149,150,0,165,2865,2881,16,0
18308ref1,2818,8016,JUNC00000051,764,+,2818,8016,255;0;0,2,101,94,0,5104,2919,7922,5003,0
18308ref1,2855,3066,JUNC00000052,3,+,2855,3066,255;0;0,2,87,34,0,177,2942,3032,90,0
18308ref1,3023,3351,JUNC00000053,476,-,3023,3351,255;0;0,2,150,150,0,178,3173,3201,28,0
18308ref1,3206,3433,JUNC00000054,6,-,3206,3433,255;0;0,2,51,149,0,78,3257,3284,27,0
18308ref1,3602,3916,JUNC00000055,1224,-,3602,3916,255;0;0,2,150,149,0,165,3752,3767,15,0
18308ref1,3711,3980,JUNC00000056,95,+,3711,3980,255;0;0,2,75,149,0,120,3786,3831,45,0
18308ref1,3802,4057,JUNC00000057,2,-,3802,4057,255;0;0,2,52,99,0,156,3854,3958,104,0
18308ref1,3854,4094,JUNC00000058,107,-,3854,4094,255;0;0,2,48,146,0,94,3902,3948,46,0
18308ref1,3932,4111,JUNC00000059,23,+,3932,4111,255;0;0,2,24,150,0,29,3956,3961,5,0
18308ref1,3910,4173,JUNC00000060,9,+,3910,4173,255;0;0,2,46,148,0,115,3956,4025,69,0
18308ref1,3958,4225,JUNC00000061,18,+,3958,4225,255;0;0,2,103,150,0,117,4061,4075,14,0
18308ref1,3927,4238,JUNC00000062,306,+,3927,4238,255;0;0,2,148,148,0,163,4075,4090,15,0
18308ref1,4055,4238,JUNC00000063,116,+,4055,4238,255;0;0,2,26,150,0,33,4081,4088,7,0
18308ref1,4062,4253,JUNC00000064,508,+,4062,4253,255;0;0,2,30,147,0,44,4092,4106,14,0
18308ref1,3960,4285,JUNC00000065,93,-,3960,4285,255;0;0,2,147,147,0,178,4107,4138,31,0
18308ref1,4109,4333,JUNC00000066,13,+,4109,4333,255;0;0,2,23,150,0,74,4132,4183,51,0
18308ref1,4127,4335,JUNC00000067,51,+,4127,4335,255;0;0,2,9,148,0,60,4136,4187,51,0
18308ref1,4110,4418,JUNC00000068,15,+,4110,4418,255;0;0,2,147,147,0,161,4257,4271,14,0
18308ref1,4286,4523,JUNC00000069,49,-,4286,4523,255;0;0,2,66,149,0,88,4352,4374,22,0
18308ref1,4235,4469,JUNC00000070,563,-,4235,4469,255;0;0,2,147,81,0,153,4382,4388,6,0
18308ref1,4378,4645,JUNC00000071,248,-,4378,4645,255;0;0,2,108,148,0,119,4486,4497,11,0
18308ref1,4421,4815,JUNC00000072,3,-,4421,4815,255;0;0,2,118,141,0,253,4539,4674,135,0
18308ref1,4564,4870,JUNC00000073,3,+,4564,4870,255;0;0,2,149,150,0,156,4713,4720,7,0
18308ref1,4615,4933,JUNC00000074,2175,+,4615,4933,255;0;0,2,150,150,0,168,4765,4783,18,0
18308ref1,4787,4991,JUNC00000075,2,-,4787,4991,255;0;0,2,58,61,0,143,4845,4930,85,0
18308ref1,4785,5020,JUNC00000076,502,+,4785,5020,255;0;0,2,150,76,0,159,4935,4944,9,0
18308ref1,4928,5172,JUNC00000077,48,+,4928,5172,255;0;0,2,10,150,0,94,4938,5022,84,0
18308ref1,5031,5237,JUNC00000078,42,-,5031,5237,255;0;0,2,35,150,0,56,5066,5087,21,0
18308ref1,5133,5791,JUNC00000079,3,-,5133,5791,255;0;0,2,33,148,0,510,5166,5643,477,0
18308ref1,5225,6058,JUNC00000080,2,+,5225,6058,255;0;0,2,105,46,0,787,5330,6012,682,0
18308ref1,5681,5891,JUNC00000081,9,+,5681,5891,255;0;0,2,149,25,0,185,5830,5866,36,0
18308ref1,5681,5923,JUNC00000082,12,+,5681,5923,255;0;0,2,149,44,0,198,5830,5879,49,0
18308ref1,5729,6031,JUNC00000083,10,+,5729,6031,255;0;0,2,149,147,0,155,5878,5884,6,0
18308ref1,6467,10024,JUNC00000084,3,+,6467,10024,255;0;0,2,148,147,0,3410,6615,9877,3262,0
18308ref1,6470,10027,JUNC00000085,2784,-,6470,10027,255;0;0,2,150,145,0,3412,6620,9882,3262,0
18308ref1,6507,6889,JUNC00000086,639,-,6507,6889,255;0;0,2,150,147,0,235,6657,6742,85,0
18308ref1,6645,6877,JUNC00000087,2,+,6645,6877,255;0;0,2,104,18,0,214,6749,6859,110,0
18308ref1,6917,7187,JUNC00000088,4,-,6917,7187,255;0;0,2,94,135,0,135,7011,7052,41,0
18308ref1,7189,7450,JUNC00000089,2653,-,7189,7450,255;0;0,2,98,150,0,111,7287,7300,13,0
18308ref1,7323,8143,JUNC00000090,6952,+,7323,8143,255;0;0,2,150,149,0,671,7473,7994,521,0
18308ref1,7423,7633,JUNC00000091,11,-,7423,7633,255;0;0,2,150,55,0,155,7573,7578,5,0
18308ref1,7744,8048,JUNC00000092,2,-,7744,8048,255;0;0,2,32,142,0,162,7776,7906,130,0
18308ref1,7797,7973,JUNC00000093,84,-,7797,7973,255;0;0,2,9,146,0,30,7806,7827,21,0
18308ref1,7725,7923,JUNC00000094,23,-,7725,7923,255;0;0,2,150,43,0,155,7875,7880,5,0
18308ref1,7870,8194,JUNC00000095,73,+,7870,8194,255;0;0,2,145,150,0,174,8015,8044,29,0
18308ref1,7962,8305,JUNC00000096,2135,+,7962,8305,255;0;0,2,150,150,0,193,8112,8155,43,0
18308ref1,8303,8617,JUNC00000097,3,+,8303,8617,255;0;0,2,146,148,0,166,8449,8469,20,0
18308ref1,8374,8583,JUNC00000098,1,+,8374,8583,255;0;0,2,114,37,0,172,8488,8546,58,0
18308ref1,8751,9079,JUNC00000099,1,-,8751,9079,255;0;0,2,71,80,0,248,8822,8999,177,0
18308ref1,8772,9233,JUNC00000100,63,+,8772,9233,255;0;0,2,149,150,0,311,8921,9083,162,0
18308ref1,8773,9078,JUNC00000101,2017,+,8773,9078,255;0;0,2,150,150,0,155,8923,8928,5,0
18308ref1,9078,9287,JUNC00000102,1,+,9078,9287,255;0;0,2,75,40,0,169,9153,9247,94,0
18308ref1,9094,9561,JUNC00000103,277,+,9094,9561,255;0;0,2,143,150,0,317,9237,9411,174,0
18308ref1,9119,9766,JUNC00000104,137,+,9119,9766,255;0;0,2,118,148,0,499,9237,9618,381,0
18308ref1,9724,9972,JUNC00000105,21,+,9724,9972,255;0;0,2,51,149,0,99,9775,9823,48,0
17299ref2,4446,7817,JUNC00000081,3,-,4446,7817,255;0;0,2,109,89,0,3282,4555,7728,3173,0
17299ref2,1670,4465,JUNC00000032,95,+,1670,4465,255;0;0,2,123,142,0,2653,1793,4323,2530,0
17299ref2,1356,2881,JUNC00000029,1949,-,1356,2881,255;0;0,2,150,144,0,1381,1506,2737,1231,0
17299ref2,6947,7640,JUNC00000092,3,+,6947,7640,255;0;0,2,126,146,0,547,7073,7494,421,0
17299ref2,614,1055,JUNC00000006,21,+,614,1055,255;0;0,2,42,40,0,401,656,1015,359,0
17299ref2,9727,10220,JUNC00000116,1,-,9727,10220,255;0;0,2,97,54,0,439,9824,10166,342,0
17299ref2,2216,2819,JUNC00000039,1241,+,2216,2819,255;0;0,2,150,149,0,454,2366,2670,304,0
17299ref2,2239,2841,JUNC00000042,76,+,2239,2841,255;0;0,2,149,149,0,453,2388,2692,304,0
17299ref2,9790,10109,JUNC00000117,1,-,9790,10109,255;0;0,2,36,28,0,291,9826,10081,255,0
17299ref2,571,1012,JUNC00000004,7,+,571,1012,255;0;0,2,42,148,0,293,613,864,251,0
17299ref2,568,1022,JUNC00000005,79,+,568,1022,255;0;0,2,59,144,0,310,627,878,251,0
17299ref2,9606,9899,JUNC00000114,1,+,9606,9899,255;0;0,2,33,22,0,271,9639,9877,238,0
17299ref2,8905,9282,JUNC00000112,525,+,8905,9282,255;0;0,2,10,150,0,227,8915,9132,217,0
17299ref2,2436,2949,JUNC00000049,38,+,2436,2949,255;0;0,2,148,149,0,364,2584,2800,216,0
17299ref2,3696,4139,JUNC00000066,151,+,3696,4139,255;0;0,2,80,150,0,293,3776,3989,213,0
17299ref2,9869,10207,JUNC00000118,3,+,9869,10207,255;0;0,2,101,44,0,294,9970,10163,193,0
17299ref2,7609,7934,JUNC00000103,2,+,7609,7934,255;0;0,2,90,61,0,264,7699,7873,174,0
17299ref2,158,468,JUNC00000001,1,+,158,468,255;0;0,2,48,103,0,207,206,365,159,0
17299ref2,686,1012,JUNC00000009,6,+,686,1012,255;0;0,2,24,148,0,178,710,864,154,0
17299ref2,672,1019,JUNC00000010,69,+,672,1019,255;0;0,2,45,148,0,199,717,871,154,0
17299ref2,7702,8056,JUNC00000104,43,-,7702,8056,255;0;0,2,50,150,0,204,7752,7906,154,0
17299ref2,195,528,JUNC00000002,2,-,195,528,255;0;0,2,36,144,0,189,231,384,153,0
17299ref2,2418,2832,JUNC00000045,27,+,2418,2832,255;0;0,2,147,117,0,297,2565,2715,150,0
17299ref2,6744,7187,JUNC00000091,2,-,6744,7187,255;0;0,2,148,147,0,296,6892,7040,148,0
17299ref2,2621,2988,JUNC00000052,18,+,2621,2988,255;0;0,2,76,148,0,219,2697,2840,143,0
17299ref2,2549,2837,JUNC00000046,1,+,2549,2837,255;0;0,2,29,122,0,166,2578,2715,137,0
17299ref2,4408,4762,JUNC00000080,3,-,4408,4762,255;0;0,2,131,88,0,266,4539,4674,135,0
17299ref2,2608,2991,JUNC00000053,23,+,2608,2991,255;0;0,2,107,146,0,237,2715,2845,130,0
17299ref2,4832,5161,JUNC00000085,3,+,4832,5161,255;0;0,2,59,144,0,185,4891,5017,126,0
17299ref2,1889,2239,JUNC00000036,190,+,1889,2239,255;0;0,2,145,89,0,261,2034,2150,116,0
17299ref2,2365,2779,JUNC00000044,5,+,2365,2779,255;0;0,2,148,150,0,264,2513,2629,116,0
17299ref2,679,1033,JUNC00000014,20,+,679,1033,255;0;0,2,104,141,0,213,783,892,109,0
17299ref2,3823,4078,JUNC00000071,1,-,3823,4078,255;0;0,2,31,120,0,135,3854,3958,104,0
17299ref2,1336,1678,JUNC00000028,2,+,1336,1678,255;0;0,2,129,113,0,229,1465,1565,100,0
17299ref2,6969,7362,JUNC00000094,10,-,6969,7362,255;0;0,2,149,148,0,245,7118,7214,96,0
17299ref2,3747,4003,JUNC00000065,79,-,3747,4003,255;0;0,2,20,149,0,107,3767,3854,87,0
17299ref2,1748,2056,JUNC00000033,25,-,1748,2056,255;0;0,2,78,144,0,164,1826,1912,86,0
17299ref2,7472,7848,JUNC00000101,69,+,7472,7848,255;0;0,2,144,149,0,227,7616,7699,83,0
17299ref2,2520,2887,JUNC00000051,150,+,2520,2887,255;0;0,2,150,136,0,231,2670,2751,81,0
17299ref2,1691,1943,JUNC00000034,2,+,1691,1943,255;0;0,2,149,25,0,227,1840,1918,78,0
17299ref2,744,991,JUNC00000013,11,-,744,991,255;0;0,2,26,146,0,101,770,845,75,0
17299ref2,1609,1973,JUNC00000031,520,-,1609,1973,255;0;0,2,142,147,0,217,1751,1826,75,0
17299ref2,7173,7507,JUNC00000098,305,-,7173,7507,255;0;0,2,114,146,0,188,7287,7361,74,0
17299ref2,7362,7616,JUNC00000100,79,-,7362,7616,255;0;0,2,149,38,0,216,7511,7578,67,0
17299ref2,763,1012,JUNC00000015,49,+,763,1012,255;0;0,2,41,148,0,101,804,864,60,0
17299ref2,4421,4692,JUNC00000079,139,-,4421,4692,255;0;0,2,76,137,0,134,4497,4555,58,0
17299ref2,955,1306,JUNC00000022,596,-,955,1306,255;0;0,2,146,148,0,203,1101,1158,57,0
17299ref2,2739,2989,JUNC00000055,51,+,2739,2989,255;0;0,2,48,149,0,101,2787,2840,53,0
17299ref2,1769,1963,JUNC00000035,2,-,1769,1963,255;0;0,2,91,51,0,143,1860,1912,52,0
17299ref2,7909,8255,JUNC00000107,3,-,7909,8255,255;0;0,2,149,147,0,199,8058,8108,50,0
17299ref2,2440,2778,JUNC00000047,3,+,2440,2778,255;0;0,2,140,149,0,189,2580,2629,49,0
17299ref2,2896,3096,JUNC00000060,1,+,2896,3096,255;0;0,2,23,128,0,72,2919,2968,49,0
17299ref2,6578,6886,JUNC00000090,27,-,6578,6886,255;0;0,2,116,144,0,164,6694,6742,48,0
17299ref2,7981,8196,JUNC00000106,57,+,7981,8196,255;0;0,2,26,143,0,72,8007,8053,46,0
17299ref2,2403,2653,JUNC00000043,26,+,2403,2653,255;0;0,2,59,146,0,104,2462,2507,45,0
17299ref2,3704,3980,JUNC00000067,103,+,3704,3980,255;0;0,2,82,149,0,127,3786,3831,45,0
17299ref2,5791,6127,JUNC00000088,2,+,5791,6127,255;0;0,2,146,145,0,191,5937,5982,45,0
17299ref2,423,665,JUNC00000003,54,-,423,665,255;0;0,2,148,50,0,192,571,615,44,0
17299ref2,7152,7491,JUNC00000099,74,-,7152,7491,255;0;0,2,149,149,0,190,7301,7342,41,0
17299ref2,871,1200,JUNC00000020,30,+,871,1200,255;0;0,2,144,145,0,184,1015,1055,40,0
17299ref2,3049,3386,JUNC00000062,605,+,3049,3386,255;0;0,2,147,150,0,187,3196,3236,40,0
17299ref2,3659,3993,JUNC00000069,112,-,3659,3993,255;0;0,2,148,149,0,185,3807,3844,37,0
17299ref2,2239,2574,JUNC00000041,27,-,2239,2574,255;0;0,2,149,150,0,185,2388,2424,36,0
17299ref2,3881,4115,JUNC00000072,12,+,3881,4115,255;0;0,2,49,149,0,85,3930,3966,36,0
17299ref2,1635,1734,JUNC00000030,2,+,1635,1734,255;0;0,2,8,56,0,43,1643,1678,35,0
17299ref2,3789,4124,JUNC00000073,88,+,3789,4124,255;0;0,2,150,150,0,185,3939,3974,35,0
17299ref2,9518,9848,JUNC00000115,10,+,9518,9848,255;0;0,2,147,148,0,182,9665,9700,35,0
17299ref2,946,1278,JUNC00000021,20,+,946,1278,255;0;0,2,149,150,0,182,1095,1128,33,0
17299ref2,5451,5778,JUNC00000087,24,-,5451,5778,255;0;0,2,149,145,0,182,5600,5633,33,0
17299ref2,729,1058,JUNC00000019,165,+,729,1058,255;0;0,2,149,148,0,181,878,910,32,0
17299ref2,8281,8613,JUNC00000110,267,+,8281,8613,255;0;0,2,150,150,0,182,8431,8463,32,0
17299ref2,5831,6157,JUNC00000089,5,+,5831,6157,255;0;0,2,145,150,0,176,5976,6007,31,0
17299ref2,981,1308,JUNC00000024,22,-,981,1308,255;0;0,2,147,150,0,177,1128,1158,30,0
17299ref2,4845,5094,JUNC00000086,15,+,4845,5094,255;0;0,2,148,72,0,177,4993,5022,29,0
17299ref2,3840,4168,JUNC00000075,16,-,3840,4168,255;0;0,2,150,150,0,178,3990,4018,28,0
17299ref2,783,1008,JUNC00000016,22,-,783,1008,255;0;0,2,50,148,0,77,833,860,27,0
17299ref2,2728,2946,JUNC00000054,31,+,2728,2946,255;0;0,2,43,148,0,70,2771,2798,27,0
17299ref2,3181,3434,JUNC00000063,21,-,3181,3434,255;0;0,2,76,150,0,103,3257,3284,27,0
17299ref2,3501,3827,JUNC00000064,562,+,3501,3827,255;0;0,2,150,149,0,177,3651,3678,27,0
17299ref2,2857,3069,JUNC00000059,71,+,2857,3069,255;0;0,2,36,150,0,62,2893,2919,26,0
17299ref2,3744,3980,JUNC00000068,132,-,3744,3980,255;0;0,2,63,147,0,89,3807,3833,26,0
17299ref2,652,851,JUNC00000007,267,+,652,851,255;0;0,2,24,150,0,49,676,701,25,0
17299ref2,3022,3259,JUNC00000061,96,+,3022,3259,255;0;0,2,149,63,0,174,3171,3196,25,0
17299ref2,4542,4862,JUNC00000082,30,+,4542,4862,255;0;0,2,147,150,0,170,4689,4712,23,0
17299ref2,686,749,JUNC00000008,3,+,686,749,255;0;0,2,24,19,0,44,710,730,20,0
17299ref2,977,1292,JUNC00000023,22,+,977,1292,255;0;0,2,150,145,0,170,1127,1147,20,0
17299ref2,1978,2296,JUNC00000037,25,+,1978,2296,255;0;0,2,149,149,0,169,2127,2147,20,0
17299ref2,7244,7428,JUNC00000096,3,-,7244,7428,255;0;0,2,19,145,0,39,7263,7283,20,0
17299ref2,4747,4925,JUNC00000083,4,+,4747,4925,255;0;0,2,18,142,0,36,4765,4783,18,0
17299ref2,7964,8279,JUNC00000109,125,-,7964,8279,255;0;0,2,148,150,0,165,8112,8129,17,0
17299ref2,2699,3009,JUNC00000057,19,+,2699,3009,255;0;0,2,147,147,0,163,2846,2862,16,0
17299ref2,2716,2943,JUNC00000058,22,+,2716,2943,255;0;0,2,149,62,0,165,2865,2881,16,0
17299ref2,1049,1215,JUNC00000025,2,+,1049,1215,255;0;0,2,99,52,0,114,1148,1163,15,0
17299ref2,2436,2746,JUNC00000048,5,+,2436,2746,255;0;0,2,148,147,0,163,2584,2599,15,0
17299ref2,2450,2763,JUNC00000050,14,+,2450,2763,255;0;0,2,148,150,0,163,2598,2613,15,0
17299ref2,3805,4017,JUNC00000070,9,-,3805,4017,255;0;0,2,49,148,0,64,3854,3869,15,0
17299ref2,599,907,JUNC00000012,93,-,599,907,255;0;0,2,145,149,0,159,744,758,14,0
17299ref2,2748,2966,JUNC00000056,14,-,2748,2966,255;0;0,2,54,150,0,68,2802,2816,14,0
17299ref2,4206,4417,JUNC00000077,5,+,4206,4417,255;0;0,2,51,146,0,65,4257,4271,14,0
17299ref2,2166,2477,JUNC00000038,711,-,2166,2477,255;0;0,2,150,148,0,163,2316,2329,13,0
17299ref2,7063,7226,JUNC00000093,4,+,7063,7226,255;0;0,2,54,97,0,66,7117,7129,12,0
17299ref2,3958,4252,JUNC00000076,1367,+,3958,4252,255;0;0,2,134,149,0,145,4092,4103,11,0
17299ref2,7216,7426,JUNC00000097,12,+,7216,7426,255;0;0,2,51,149,0,61,7267,7277,10,0
17299ref2,705,1012,JUNC00000018,4,-,705,1012,255;0;0,2,150,148,0,159,855,864,9,0
17299ref2,694,845,JUNC00000011,1,-,694,845,255;0;0,2,38,105,0,46,732,740,8,0
17299ref2,1002,1304,JUNC00000027,72,-,1002,1304,255;0;0,2,148,146,0,156,1150,1158,8,0
17299ref2,8010,8261,JUNC00000108,46,+,8010,8261,255;0;0,2,94,149,0,102,8104,8112,8,0
17299ref2,2354,2530,JUNC00000040,2,+,2354,2530,255;0;0,2,19,150,0,26,2373,2380,7,0
17299ref2,3931,4110,JUNC00000074,25,+,3931,4110,255;0;0,2,23,149,0,30,3954,3961,7,0
17299ref2,7540,7842,JUNC00000102,3,+,7540,7842,255;0;0,2,149,146,0,156,7689,7696,7,0
17299ref2,8862,9062,JUNC00000111,2,+,8862,9062,255;0;0,2,44,149,0,51,8906,8913,7,0
17299ref2,758,1007,JUNC00000017,11,-,758,1007,255;0;0,2,97,147,0,102,855,860,5,0
17299ref2,1001,1303,JUNC00000026,14,-,1001,1303,255;0;0,2,149,148,0,154,1150,1155,5,0
17299ref2,4264,4568,JUNC00000078,112,-,4264,4568,255;0;0,2,149,150,0,154,4413,4418,5,0
17299ref2,4774,5025,JUNC00000084,4,-,4774,5025,255;0;0,2,99,147,0,104,4873,4878,5,0
17299ref2,6991,7289,JUNC00000095,55,+,6991,7289,255;0;0,2,146,147,0,151,7137,7142,5,0
17299ref2,7750,7981,JUNC00000105,74,-,7750,7981,255;0;0,2,125,101,0,130,7875,7880,5,0
17299ref2,8773,9078,JUNC00000113,1854,+,8773,9078,255;0;0,2,150,150,0,155,8923,8928,5,0
24774ref2,4578,9632,JUNC00000074,16,+,4578,9632,255;0;0,2,150,145,0,4909,4728,9487,4759,0
24774ref2,4556,8973,JUNC00000073,8,+,4556,8973,255;0;0,2,10,33,0,4384,4566,8940,4374,0
24774ref2,990,5239,JUNC00000016,1,-,990,5239,255;0;0,2,78,73,0,4176,1068,5166,4098,0
24774ref2,3282,6261,JUNC00000063,1,+,3282,6261,255;0;0,2,16,135,0,2844,3298,6126,2828,0
24774ref2,4183,5898,JUNC00000065,10,+,4183,5898,255;0;0,2,47,123,0,1592,4230,5775,1545,0
24774ref2,5011,6218,JUNC00000076,2,-,5011,6218,255;0;0,2,86,92,0,1115,5097,6126,1029,0
24774ref2,1216,2479,JUNC00000024,15,-,1216,2479,255;0;0,2,147,125,0,1138,1363,2354,991,0
24774ref2,1533,2330,JUNC00000030,36,+,1533,2330,255;0;0,2,24,148,0,649,1557,2182,625,0
24774ref2,9497,10184,JUNC00000120,12,+,9497,10184,255;0;0,2,142,29,0,658,9639,10155,516,0
24774ref2,1974,2591,JUNC00000039,1,+,1974,2591,255;0;0,2,125,26,0,591,2099,2565,466,0
24774ref2,473,1133,JUNC00000005,6,+,473,1133,255;0;0,2,73,131,0,529,546,1002,456,0
24774ref2,415,1109,JUNC00000006,7,+,415,1109,255;0;0,2,147,147,0,547,562,962,400,0
24774ref2,614,1133,JUNC00000007,124,+,614,1133,255;0;0,2,42,118,0,401,656,1015,359,0
24774ref2,8981,9472,JUNC00000111,1,+,8981,9472,255;0;0,2,106,37,0,454,9087,9435,348,0
24774ref2,657,1133,JUNC00000008,14,+,657,1133,255;0;0,2,17,118,0,358,674,1015,341,0
24774ref2,5357,5838,JUNC00000078,1,+,5357,5838,255;0;0,2,61,90,0,391,5418,5748,330,0
24774ref2,8789,9207,JUNC00000108,1,+,8789,9207,255;0;0,2,8,92,0,326,8797,9115,318,0
24774ref2,871,1452,JUNC00000015,19,+,871,1452,255;0;0,2,144,144,0,437,1015,1308,293,0
24774ref2,7314,7738,JUNC00000085,2,+,7314,7738,255;0;0,2,8,148,0,276,7322,7590,268,0
24774ref2,9787,10193,JUNC00000121,1,-,9787,10193,255;0;0,2,39,112,0,294,9826,10081,255,0
24774ref2,7225,7686,JUNC00000084,2,+,7225,7686,255;0;0,2,97,118,0,343,7322,7568,246,0
24774ref2,7941,8397,JUNC00000099,2,+,7941,8397,255;0;0,2,66,147,0,309,8007,8250,243,0
24774ref2,331,839,JUNC00000001,1730,+,331,839,255;0;0,2,150,148,0,360,481,691,210,0
24774ref2,500,847,JUNC00000004,1,+,500,847,255;0;0,2,34,117,0,230,534,730,196,0
24774ref2,9936,10153,JUNC00000123,1,-,9936,10153,255;0;0,2,14,11,0,206,9950,10142,192,0
24774ref2,607,1090,JUNC00000010,12,-,607,1090,255;0;0,2,150,150,0,333,757,940,183,0
24774ref2,625,1099,JUNC00000011,76,-,625,1099,255;0;0,2,145,146,0,328,770,953,183,0
24774ref2,1292,1723,JUNC00000026,22,+,1292,1723,255;0;0,2,146,105,0,326,1438,1618,180,0
24774ref2,2182,2615,JUNC00000041,3725,+,2182,2615,255;0;0,2,145,114,0,319,2327,2501,174,0
24774ref2,9094,9456,JUNC00000115,66,+,9094,9456,255;0;0,2,143,45,0,317,9237,9411,174,0
24774ref2,9251,9569,JUNC00000116,14,+,9251,9569,255;0;0,2,116,39,0,279,9367,9530,163,0
24774ref2,1662,1973,JUNC00000033,1,+,1662,1973,255;0;0,2,53,97,0,214,1715,1876,161,0
24774ref2,501,812,JUNC00000002,1,-,501,812,255;0;0,2,8,143,0,168,509,669,160,0
24774ref2,526,838,JUNC00000003,6,+,526,838,255;0;0,2,8,144,0,168,534,694,160,0
24774ref2,7596,8028,JUNC00000092,4,+,7596,8028,255;0;0,2,150,125,0,307,7746,7903,157,0
24774ref2,573,1018,JUNC00000009,5,+,573,1018,255;0;0,2,144,147,0,298,717,871,154,0
24774ref2,2320,2633,JUNC00000043,6,-,2320,2633,255;0;0,2,144,17,0,296,2464,2616,152,0
24774ref2,7259,7703,JUNC00000086,82,-,7259,7703,255;0;0,2,150,143,0,301,7409,7560,151,0
24774ref2,4407,4803,JUNC00000072,27,-,4407,4803,255;0;0,2,132,129,0,267,4539,4674,135,0
24774ref2,3849,4168,JUNC00000064,2,+,3849,4168,255;0;0,2,45,143,0,176,3894,4025,131,0
24774ref2,2882,3159,JUNC00000055,1,+,2882,3159,255;0;0,2,39,112,0,165,2921,3047,126,0
24774ref2,1915,2271,JUNC00000038,396,+,1915,2271,255;0;0,2,119,121,0,235,2034,2150,116,0
24774ref2,2468,2751,JUNC00000046,3,-,2468,2751,255;0;0,2,68,99,0,184,2536,2652,116,0
24774ref2,8356,8631,JUNC00000107,2,+,8356,8631,255;0;0,2,132,29,0,246,8488,8602,114,0
24774ref2,4180,4568,JUNC00000067,48,+,4180,4568,255;0;0,2,143,133,0,255,4323,4435,112,0
24774ref2,9571,9833,JUNC00000118,2,+,9571,9833,255;0;0,2,47,104,0,158,9618,9729,111,0
24774ref2,1655,1891,JUNC00000032,8,+,1655,1891,255;0;0,2,31,98,0,138,1686,1793,107,0
24774ref2,2855,3110,JUNC00000057,1,+,2855,3110,255;0;0,2,142,8,0,247,2997,3102,105,0
24774ref2,2079,2473,JUNC00000040,18,+,2079,2473,255;0;0,2,146,146,0,248,2225,2327,102,0
24774ref2,1374,1627,JUNC00000027,21,+,1374,1627,255;0;0,2,91,62,0,191,1465,1565,100,0
24774ref2,1361,1619,JUNC00000028,1491,-,1361,1619,255;0;0,2,150,8,0,250,1511,1611,100,0
24774ref2,8928,9247,JUNC00000110,8,+,8928,9247,255;0;0,2,74,147,0,172,9002,9100,98,0
24774ref2,9004,9269,JUNC00000113,34,+,9004,9269,255;0;0,2,149,22,0,243,9153,9247,94,0
24774ref2,732,1025,JUNC00000012,2,-,732,1025,255;0;0,2,53,147,0,146,785,878,93,0
24774ref2,1680,2052,JUNC00000035,9,-,1680,2052,255;0;0,2,146,140,0,232,1826,1912,86,0
24774ref2,2579,2895,JUNC00000052,2,+,2579,2895,255;0;0,2,91,144,0,172,2670,2751,81,0
24774ref2,8974,9247,JUNC00000112,7,+,8974,9247,255;0;0,2,146,50,0,223,9120,9197,77,0
24774ref2,1392,1619,JUNC00000029,7,+,1392,1619,255;0;0,2,144,8,0,219,1536,1611,75,0
24774ref2,1606,1973,JUNC00000034,33,-,1606,1973,255;0;0,2,145,147,0,220,1751,1826,75,0
24774ref2,9781,10004,JUNC00000122,1,+,9781,10004,255;0;0,2,117,34,0,189,9898,9970,72,0
24774ref2,7362,7700,JUNC00000089,139,-,7362,7700,255;0;0,2,149,122,0,216,7511,7578,67,0
24774ref2,7460,7677,JUNC00000087,1,+,7460,7677,255;0;0,2,25,126,0,91,7485,7551,66,0
24774ref2,7347,7712,JUNC00000088,7,-,7347,7712,255;0;0,2,149,150,0,215,7496,7562,66,0
24774ref2,8283,8526,JUNC00000102,7,+,8283,8526,255;0;0,2,148,30,0,213,8431,8496,65,0
24774ref2,1723,1937,JUNC00000036,2,-,1723,1937,255;0;0,2,127,23,0,191,1850,1914,64,0
24774ref2,957,1167,JUNC00000017,1,-,957,1167,255;0;0,2,142,9,0,201,1099,1158,59,0
24774ref2,4359,4685,JUNC00000071,158,-,4359,4685,255;0;0,2,138,130,0,196,4497,4555,58,0
24774ref2,8393,8602,JUNC00000106,1,+,8393,8602,255;0;0,2,95,56,0,153,8488,8546,58,0
24774ref2,955,1307,JUNC00000018,532,-,955,1307,255;0;0,2,146,149,0,203,1101,1158,57,0
24774ref2,9350,9457,JUNC00000117,1,+,9350,9457,255;0;0,2,28,22,0,85,9378,9435,57,0
24774ref2,7954,8166,JUNC00000098,4,+,7954,8166,255;0;0,2,8,150,0,62,7962,8016,54,0
24774ref2,825,1169,JUNC00000014,34,+,825,1169,255;0;0,2,144,147,0,197,969,1022,53,0
24774ref2,1723,1971,JUNC00000037,4,-,1723,1971,255;0;0,2,137,59,0,189,1860,1912,52,0
24774ref2,5608,5811,JUNC00000081,1,+,5608,5811,255;0;0,2,140,11,0,192,5748,5800,52,0
24774ref2,8304,8510,JUNC00000105,5,+,8304,8510,255;0;0,2,145,14,0,192,8449,8496,47,0
24774ref2,5687,5889,JUNC00000080,393,-,5687,5889,255;0;0,2,8,148,0,54,5695,5741,46,0
24774ref2,10062,10259,JUNC00000124,1,+,10062,10259,255;0;0,2,84,67,0,130,10146,10192,46,0
24774ref2,7745,7939,JUNC00000093,6,-,7745,7939,255;0;0,2,61,90,0,104,7806,7849,43,0
24774ref2,2444,2783,JUNC00000051,7,-,2444,2783,255;0;0,2,150,147,0,192,2594,2636,42,0
24774ref2,2563,2637,JUNC00000050,1,+,2563,2637,255;0;0,2,26,8,0,66,2589,2629,40,0
24774ref2,2238,2572,JUNC00000042,19,-,2238,2572,255;0;0,2,150,148,0,186,2388,2424,36,0
24774ref2,7512,7806,JUNC00000091,3,+,7512,7806,255;0;0,2,148,110,0,184,7660,7696,36,0
24774ref2,2802,3032,JUNC00000056,14,-,2802,3032,255;0;0,2,147,48,0,182,2949,2984,35,0
24774ref2,5527,5778,JUNC00000079,8,-,5527,5778,255;0;0,2,73,145,0,106,5600,5633,33,0
24774ref2,2919,3245,JUNC00000058,17,-,2919,3245,255;0;0,2,146,148,0,178,3065,3097,32,0
24774ref2,7708,8035,JUNC00000096,7,+,7708,8035,255;0;0,2,149,147,0,180,7857,7888,31,0
24774ref2,2778,2841,JUNC00000053,1,-,2778,2841,255;0;0,2,24,9,0,54,2802,2832,30,0
24774ref2,2921,3105,JUNC00000059,3,-,2921,3105,255;0;0,2,146,8,0,176,3067,3097,30,0
24774ref2,4280,4516,JUNC00000068,3,-,4280,4516,255;0;0,2,72,134,0,102,4352,4382,30,0
24774ref2,3023,3351,JUNC00000061,158,-,3023,3351,255;0;0,2,150,150,0,178,3173,3201,28,0
24774ref2,10035,10230,JUNC00000126,2,+,10035,10230,255;0;0,2,129,38,0,157,10164,10192,28,0
24774ref2,3233,3434,JUNC00000062,860,-,3233,3434,255;0;0,2,24,150,0,51,3257,3284,27,0
24774ref2,7703,7884,JUNC00000094,15,-,7703,7884,255;0;0,2,145,9,0,172,7848,7875,27,0
24774ref2,3023,3346,JUNC00000060,85,+,3023,3346,255;0;0,2,148,150,0,173,3171,3196,25,0
24774ref2,1207,1527,JUNC00000022,15,+,1207,1527,255;0;0,2,146,150,0,170,1353,1377,24,0
24774ref2,6083,6254,JUNC00000083,15,+,6083,6254,255;0;0,2,98,51,0,120,6181,6203,22,0
24774ref2,2320,2637,JUNC00000044,8,+,2320,2637,255;0;0,2,147,149,0,168,2467,2488,21,0
24774ref2,2411,2580,JUNC00000047,1,+,2411,2580,255;0;0,2,136,15,0,154,2547,2565,18,0
24774ref2,2715,2974,JUNC00000054,218,+,2715,2974,255;0;0,2,150,93,0,166,2865,2881,16,0
24774ref2,4906,5094,JUNC00000075,2,+,4906,5094,255;0;0,2,22,150,0,38,4928,4944,16,0
24774ref2,5950,6210,JUNC00000082,71,+,5950,6210,255;0;0,2,100,144,0,116,6050,6066,16,0
24774ref2,4229,4418,JUNC00000066,28,+,4229,4418,255;0;0,2,28,147,0,42,4257,4271,14,0
24774ref2,8299,8612,JUNC00000104,3,+,8299,8612,255;0;0,2,150,149,0,164,8449,8463,14,0
24774ref2,2528,2575,JUNC00000048,1,-,2528,2575,255;0;0,2,26,8,0,39,2554,2567,13,0
24774ref2,2497,2632,JUNC00000049,5,+,2497,2632,255;0;0,2,68,54,0,81,2565,2578,13,0
24774ref2,8294,8598,JUNC00000103,6,+,8294,8598,255;0;0,2,147,144,0,160,8441,8454,13,0
24774ref2,10014,10226,JUNC00000125,2,+,10014,10226,255;0;0,2,150,49,0,163,10164,10177,13,0
24774ref2,1519,1826,JUNC00000031,2,+,1519,1826,255;0;0,2,149,146,0,161,1668,1680,12,0
24774ref2,7731,8017,JUNC00000095,5,+,7731,8017,255;0;0,2,126,150,0,136,7857,7867,10,0
24774ref2,1238,1544,JUNC00000025,11,-,1238,1544,255;0;0,2,148,149,0,157,1386,1395,9,0
24774ref2,8008,8314,JUNC00000100,15,+,8008,8314,255;0;0,2,148,149,0,157,8156,8165,9,0
24774ref2,9030,9198,JUNC00000114,5,+,9030,9198,255;0;0,2,149,10,0,158,9179,9188,9,0
24774ref2,1001,1307,JUNC00000019,1059,-,1001,1307,255;0;0,2,149,149,0,157,1150,1158,8,0
24774ref2,1185,1364,JUNC00000020,5,-,1185,1364,255;0;0,2,23,148,0,31,1208,1216,8,0
24774ref2,1074,1380,JUNC00000021,25,+,1074,1380,255;0;0,2,150,148,0,158,1224,1232,8,0
24774ref2,825,1126,JUNC00000013,588,+,825,1126,255;0;0,2,144,150,0,151,969,976,7,0
24774ref2,7719,7881,JUNC00000097,7,+,7719,7881,255;0;0,2,147,8,0,154,7866,7873,7,0
24774ref2,8284,8586,JUNC00000101,11,+,8284,8586,255;0;0,2,147,148,0,154,8431,8438,7,0
24774ref2,9491,9796,JUNC00000119,208,+,9491,9796,255;0;0,2,148,150,0,155,9639,9646,7,0
24774ref2,2342,2565,JUNC00000045,7,+,2342,2565,255;0;0,2,149,68,0,155,2491,2497,6,0
24774ref2,4234,4525,JUNC00000069,426,-,4234,4525,255;0;0,2,148,137,0,154,4382,4388,6,0
24774ref2,4361,4518,JUNC00000070,1,-,4361,4518,255;0;0,2,105,46,0,111,4466,4472,6,0
24774ref2,5116,5346,JUNC00000077,184,+,5116,5346,255;0;0,2,149,75,0,155,5265,5271,6,0
24774ref2,1338,1511,JUNC00000023,391,-,1338,1511,255;0;0,2,25,143,0,30,1363,1368,5,0
24774ref2,7445,7601,JUNC00000090,7,-,7445,7601,255;0;0,2,128,23,0,133,7573,7578,5,0
24774ref2,8776,9078,JUNC00000109,35689,+,8776,9078,255;0;0,2,147,150,0,152,8923,8928,5,0
18264ref1,174,503,JUNC00000001,4,+,174,503,255;0;0,2,150,146,0,183,324,357,33,0
18264ref1,306,4655,JUNC00000002,1,+,306,4655,255;0;0,2,62,89,0,4260,368,4566,4198,0
18264ref1,392,10112,JUNC00000003,3,+,392,10112,255;0;0,2,79,142,0,9578,471,9970,9499,0
18264ref1,408,761,JUNC00000004,167,-,408,761,255;0;0,2,150,142,0,211,558,619,61,0
18264ref1,524,972,JUNC00000005,623,+,524,972,255;0;0,2,150,146,0,302,674,826,152,0
18264ref1,667,1079,JUNC00000006,58,-,667,1079,255;0;0,2,65,147,0,265,732,932,200,0
18264ref1,601,887,JUNC00000007,2,-,601,887,255;0;0,2,143,102,0,184,744,785,41,0
18264ref1,703,969,JUNC00000008,129,+,703,969,255;0;0,2,90,143,0,123,793,826,33,0
18264ref1,763,931,JUNC00000009,2,+,763,931,255;0;0,2,30,53,0,115,793,878,85,0
18264ref1,897,1058,JUNC00000010,12,-,897,1058,255;0;0,2,8,148,0,13,905,910,5,0
18264ref1,781,1082,JUNC00000011,24,+,781,1082,255;0;0,2,149,147,0,154,930,935,5,0
18264ref1,911,1124,JUNC00000012,29,+,911,1124,255;0;0,2,29,148,0,65,940,976,36,0
18264ref1,824,1126,JUNC00000013,78,+,824,1126,255;0;0,2,145,150,0,152,969,976,7,0
18264ref1,825,1171,JUNC00000014,17,+,825,1171,255;0;0,2,144,149,0,197,969,1022,53,0
18264ref1,949,1289,JUNC00000015,23,-,949,1289,255;0;0,2,150,150,0,190,1099,1139,40,0
18264ref1,955,1190,JUNC00000016,868,-,955,1190,255;0;0,2,146,32,0,203,1101,1158,57,0
18264ref1,1091,1294,JUNC00000017,23,+,1091,1294,255;0;0,2,20,149,0,54,1111,1145,34,0
18264ref1,973,1275,JUNC00000018,9,+,973,1275,255;0;0,2,149,147,0,155,1122,1128,6,0
18264ref1,978,1293,JUNC00000019,60,+,978,1293,255;0;0,2,149,146,0,169,1127,1147,20,0
18264ref1,1006,1304,JUNC00000020,18,-,1006,1304,255;0;0,2,144,149,0,149,1150,1155,5,0
18264ref1,1073,3916,JUNC00000021,5,-,1073,3916,255;0;0,2,144,149,0,2694,1217,3767,2550,0
18264ref1,1164,1547,JUNC00000022,135,+,1164,1547,255;0;0,2,144,139,0,244,1308,1408,100,0
18264ref1,1601,1973,JUNC00000023,2044,-,1601,1973,255;0;0,2,150,147,0,225,1751,1826,75,0
18264ref1,1723,1979,JUNC00000024,5,-,1723,1979,255;0;0,2,46,148,0,108,1769,1831,62,0
18264ref1,1619,1970,JUNC00000025,665,-,1619,1970,255;0;0,2,150,132,0,219,1769,1838,69,0
18264ref1,1659,1972,JUNC00000026,2,+,1659,1972,255;0;0,2,141,87,0,226,1800,1885,85,0
18264ref1,1921,2109,JUNC00000027,1,-,1921,2109,255;0;0,2,126,23,0,165,2047,2086,39,0
18264ref1,1978,2504,JUNC00000028,2,+,1978,2504,255;0;0,2,149,150,0,376,2127,2354,227,0
18264ref1,2141,2474,JUNC00000029,864,+,2141,2474,255;0;0,2,150,147,0,186,2291,2327,36,0
18264ref1,2177,2646,JUNC00000030,367,+,2177,2646,255;0;0,2,150,147,0,322,2327,2499,172,0
18264ref1,2238,2573,JUNC00000031,33,-,2238,2573,255;0;0,2,150,149,0,186,2388,2424,36,0
18264ref1,2464,2779,JUNC00000032,137,+,2464,2779,255;0;0,2,125,150,0,165,2589,2629,40,0
18264ref1,2450,2763,JUNC00000033,18,+,2450,2763,255;0;0,2,148,150,0,163,2598,2613,15,0
18264ref1,2656,2988,JUNC00000034,673,+,2656,2988,255;0;0,2,150,148,0,184,2806,2840,34,0
18264ref1,2667,2852,JUNC00000035,8,-,2667,2852,255;0;0,2,149,20,0,165,2816,2832,16,0
18264ref1,2835,3144,JUNC00000036,2753,+,2835,3144,255;0;0,2,84,150,0,159,2919,2994,75,0
18264ref1,2817,3128,JUNC00000037,248,-,2817,3128,255;0;0,2,150,150,0,161,2967,2978,11,0
18264ref1,3693,3969,JUNC00000038,1321,-,3693,3969,255;0;0,2,114,150,0,126,3807,3819,12,0
18264ref1,3833,4173,JUNC00000039,3,+,3833,4173,255;0;0,2,97,148,0,192,3930,4025,95,0
18264ref1,4107,4418,JUNC00000040,21,+,4107,4418,255;0;0,2,150,147,0,164,4257,4271,14,0
18264ref1,4151,4560,JUNC00000041,32,-,4151,4560,255;0;0,2,149,148,0,261,4300,4412,112,0
18264ref1,4183,4577,JUNC00000042,170,+,4183,4577,255;0;0,2,140,142,0,252,4323,4435,112,0
18264ref1,4226,4554,JUNC00000043,31,+,4226,4554,255;0;0,2,149,149,0,179,4375,4405,30,0
18264ref1,4237,4414,JUNC00000044,128,-,4237,4414,255;0;0,2,145,26,0,151,4382,4388,6,0
18264ref1,4264,4568,JUNC00000045,470,-,4264,4568,255;0;0,2,149,150,0,154,4413,4418,5,0
18264ref1,4322,4646,JUNC00000046,81,-,4322,4646,255;0;0,2,115,149,0,175,4437,4497,60,0
18264ref1,4445,4657,JUNC00000047,15,-,4445,4657,255;0;0,2,61,118,0,94,4506,4539,33,0
18264ref1,4497,4817,JUNC00000048,167,-,4497,4817,255;0;0,2,35,150,0,170,4532,4667,135,0
18264ref1,4394,4824,JUNC00000049,109,-,4394,4824,255;0;0,2,145,150,0,280,4539,4674,135,0
18264ref1,4398,4829,JUNC00000050,31,-,4398,4829,255;0;0,2,146,150,0,281,4544,4679,135,0
18264ref1,4960,5111,JUNC00000051,2,+,4960,5111,255;0;0,2,20,59,0,92,4980,5052,72,0
18264ref1,5347,5662,JUNC00000052,221,+,5347,5662,255;0;0,2,145,150,0,165,5492,5512,20,0
18264ref1,5725,6121,JUNC00000053,17,-,5725,6121,255;0;0,2,150,148,0,248,5875,5973,98,0
18264ref1,5728,6031,JUNC00000054,27,+,5728,6031,255;0;0,2,150,147,0,156,5878,5884,6,0
18264ref1,5923,6240,JUNC00000055,30,+,5923,6240,255;0;0,2,147,150,0,167,6070,6090,20,0
18264ref1,6152,7661,JUNC00000056,20,+,6152,7661,255;0;0,2,150,149,0,1360,6302,7512,1210,0
18264ref1,7263,7545,JUNC00000057,42,-,7263,7545,255;0;0,2,62,149,0,133,7325,7396,71,0
18264ref1,7353,7555,JUNC00000058,12,+,7353,7555,255;0;0,2,32,146,0,56,7385,7409,24,0
18264ref1,7259,7522,JUNC00000059,136,-,7259,7522,255;0;0,2,150,107,0,156,7409,7415,6,0
18264ref1,7259,7579,JUNC00000060,244,-,7259,7579,255;0;0,2,150,146,0,174,7409,7433,24,0
18264ref1,7406,7744,JUNC00000061,3,-,7406,7744,255;0;0,2,30,121,0,217,7436,7623,187,0
18264ref1,7361,7608,JUNC00000062,73,-,7361,7608,255;0;0,2,150,30,0,217,7511,7578,67,0
18264ref1,7424,7607,JUNC00000063,14,-,7424,7607,255;0;0,2,149,29,0,154,7573,7578,5,0
18264ref1,7713,7885,JUNC00000064,2,-,7713,7885,255;0;0,2,18,126,0,46,7731,7759,28,0
18264ref1,7606,7956,JUNC00000065,2,-,7606,7956,255;0;0,2,146,150,0,200,7752,7806,54,0
18264ref1,7724,7957,JUNC00000066,1,-,7724,7957,255;0;0,2,28,51,0,182,7752,7906,154,0
18264ref1,7689,8855,JUNC00000067,1,+,7689,8855,255;0;0,2,136,14,0,1152,7825,8841,1016,0
18264ref1,7962,8299,JUNC00000068,393,-,7962,8299,255;0;0,2,150,149,0,188,8112,8150,38,0
18264ref1,8429,8669,JUNC00000069,1,+,8429,8669,255;0;0,2,9,63,0,177,8438,8606,168,0
18264ref1,8363,8621,JUNC00000070,2,+,8363,8621,255;0;0,2,125,75,0,183,8488,8546,58,0
18264ref1,8765,9076,JUNC00000071,505,+,8765,9076,255;0;0,2,150,148,0,163,8915,8928,13,0
18264ref1,8773,9078,JUNC00000072,1593,+,8773,9078,255;0;0,2,150,150,0,155,8923,8928,5,0
18884ref,1111,9295,JUNC00000048,1,-,1111,9295,255;0;0,2,63,88,0,8096,1174,9207,8033,0
18884ref,1086,7561,JUNC00000049,34,+,1086,7561,255;0;0,2,149,10,0,6465,1235,7551,6316,0
18884ref,646,6677,JUNC00000026,18,+,646,6677,255;0;0,2,147,141,0,5890,793,6536,5743,0
18884ref,4302,9145,JUNC00000158,2,+,4302,9145,255;0;0,2,78,148,0,4695,4380,8997,4617,0
18884ref,1878,6083,JUNC00000075,13,+,1878,6083,255;0;0,2,150,149,0,4056,2028,5934,3906,0
18884ref,1985,6042,JUNC00000077,1,-,1985,6042,255;0;0,2,62,89,0,3968,2047,5953,3906,0
18884ref,1789,5770,JUNC00000069,15,-,1789,5770,255;0;0,2,37,142,0,3839,1826,5628,3802,0
18884ref,2764,6159,JUNC00000117,23,+,2764,6159,255;0;0,2,42,147,0,3248,2806,6012,3206,0
18884ref,2669,6116,JUNC00000119,199,-,2669,6116,255;0;0,2,147,94,0,3353,2816,6022,3206,0
18884ref,5885,9064,JUNC00000195,2,-,5885,9064,255;0;0,2,89,147,0,3032,5974,8917,2943,0
18884ref,7654,10096,JUNC00000250,12,-,7654,10096,255;0;0,2,122,146,0,2296,7776,9950,2174,0
18884ref,3957,6142,JUNC00000145,9,-,3957,6142,255;0;0,2,150,149,0,2036,4107,5993,1886,0
18884ref,1646,3382,JUNC00000066,11,+,1646,3382,255;0;0,2,143,150,0,1586,1789,3232,1443,0
18884ref,725,1896,JUNC00000021,35,-,725,1896,255;0;0,2,45,145,0,1026,770,1751,981,0
18884ref,674,1852,JUNC00000024,19,-,674,1852,255;0;0,2,111,140,0,1038,785,1712,927,0
18884ref,8078,9078,JUNC00000261,24,+,8078,9078,255;0;0,2,49,150,0,850,8127,8928,801,0
18884ref,600,1439,JUNC00000008,1,+,600,1439,255;0;0,2,27,101,0,738,627,1338,711,0
18884ref,6902,7754,JUNC00000210,12,-,6902,7754,255;0;0,2,42,148,0,704,6944,7606,662,0
18884ref,5574,6316,JUNC00000179,94,+,5574,6316,255;0;0,2,26,149,0,593,5600,6167,567,0
18884ref,5005,5813,JUNC00000174,16,+,5005,5813,255;0;0,2,149,126,0,682,5154,5687,533,0
18884ref,7067,7690,JUNC00000213,2,-,7067,7690,255;0;0,2,28,146,0,477,7095,7544,449,0
18884ref,2123,2840,JUNC00000083,124,+,2123,2840,255;0;0,2,148,148,0,569,2271,2692,421,0
18884ref,6928,7642,JUNC00000212,170,+,6928,7642,255;0;0,2,145,148,0,566,7073,7494,421,0
18884ref,4228,4927,JUNC00000157,13,+,4228,4927,255;0;0,2,150,150,0,549,4378,4777,399,0
18884ref,7346,7988,JUNC00000232,21,-,7346,7988,255;0;0,2,143,113,0,529,7489,7875,386,0
18884ref,602,1133,JUNC00000007,11,+,602,1133,255;0;0,2,25,131,0,400,627,1002,375,0
18884ref,4531,5200,JUNC00000165,9,+,4531,5200,255;0;0,2,150,148,0,521,4681,5052,371,0
18884ref,175,831,JUNC00000001,850,-,175,831,255;0;0,2,150,148,0,508,325,683,358,0
18884ref,592,1126,JUNC00000010,29,+,592,1126,255;0;0,2,48,150,0,384,640,976,336,0
18884ref,3928,4357,JUNC00000141,6,-,3928,4357,255;0;0,2,73,26,0,403,4001,4331,330,0
18884ref,6114,6617,JUNC00000198,52,+,6114,6617,255;0;0,2,67,136,0,367,6181,6481,300,0
18884ref,2523,2994,JUNC00000099,53,+,2523,2994,255;0;0,2,24,149,0,322,2547,2845,298,0
18884ref,7964,8543,JUNC00000259,190,+,7964,8543,255;0;0,2,142,149,0,430,8106,8394,288,0
18884ref,7274,7734,JUNC00000226,26,+,7274,7734,255;0;0,2,48,144,0,316,7322,7590,268,0
18884ref,7340,7733,JUNC00000227,17,+,7340,7733,255;0;0,2,34,150,0,243,7374,7583,209,0
18884ref,5333,5711,JUNC00000176,57,-,5333,5711,255;0;0,2,25,148,0,230,5358,5563,205,0
18884ref,528,1025,JUNC00000014,32,+,528,1025,255;0;0,2,146,147,0,350,674,878,204,0
18884ref,3696,4112,JUNC00000135,112,-,3696,4112,255;0;0,2,71,146,0,270,3767,3966,199,0
18884ref,1262,1754,JUNC00000055,17,+,1262,1754,255;0;0,2,149,148,0,344,1411,1606,195,0
18884ref,9809,10169,JUNC00000302,2,-,9809,10169,255;0;0,2,141,27,0,333,9950,10142,192,0
18884ref,5656,6128,JUNC00000184,46,+,5656,6128,255;0;0,2,149,148,0,324,5805,5980,175,0
18884ref,4060,4385,JUNC00000149,198,+,4060,4385,255;0;0,2,89,62,0,263,4149,4323,174,0
18884ref,7404,7867,JUNC00000236,59,+,7404,7867,255;0;0,2,150,147,0,316,7554,7720,166,0
18884ref,7054,7516,JUNC00000219,11,+,7054,7516,255;0;0,2,149,150,0,312,7203,7366,163,0
18884ref,445,818,JUNC00000002,64,-,445,818,255;0;0,2,64,149,0,224,509,669,160,0
18884ref,7999,8455,JUNC00000263,4,+,7999,8455,255;0;0,2,149,147,0,309,8148,8308,160,0
18884ref,8008,8339,JUNC00000265,10,+,8008,8339,255;0;0,2,148,23,0,308,8156,8316,160,0
18884ref,3801,4253,JUNC00000139,5,+,3801,4253,255;0;0,2,145,150,0,302,3946,4103,157,0
18884ref,7690,8143,JUNC00000252,48,+,7690,8143,255;0;0,2,147,149,0,304,7837,7994,157,0
18884ref,666,890,JUNC00000016,3,+,666,890,255;0;0,2,44,26,0,198,710,864,154,0
18884ref,655,1019,JUNC00000017,60,+,655,1019,255;0;0,2,62,148,0,216,717,871,154,0
18884ref,8437,8749,JUNC00000275,2,+,8437,8749,255;0;0,2,9,149,0,163,8446,8600,154,0
18884ref,1517,1867,JUNC00000061,7,+,1517,1867,255;0;0,2,51,148,0,202,1568,1719,151,0
18884ref,5821,6265,JUNC00000193,6,+,5821,6265,255;0;0,2,144,149,0,295,5965,6116,151,0
18884ref,2342,2779,JUNC00000095,15,+,2342,2779,255;0;0,2,149,150,0,287,2491,2629,138,0
18884ref,8367,8804,JUNC00000279,464,+,8367,8804,255;0;0,2,150,150,0,287,8517,8654,137,0
18884ref,4488,4689,JUNC00000163,4,-,4488,4689,255;0;0,2,44,22,0,179,4532,4667,135,0
18884ref,4393,4798,JUNC00000164,11,-,4393,4798,255;0;0,2,146,124,0,281,4539,4674,135,0
18884ref,7725,8156,JUNC00000257,44,-,7725,8156,255;0;0,2,150,149,0,282,7875,8007,132,0
18884ref,3962,4390,JUNC00000147,21,-,3962,4390,255;0;0,2,147,150,0,278,4109,4240,131,0
18884ref,4749,5115,JUNC00000169,2,+,4749,5115,255;0;0,2,112,124,0,242,4861,4991,130,0
18884ref,2353,2777,JUNC00000096,13,+,2353,2777,255;0;0,2,148,148,0,276,2501,2629,128,0
18884ref,7288,7582,JUNC00000230,3,-,7288,7582,255;0;0,2,141,26,0,268,7429,7556,127,0
18884ref,8781,9205,JUNC00000286,4,+,8781,9205,255;0;0,2,150,148,0,276,8931,9057,126,0
18884ref,9680,10095,JUNC00000297,19,-,9680,10095,255;0;0,2,144,145,0,270,9824,9950,126,0
18884ref,2238,2658,JUNC00000088,18,+,2238,2658,255;0;0,2,147,149,0,271,2385,2509,124,0
18884ref,2822,3177,JUNC00000127,85,+,2822,3177,255;0;0,2,148,84,0,271,2970,3093,123,0
18884ref,495,773,JUNC00000003,49,+,495,773,255;0;0,2,39,117,0,161,534,656,122,0
18884ref,1518,1938,JUNC00000063,10,+,1518,1938,255;0;0,2,150,150,0,270,1668,1788,120,0
18884ref,1889,2220,JUNC00000076,220,+,1889,2220,255;0;0,2,145,70,0,261,2034,2150,116,0
18884ref,2420,2800,JUNC00000097,49,-,2420,2800,255;0;0,2,116,148,0,232,2536,2652,116,0
18884ref,2744,3156,JUNC00000125,9,+,2744,3156,255;0;0,2,149,150,0,262,2893,3006,113,0
18884ref,7120,7390,JUNC00000216,72,+,7120,7390,255;0;0,2,8,150,0,120,7128,7240,112,0
18884ref,750,1010,JUNC00000023,12,+,750,1010,255;0;0,2,33,118,0,142,783,892,109,0
18884ref,438,843,JUNC00000006,8,-,438,843,255;0;0,2,148,149,0,256,586,694,108,0
18884ref,9860,10160,JUNC00000299,92,+,9860,10160,255;0;0,2,43,149,0,151,9903,10011,108,0
18884ref,1124,1423,JUNC00000050,51,+,1124,1423,255;0;0,2,146,46,0,253,1270,1377,107,0
18884ref,3881,4180,JUNC00000138,106,+,3881,4180,255;0;0,2,49,147,0,152,3930,4033,103,0
18884ref,2174,2473,JUNC00000082,16,+,2174,2473,255;0;0,2,51,146,0,153,2225,2327,102,0
18884ref,5785,6159,JUNC00000189,7,-,5785,6159,255;0;0,2,148,124,0,250,5933,6035,102,0
18884ref,2373,2638,JUNC00000090,12,+,2373,2638,255;0;0,2,25,148,0,117,2398,2490,92,0
18884ref,2356,2650,JUNC00000092,96,+,2356,2650,255;0;0,2,53,149,0,145,2409,2501,92,0
18884ref,750,1013,JUNC00000022,145,+,750,1013,255;0;0,2,23,149,0,114,773,864,91,0
18884ref,2285,2662,JUNC00000093,7,-,2285,2662,255;0;0,2,143,147,0,230,2428,2515,87,0
18884ref,1681,2059,JUNC00000068,57,-,1681,2059,255;0;0,2,145,147,0,231,1826,1912,86,0
18884ref,5826,6206,JUNC00000194,9,-,5826,6206,255;0;0,2,146,148,0,232,5972,6058,86,0
18884ref,5563,5939,JUNC00000180,15,-,5563,5939,255;0;0,2,147,146,0,230,5710,5793,83,0
18884ref,7524,7905,JUNC00000244,42,+,7524,7905,255;0;0,2,150,148,0,233,7674,7757,83,0
18884ref,5633,6007,JUNC00000182,8,-,5633,6007,255;0;0,2,143,150,0,224,5776,5857,81,0
18884ref,6295,6671,JUNC00000200,18,+,6295,6671,255;0;0,2,149,146,0,230,6444,6525,81,0
18884ref,6307,6686,JUNC00000201,26,-,6307,6686,255;0;0,2,148,150,0,229,6455,6536,81,0
18884ref,3974,4248,JUNC00000143,55,+,3974,4248,255;0;0,2,51,145,0,129,4025,4103,78,0
18884ref,683,1059,JUNC00000028,4,-,683,1059,255;0;0,2,150,149,0,227,833,910,77,0
18884ref,9876,10117,JUNC00000298,19,+,9876,10117,255;0;0,2,22,147,0,94,9898,9970,72,0
18884ref,638,887,JUNC00000013,78,+,638,887,255;0;0,2,36,142,0,107,674,745,71,0
18884ref,1404,1762,JUNC00000058,160,+,1404,1762,255;0;0,2,144,144,0,214,1548,1618,70,0
18884ref,4791,5034,JUNC00000168,98,+,4791,5034,255;0;0,2,26,148,0,95,4817,4886,69,0
18884ref,1806,2042,JUNC00000067,2,+,1806,2042,255;0;0,2,18,150,0,86,1824,1892,68,0
18884ref,1758,1940,JUNC00000070,8,+,1758,1940,255;0;0,2,92,22,0,160,1850,1918,68,0
18884ref,560,851,JUNC00000009,207,+,560,851,255;0;0,2,74,150,0,141,634,701,67,0
18884ref,6884,7103,JUNC00000208,55,-,6884,7103,255;0;0,2,8,144,0,75,6892,6959,67,0
18884ref,7361,7726,JUNC00000233,163,-,7361,7726,255;0;0,2,150,148,0,217,7511,7578,67,0
18884ref,8283,8645,JUNC00000271,51,+,8283,8645,255;0;0,2,148,149,0,213,8431,8496,65,0
18884ref,438,800,JUNC00000005,27,-,438,800,255;0;0,2,148,150,0,212,586,650,64,0
18884ref,6968,7331,JUNC00000215,110,-,6968,7331,255;0;0,2,150,150,0,213,7118,7181,63,0
18884ref,450,767,JUNC00000004,40,-,450,767,255;0;0,2,108,148,0,169,558,619,61,0
18884ref,8495,8854,JUNC00000280,16,+,8495,8854,255;0;0,2,148,150,0,209,8643,8704,61,0
18884ref,622,974,JUNC00000020,78,-,622,974,255;0;0,2,148,146,0,206,770,828,58,0
18884ref,4207,4564,JUNC00000155,24,+,4207,4564,255;0;0,2,149,150,0,207,4356,4414,58,0
18884ref,4416,4664,JUNC00000162,226,-,4416,4664,255;0;0,2,81,109,0,139,4497,4555,58,0
18884ref,8342,8692,JUNC00000278,3,+,8342,8692,255;0;0,2,146,146,0,204,8488,8546,58,0
18884ref,9033,9245,JUNC00000290,8,+,9033,9245,255;0;0,2,146,8,0,204,9179,9237,58,0
18884ref,955,1307,JUNC00000040,879,-,955,1307,255;0;0,2,146,149,0,203,1101,1158,57,0
18884ref,2441,2792,JUNC00000107,5,+,2441,2792,255;0;0,2,148,148,0,203,2589,2644,55,0
18884ref,5195,5549,JUNC00000175,5,+,5195,5549,255;0;0,2,150,150,0,204,5345,5399,54,0
18884ref,7486,7840,JUNC00000238,17,+,7486,7840,255;0;0,2,150,150,0,204,7636,7690,54,0
18884ref,9050,9277,JUNC00000288,3,-,9050,9277,255;0;0,2,28,145,0,82,9078,9132,54,0
18884ref,825,1171,JUNC00000035,29,+,825,1171,255;0;0,2,144,149,0,197,969,1022,53,0
18884ref,6959,7300,JUNC00000214,77,-,6959,7300,255;0;0,2,142,146,0,195,7101,7154,53,0
18884ref,1720,1934,JUNC00000071,3,-,1720,1934,255;0;0,2,140,22,0,192,1860,1912,52,0
18884ref,2698,2946,JUNC00000114,53,-,2698,2946,255;0;0,2,48,148,0,100,2746,2798,52,0
18884ref,7277,7626,JUNC00000229,29,-,7277,7626,255;0;0,2,150,148,0,201,7427,7478,51,0
18884ref,5792,6019,JUNC00000185,8,-,5792,6019,255;0;0,2,28,149,0,78,5820,5870,50,0
18884ref,7721,8065,JUNC00000255,39,-,7721,8065,255;0;0,2,145,149,0,195,7866,7916,50,0
18884ref,2162,2504,JUNC00000085,3,+,2162,2504,255;0;0,2,148,145,0,197,2310,2359,49,0
18884ref,2433,2777,JUNC00000104,14,+,2433,2777,255;0;0,2,147,148,0,196,2580,2629,49,0
18884ref,2522,2866,JUNC00000112,63,+,2522,2866,255;0;0,2,148,147,0,197,2670,2719,49,0
18884ref,3068,3268,JUNC00000129,2,+,3068,3268,255;0;0,2,10,141,0,59,3078,3127,49,0
18884ref,4098,4446,JUNC00000150,11,+,4098,4446,255;0;0,2,150,149,0,199,4248,4297,49,0
18884ref,7240,7578,JUNC00000228,200,+,7240,7578,255;0;0,2,145,145,0,193,7385,7433,48,0
18884ref,8294,8638,JUNC00000273,53,+,8294,8638,255;0;0,2,150,146,0,198,8444,8492,48,0
18884ref,1411,1755,JUNC00000060,5,+,1411,1755,255;0;0,2,148,149,0,195,1559,1606,47,0
18884ref,2407,2753,JUNC00000100,18,+,2407,2753,255;0;0,2,149,150,0,196,2556,2603,47,0
18884ref,8908,9251,JUNC00000287,14,-,8908,9251,255;0;0,2,148,148,0,195,9056,9103,47,0
18884ref,1509,1750,JUNC00000059,21,-,1509,1750,255;0;0,2,45,150,0,91,1554,1600,46,0
18884ref,1973,2318,JUNC00000079,3,+,1973,2318,255;0;0,2,149,150,0,195,2122,2168,46,0
18884ref,7454,7671,JUNC00000231,17,+,7454,7671,255;0;0,2,22,149,0,68,7476,7522,46,0
18884ref,9901,10111,JUNC00000300,21,+,9901,10111,255;0;0,2,19,148,0,62,9920,9963,43,0
18884ref,9777,10114,JUNC00000301,3,+,9777,10114,255;0;0,2,148,146,0,191,9925,9968,43,0
18884ref,7680,8015,JUNC00000251,7,+,7680,8015,255;0;0,2,145,148,0,187,7825,7867,42,0
18884ref,599,794,JUNC00000018,28,-,599,794,255;0;0,2,145,9,0,186,744,785,41,0
18884ref,2555,2749,JUNC00000102,10,+,2555,2749,255;0;0,2,10,143,0,51,2565,2606,41,0
18884ref,2568,2779,JUNC00000106,6,+,2568,2779,255;0;0,2,21,150,0,61,2589,2629,40,0
18884ref,5805,6142,JUNC00000191,8,-,5805,6142,255;0;0,2,148,149,0,188,5953,5993,40,0
18884ref,6741,6966,JUNC00000205,21,-,6741,6966,255;0;0,2,37,148,0,77,6778,6818,40,0
18884ref,8297,8505,JUNC00000267,149,+,8297,8505,255;0;0,2,24,144,0,64,8321,8361,40,0
18884ref,5590,5924,JUNC00000181,27,+,5590,5924,255;0;0,2,146,149,0,185,5736,5775,39,0
18884ref,5933,6130,JUNC00000190,16,+,5933,6130,255;0;0,2,10,148,0,49,5943,5982,39,0
18884ref,4249,4442,JUNC00000152,10,+,4249,4442,255;0;0,2,8,147,0,46,4257,4295,38,0
18884ref,5807,6142,JUNC00000192,9,-,5807,6142,255;0;0,2,148,149,0,186,5955,5993,38,0
18884ref,6743,6969,JUNC00000206,75,-,6743,6969,255;0;0,2,40,148,0,78,6783,6821,38,0
18884ref,7497,7835,JUNC00000239,8,+,7497,7835,255;0;0,2,150,150,0,188,7647,7685,38,0
18884ref,1518,1854,JUNC00000062,7,+,1518,1854,255;0;0,2,150,149,0,187,1668,1705,37,0
18884ref,5920,6228,JUNC00000197,3,-,5920,6228,255;0;0,2,124,147,0,161,6044,6081,37,0
18884ref,2238,2574,JUNC00000089,65,-,2238,2574,255;0;0,2,150,150,0,186,2388,2424,36,0
18884ref,8209,8540,JUNC00000268,3,+,8209,8540,255;0;0,2,147,148,0,183,8356,8392,36,0
18884ref,2444,2779,JUNC00000109,10,-,2444,2779,255;0;0,2,150,150,0,185,2594,2629,35,0
18884ref,2449,2781,JUNC00000111,233,-,2449,2781,255;0;0,2,149,148,0,184,2598,2633,35,0
18884ref,2737,2989,JUNC00000116,27,+,2737,2989,255;0;0,2,69,149,0,103,2806,2840,34,0
18884ref,3855,4060,JUNC00000137,6,-,3855,4060,255;0;0,2,21,150,0,55,3876,3910,34,0
18884ref,658,969,JUNC00000025,42,+,658,969,255;0;0,2,135,143,0,168,793,826,33,0
18884ref,945,1277,JUNC00000038,66,+,945,1277,255;0;0,2,150,149,0,183,1095,1128,33,0
18884ref,2948,3139,JUNC00000126,11,+,2948,3139,255;0;0,2,8,150,0,41,2956,2989,33,0
18884ref,4952,5277,JUNC00000173,2,-,4952,5277,255;0;0,2,145,147,0,178,5097,5130,33,0
18884ref,5460,5781,JUNC00000178,36,-,5460,5781,255;0;0,2,140,148,0,173,5600,5633,33,0
18884ref,8557,8887,JUNC00000281,3,+,8557,8887,255;0;0,2,148,149,0,181,8705,8738,33,0
18884ref,994,1180,JUNC00000036,31,+,994,1180,255;0;0,2,8,146,0,40,1002,1034,32,0
18884ref,952,1283,JUNC00000039,32,-,952,1283,255;0;0,2,149,150,0,181,1101,1133,32,0
18884ref,4194,4523,JUNC00000153,16,-,4194,4523,255;0;0,2,148,149,0,180,4342,4374,32,0
18884ref,4475,4673,JUNC00000161,2,+,4475,4673,255;0;0,2,18,148,0,50,4493,4525,32,0
18884ref,7730,7938,JUNC00000249,29,+,7730,7938,255;0;0,2,30,146,0,62,7760,7792,32,0
18884ref,8789,9010,JUNC00000282,2,-,8789,9010,255;0;0,2,39,150,0,71,8828,8860,32,0
18884ref,2403,2727,JUNC00000098,77,+,2403,2727,255;0;0,2,144,149,0,175,2547,2578,31,0
18884ref,5826,6157,JUNC00000196,11,+,5826,6157,255;0;0,2,150,150,0,181,5976,6007,31,0
18884ref,2655,2980,JUNC00000115,50,-,2655,2980,255;0;0,2,147,148,0,177,2802,2832,30,0
18884ref,4328,4531,JUNC00000154,30,-,4328,4531,255;0;0,2,24,149,0,54,4352,4382,30,0
18884ref,4225,4553,JUNC00000156,57,+,4225,4553,255;0;0,2,150,148,0,180,4375,4405,30,0
18884ref,5327,5653,JUNC00000177,52,-,5327,5653,255;0;0,2,149,148,0,178,5476,5505,29,0
18884ref,6107,6434,JUNC00000199,107,+,6107,6434,255;0;0,2,148,150,0,177,6255,6284,29,0
18884ref,8289,8586,JUNC00000269,29,+,8289,8586,255;0;0,2,120,148,0,149,8409,8438,29,0
18884ref,8285,8607,JUNC00000270,3,+,8285,8607,255;0;0,2,144,149,0,173,8429,8458,29,0
18884ref,1133,1457,JUNC00000051,13,-,1133,1457,255;0;0,2,149,147,0,177,1282,1310,28,0
18884ref,2432,2757,JUNC00000103,63,+,2432,2757,255;0;0,2,148,149,0,176,2580,2608,28,0
18884ref,3743,4035,JUNC00000136,32,+,3743,4035,255;0;0,2,115,149,0,143,3858,3886,28,0
18884ref,3195,3432,JUNC00000133,5,-,3195,3432,255;0;0,2,62,148,0,89,3257,3284,27,0
18884ref,7552,7802,JUNC00000248,15,+,7552,7802,255;0;0,2,149,74,0,176,7701,7728,27,0
18884ref,962,1287,JUNC00000042,6,+,962,1287,255;0;0,2,149,150,0,175,1111,1137,26,0
18884ref,7113,7433,JUNC00000221,11,-,7113,7433,255;0;0,2,148,146,0,174,7261,7287,26,0
18884ref,8309,8633,JUNC00000277,6,+,8309,8633,255;0;0,2,149,149,0,175,8458,8484,26,0
18884ref,698,994,JUNC00000029,20,+,698,994,255;0;0,2,148,123,0,173,846,871,25,0
18884ref,975,1293,JUNC00000046,7,+,975,1293,255;0;0,2,147,146,0,172,1122,1147,25,0
18884ref,1729,1941,JUNC00000072,2,+,1729,1941,255;0;0,2,143,44,0,168,1872,1897,25,0
18884ref,1977,2299,JUNC00000080,4,-,1977,2299,255;0;0,2,148,149,0,173,2125,2150,25,0
18884ref,2994,3317,JUNC00000130,3,+,2994,3317,255;0;0,2,150,148,0,175,3144,3169,25,0
18884ref,3022,3345,JUNC00000132,136,+,3022,3345,255;0;0,2,149,149,0,174,3171,3196,25,0
18884ref,3960,4278,JUNC00000146,12,-,3960,4278,255;0;0,2,149,144,0,174,4109,4134,25,0
18884ref,9634,9827,JUNC00000293,123,-,9634,9827,255;0;0,2,21,147,0,46,9655,9680,25,0
18884ref,1206,1527,JUNC00000052,18,+,1206,1527,255;0;0,2,147,150,0,171,1353,1377,24,0
18884ref,2170,2493,JUNC00000086,18,-,2170,2493,255;0;0,2,149,150,0,173,2319,2343,24,0
18884ref,7695,8013,JUNC00000253,5,+,7695,8013,255;0;0,2,145,149,0,169,7840,7864,24,0
18884ref,8849,9080,JUNC00000283,30,-,8849,9080,255;0;0,2,57,150,0,81,8906,8930,24,0
18884ref,706,1027,JUNC00000031,112,-,706,1027,255;0;0,2,149,149,0,172,855,878,23,0
18884ref,527,847,JUNC00000015,43,+,527,847,255;0;0,2,149,149,0,171,676,698,22,0
18884ref,964,1283,JUNC00000041,23,+,964,1283,255;0;0,2,147,150,0,169,1111,1133,22,0
18884ref,2359,2552,JUNC00000087,24,+,2359,2552,255;0;0,2,26,145,0,48,2385,2407,22,0
18884ref,4846,5165,JUNC00000171,24,-,4846,5165,255;0;0,2,147,150,0,169,4993,5015,22,0
18884ref,7524,7717,JUNC00000243,7,+,7524,7717,255;0;0,2,150,21,0,172,7674,7696,22,0
18884ref,8029,8326,JUNC00000264,11,+,8029,8326,255;0;0,2,125,150,0,147,8154,8176,22,0
18884ref,969,1287,JUNC00000044,7,+,969,1287,255;0;0,2,147,150,0,168,1116,1137,21,0
18884ref,2444,2637,JUNC00000094,16,+,2444,2637,255;0;0,2,23,149,0,44,2467,2488,21,0
18884ref,3942,4138,JUNC00000140,45,+,3942,4138,255;0;0,2,26,149,0,47,3968,3989,21,0
18884ref,4995,5234,JUNC00000172,53,-,4995,5234,255;0;0,2,71,147,0,92,5066,5087,21,0
18884ref,7381,7701,JUNC00000234,6,-,7381,7701,255;0;0,2,149,150,0,170,7530,7551,21,0
18884ref,7393,7709,JUNC00000235,10,+,7393,7709,255;0;0,2,146,149,0,167,7539,7560,21,0
18884ref,3674,3917,JUNC00000134,77,-,3674,3917,255;0;0,2,73,150,0,93,3747,3767,20,0
18884ref,7166,7359,JUNC00000218,26,+,7166,7359,255;0;0,2,24,149,0,44,7190,7210,20,0
18884ref,7510,7829,JUNC00000241,5,-,7510,7829,255;0;0,2,150,149,0,170,7660,7680,20,0
18884ref,1540,1854,JUNC00000064,4,+,1540,1854,255;0;0,2,149,146,0,168,1689,1708,19,0
18884ref,1956,2271,JUNC00000078,10,+,1956,2271,255;0;0,2,148,148,0,167,2104,2123,19,0
18884ref,3990,4182,JUNC00000142,5,-,3990,4182,255;0;0,2,24,149,0,43,4014,4033,19,0
18884ref,6763,7069,JUNC00000209,22,+,6763,7069,255;0;0,2,140,147,0,159,6903,6922,19,0
18884ref,607,822,JUNC00000011,33,+,607,822,255;0;0,2,49,148,0,67,656,674,18,0
18884ref,4722,4926,JUNC00000167,103,+,4722,4926,255;0;0,2,43,143,0,61,4765,4783,18,0
18884ref,9585,9901,JUNC00000294,49,-,9585,9901,255;0;0,2,148,150,0,166,9733,9751,18,0
18884ref,967,1283,JUNC00000043,13,+,967,1283,255;0;0,2,149,150,0,166,1116,1133,17,0
18884ref,2270,2474,JUNC00000084,71,+,2270,2474,255;0;0,2,40,147,0,57,2310,2327,17,0
18884ref,7963,8278,JUNC00000260,120,-,7963,8278,255;0;0,2,149,149,0,166,8112,8129,17,0
18884ref,8300,8612,JUNC00000274,9,+,8300,8612,255;0;0,2,146,149,0,163,8446,8463,17,0
18884ref,614,830,JUNC00000012,8,-,614,830,255;0;0,2,50,150,0,66,664,680,16,0
18884ref,1750,2060,JUNC00000073,8,-,1750,2060,255;0;0,2,146,148,0,162,1896,1912,16,0
18884ref,2667,2855,JUNC00000118,21,-,2667,2855,255;0;0,2,149,23,0,165,2816,2832,16,0
18884ref,2697,3012,JUNC00000123,11,+,2697,3012,255;0;0,2,149,150,0,165,2846,2862,16,0
18884ref,2715,3030,JUNC00000124,77,+,2715,3030,255;0;0,2,150,149,0,166,2865,2881,16,0
18884ref,7527,7840,JUNC00000242,13,+,7527,7840,255;0;0,2,147,150,0,163,7674,7690,16,0
18884ref,7537,7771,JUNC00000246,22,-,7537,7771,255;0;0,2,148,70,0,164,7685,7701,16,0
18884ref,946,1259,JUNC00000037,8,+,946,1259,255;0;0,2,149,149,0,164,1095,1110,15,0
18884ref,1247,1555,JUNC00000054,10,+,1247,1555,255;0;0,2,146,147,0,161,1393,1408,15,0
18884ref,2435,2748,JUNC00000105,7,+,2435,2748,255;0;0,2,149,149,0,164,2584,2599,15,0
18884ref,2449,2763,JUNC00000110,14,+,2449,2763,255;0;0,2,149,150,0,164,2598,2613,15,0
18884ref,3021,3334,JUNC00000131,38,-,3021,3334,255;0;0,2,150,148,0,165,3171,3186,15,0
18884ref,9698,9973,JUNC00000296,195,-,9698,9973,255;0;0,2,111,149,0,126,9809,9824,15,0
18884ref,4128,4416,JUNC00000151,16,+,4128,4416,255;0;0,2,129,145,0,143,4257,4271,14,0
18884ref,4315,4627,JUNC00000160,23,-,4315,4627,255;0;0,2,149,149,0,163,4464,4478,14,0
18884ref,8299,8613,JUNC00000276,37,+,8299,8613,255;0;0,2,150,150,0,164,8449,8463,14,0
18884ref,2557,2723,JUNC00000101,37,+,2557,2723,255;0;0,2,8,145,0,21,2565,2578,13,0
18884ref,2819,2989,JUNC00000121,8,+,2819,2989,255;0;0,2,8,149,0,21,2827,2840,13,0
18884ref,5724,5911,JUNC00000186,3,+,5724,5911,255;0;0,2,117,57,0,130,5841,5854,13,0
18884ref,5731,6040,JUNC00000188,9,+,5731,6040,255;0;0,2,147,149,0,160,5878,5891,13,0
18884ref,7140,7448,JUNC00000225,158,-,7140,7448,255;0;0,2,147,148,0,160,7287,7300,13,0
18884ref,8293,8600,JUNC00000272,8,+,8293,8600,255;0;0,2,148,146,0,161,8441,8454,13,0
18884ref,8857,9076,JUNC00000284,20,+,8857,9076,255;0;0,2,58,148,0,71,8915,8928,13,0
18884ref,2674,2981,JUNC00000120,9,-,2674,2981,255;0;0,2,146,149,0,158,2820,2832,12,0
18884ref,706,1015,JUNC00000030,15,-,706,1015,255;0;0,2,149,149,0,160,855,866,11,0
18884ref,821,1028,JUNC00000032,27,+,821,1028,255;0;0,2,46,150,0,57,867,878,11,0
18884ref,1270,1579,JUNC00000056,9,+,1270,1579,255;0;0,2,149,149,0,160,1419,1430,11,0
18884ref,2112,2296,JUNC00000081,14,+,2112,2296,255;0;0,2,24,149,0,35,2136,2147,11,0
18884ref,7113,7423,JUNC00000223,7,-,7113,7423,255;0;0,2,150,149,0,161,7263,7274,11,0
18884ref,2698,3006,JUNC00000122,45,+,2698,3006,255;0;0,2,148,150,0,158,2846,2856,10,0
18884ref,7243,7427,JUNC00000224,19,+,7243,7427,255;0;0,2,24,150,0,34,7267,7277,10,0
18884ref,1240,1543,JUNC00000053,12,-,1240,1543,255;0;0,2,146,148,0,155,1386,1395,9,0
18884ref,4862,4991,JUNC00000170,67,+,4862,4991,255;0;0,2,73,47,0,82,4935,4944,9,0
18884ref,7986,8295,JUNC00000262,278,+,7986,8295,255;0;0,2,150,150,0,159,8136,8145,9,0
18884ref,9030,9196,JUNC00000289,8,+,9030,9196,255;0;0,2,149,8,0,158,9179,9188,9,0
18884ref,669,975,JUNC00000027,69,-,669,975,255;0;0,2,149,149,0,157,818,826,8,0
18884ref,1003,1307,JUNC00000047,124,-,1003,1307,255;0;0,2,147,149,0,155,1150,1158,8,0
18884ref,1602,1909,JUNC00000065,25,+,1602,1909,255;0;0,2,149,150,0,157,1751,1759,8,0
18884ref,1856,2066,JUNC00000074,61,+,1856,2066,255;0;0,2,148,54,0,156,2004,2012,8,0
18884ref,6944,7175,JUNC00000211,60,-,6944,7175,255;0;0,2,73,150,0,81,7017,7025,8,0
18884ref,8009,8262,JUNC00000258,50,+,8009,8262,255;0;0,2,95,150,0,103,8104,8112,8,0
18884ref,824,1126,JUNC00000034,65,+,824,1126,255;0;0,2,145,150,0,152,969,976,7,0
18884ref,1288,1472,JUNC00000057,7,-,1288,1472,255;0;0,2,150,27,0,157,1438,1445,7,0
18884ref,3015,3197,JUNC00000128,46,+,3015,3197,255;0;0,2,25,150,0,32,3040,3047,7,0
18884ref,4563,4822,JUNC00000166,15,+,4563,4822,255;0;0,2,150,102,0,157,4713,4720,7,0
18884ref,7513,7817,JUNC00000240,14,-,7513,7817,255;0;0,2,147,150,0,154,7660,7667,7,0
18884ref,7531,7835,JUNC00000245,10,+,7531,7835,255;0;0,2,147,150,0,154,7678,7685,7,0
18884ref,7541,7844,JUNC00000247,13,+,7541,7844,255;0;0,2,148,148,0,155,7689,7696,7,0
18884ref,7708,7914,JUNC00000254,3,+,7708,7914,255;0;0,2,149,50,0,156,7857,7864,7,0
18884ref,9612,9794,JUNC00000292,13,+,9612,9794,255;0;0,2,27,148,0,34,9639,9646,7,0
18884ref,796,1099,JUNC00000033,19,+,796,1099,255;0;0,2,147,150,0,153,943,949,6,0
18884ref,973,1276,JUNC00000045,9,+,973,1276,255;0;0,2,149,148,0,155,1122,1128,6,0
18884ref,2443,2748,JUNC00000108,10,+,2443,2748,255;0;0,2,150,149,0,156,2593,2599,6,0
18884ref,2698,2902,JUNC00000113,20,-,2698,2902,255;0;0,2,48,150,0,54,2746,2752,6,0
18884ref,3947,4251,JUNC00000144,4,-,3947,4251,255;0;0,2,150,148,0,156,4097,4103,6,0
18884ref,4233,4414,JUNC00000159,249,-,4233,4414,255;0;0,2,149,26,0,155,4382,4388,6,0
18884ref,5768,5941,JUNC00000183,6,+,5768,5941,255;0;0,2,19,148,0,25,5787,5793,6,0
18884ref,5729,5904,JUNC00000187,7,+,5729,5904,255;0;0,2,149,20,0,155,5878,5884,6,0
18884ref,6407,6710,JUNC00000202,14,-,6407,6710,255;0;0,2,147,150,0,153,6554,6560,6,0
18884ref,6601,6905,JUNC00000203,11,+,6601,6905,255;0;0,2,148,150,0,154,6749,6755,6,0
18884ref,7099,7373,JUNC00000220,43,+,7099,7373,255;0;0,2,122,146,0,128,7221,7227,6,0
18884ref,7117,7416,JUNC00000222,18,-,7117,7416,255;0;0,2,146,147,0,152,7263,7269,6,0
18884ref,8133,8435,JUNC00000266,2,-,8133,8435,255;0;0,2,149,147,0,155,8282,8288,6,0
18884ref,9615,9914,JUNC00000295,10,+,9615,9914,255;0;0,2,148,145,0,154,9763,9769,6,0
18884ref,622,922,JUNC00000019,22,-,622,922,255;0;0,2,148,147,0,153,770,775,5,0
18884ref,2283,2561,JUNC00000091,31,-,2283,2561,255;0;0,2,123,150,0,128,2406,2411,5,0
18884ref,4093,4158,JUNC00000148,40,-,4093,4158,255;0;0,2,40,20,0,45,4133,4138,5,0
18884ref,6616,6918,JUNC00000204,83,+,6616,6918,255;0;0,2,150,147,0,155,6766,6771,5,0
18884ref,6727,7030,JUNC00000207,122,+,6727,7030,255;0;0,2,149,149,0,154,6876,6881,5,0
18884ref,6988,7290,JUNC00000217,35,+,6988,7290,255;0;0,2,149,148,0,154,7137,7142,5,0
18884ref,7425,7646,JUNC00000237,20,-,7425,7646,255;0;0,2,148,68,0,153,7573,7578,5,0
18884ref,7725,8027,JUNC00000256,39,-,7725,8027,255;0;0,2,150,147,0,155,7875,7880,5,0
18884ref,8787,9078,JUNC00000285,2765,+,8787,9078,255;0;0,2,136,150,0,141,8923,8928,5,0
18884ref,9480,9780,JUNC00000291,36,+,9480,9780,255;0;0,2,147,148,0,152,9627,9632,5,0
16776ref2,3958,10271,JUNC00000049,322,+,3958,10271,255;0;0,2,123,116,0,6197,4081,10155,6074,0
16776ref2,4528,10266,JUNC00000057,1,-,4528,10266,255;0;0,2,27,124,0,5614,4555,10142,5587,0
16776ref2,3636,9260,JUNC00000043,555,+,3636,9260,255;0;0,2,150,145,0,5479,3786,9115,5329,0
16776ref2,3642,9254,JUNC00000044,830,+,3642,9254,255;0;0,2,150,134,0,5478,3792,9120,5328,0
16776ref2,4639,10076,JUNC00000058,2,-,4639,10076,255;0;0,2,107,44,0,5393,4746,10032,5286,0
16776ref2,7720,9078,JUNC00000085,22,-,7720,9078,255;0;0,2,120,148,0,1210,7840,8930,1090,0
16776ref2,9009,9680,JUNC00000100,6,+,9009,9680,255;0;0,2,149,141,0,530,9158,9539,381,0
16776ref2,7288,7832,JUNC00000078,2,-,7288,7832,255;0;0,2,121,147,0,397,7409,7685,276,0
16776ref2,2748,3148,JUNC00000037,1,+,2748,3148,255;0;0,2,82,69,0,331,2830,3079,249,0
16776ref2,3820,4296,JUNC00000048,74,-,3820,4296,255;0;0,2,95,150,0,326,3915,4146,231,0
16776ref2,7852,8275,JUNC00000090,1545,-,7852,8275,255;0;0,2,64,150,0,273,7916,8125,209,0
16776ref2,600,1019,JUNC00000003,60,+,600,1019,255;0;0,2,117,148,0,271,717,871,154,0
16776ref2,4518,4709,JUNC00000056,4,-,4518,4709,255;0;0,2,21,35,0,156,4539,4674,135,0
16776ref2,8696,8979,JUNC00000093,2,+,8696,8979,255;0;0,2,79,72,0,211,8775,8907,132,0
16776ref2,2344,2763,JUNC00000029,15,-,2344,2763,255;0;0,2,149,147,0,272,2493,2616,123,0
16776ref2,1893,2300,JUNC00000027,953,+,1893,2300,255;0;0,2,141,150,0,257,2034,2150,116,0
16776ref2,2365,2779,JUNC00000030,4,+,2365,2779,255;0;0,2,148,150,0,264,2513,2629,116,0
16776ref2,2434,2802,JUNC00000031,488,-,2434,2802,255;0;0,2,102,150,0,218,2536,2652,116,0
16776ref2,8649,9024,JUNC00000092,87,+,8649,9024,255;0;0,2,126,139,0,236,8775,8885,110,0
16776ref2,1122,1527,JUNC00000020,725,+,1122,1527,255;0;0,2,148,150,0,255,1270,1377,107,0
16776ref2,7288,7555,JUNC00000076,2,+,7288,7555,255;0;0,2,113,47,0,220,7401,7508,107,0
16776ref2,6968,7363,JUNC00000073,55,-,6968,7363,255;0;0,2,150,149,0,246,7118,7214,96,0
16776ref2,680,1061,JUNC00000004,74,+,680,1061,255;0;0,2,146,147,0,234,826,914,88,0
16776ref2,1805,2057,JUNC00000023,4,-,1805,2057,255;0;0,2,21,145,0,107,1826,1912,86,0
16776ref2,5784,6161,JUNC00000068,57,+,5784,6161,255;0;0,2,145,149,0,228,5929,6012,83,0
16776ref2,8782,9162,JUNC00000095,5,+,8782,9162,255;0;0,2,149,149,0,231,8931,9013,82,0
16776ref2,7338,7712,JUNC00000079,5,+,7338,7712,255;0;0,2,150,147,0,227,7488,7565,77,0
16776ref2,3761,4134,JUNC00000047,15,-,3761,4134,255;0;0,2,148,150,0,223,3909,3984,75,0
16776ref2,4991,5257,JUNC00000062,28,+,4991,5257,255;0;0,2,41,150,0,116,5032,5107,75,0
16776ref2,1777,2011,JUNC00000026,2,+,1777,2011,255;0;0,2,122,39,0,195,1899,1972,73,0
16776ref2,7259,7627,JUNC00000077,59,-,7259,7627,255;0;0,2,150,149,0,219,7409,7478,69,0
16776ref2,1763,1950,JUNC00000024,1,+,1763,1950,255;0;0,2,87,32,0,155,1850,1918,68,0
16776ref2,7361,7724,JUNC00000080,66,-,7361,7724,255;0;0,2,150,146,0,217,7511,7578,67,0
16776ref2,5020,5239,JUNC00000064,2,+,5020,5239,255;0;0,2,144,9,0,210,5164,5230,66,0
16776ref2,4359,4699,JUNC00000055,481,-,4359,4699,255;0;0,2,138,144,0,196,4497,4555,58,0
16776ref2,8377,8607,JUNC00000091,2,+,8377,8607,255;0;0,2,111,61,0,169,8488,8546,58,0
16776ref2,955,1306,JUNC00000011,785,-,955,1306,255;0;0,2,146,148,0,203,1101,1158,57,0
16776ref2,7489,7839,JUNC00000083,7,+,7489,7839,255;0;0,2,147,149,0,201,7636,7690,54,0
16776ref2,842,1172,JUNC00000008,21,+,842,1172,255;0;0,2,127,150,0,180,969,1022,53,0
16776ref2,1726,1962,JUNC00000025,4,-,1726,1962,255;0;0,2,134,50,0,186,1860,1912,52,0
16776ref2,7725,8064,JUNC00000088,36,-,7725,8064,255;0;0,2,141,148,0,191,7866,7916,50,0
16776ref2,2475,2814,JUNC00000035,16,+,2475,2814,255;0;0,2,146,144,0,195,2621,2670,49,0
16776ref2,4224,4471,JUNC00000051,23,+,4224,4471,255;0;0,2,51,148,0,99,4275,4323,48,0
16776ref2,7381,7727,JUNC00000082,4,-,7381,7727,255;0;0,2,149,149,0,197,7530,7578,48,0
16776ref2,949,1293,JUNC00000010,27,-,949,1293,255;0;0,2,150,148,0,196,1099,1145,46,0
16776ref2,696,1037,JUNC00000005,102,+,696,1037,255;0;0,2,150,147,0,194,846,890,44,0
16776ref2,2417,2757,JUNC00000032,6,-,2417,2757,255;0;0,2,149,149,0,191,2566,2608,42,0
16776ref2,7300,7573,JUNC00000075,42,-,7300,7573,255;0;0,2,81,150,0,123,7381,7423,42,0
16776ref2,2948,3145,JUNC00000039,9,+,2948,3145,255;0;0,2,8,149,0,48,2956,2996,40,0
16776ref2,8978,9212,JUNC00000099,6,+,8978,9212,255;0;0,2,52,144,0,90,9030,9068,38,0
16776ref2,1518,1854,JUNC00000021,3,+,1518,1854,255;0;0,2,150,149,0,187,1668,1705,37,0
16776ref2,1537,1872,JUNC00000022,6,+,1537,1872,255;0;0,2,149,149,0,186,1686,1723,37,0
16776ref2,7513,7817,JUNC00000084,13,+,7513,7817,255;0;0,2,147,121,0,183,7660,7696,36,0
16776ref2,1088,1293,JUNC00000013,6,+,1088,1293,255;0;0,2,23,148,0,57,1111,1145,34,0
16776ref2,5535,5780,JUNC00000065,13,-,5535,5780,255;0;0,2,65,147,0,98,5600,5633,33,0
16776ref2,8801,9133,JUNC00000096,6,+,8801,9133,255;0;0,2,150,149,0,183,8951,8984,33,0
16776ref2,963,1163,JUNC00000012,8,+,963,1163,255;0;0,2,148,21,0,179,1111,1142,31,0
16776ref2,5826,6157,JUNC00000069,5,+,5826,6157,255;0;0,2,150,150,0,181,5976,6007,31,0
16776ref2,5835,6157,JUNC00000070,7,-,5835,6157,255;0;0,2,146,145,0,177,5981,6012,31,0
16776ref2,7715,8036,JUNC00000087,36,+,7715,8036,255;0;0,2,142,148,0,173,7857,7888,31,0
16776ref2,4315,4390,JUNC00000052,1,-,4315,4390,255;0;0,2,35,10,0,65,4350,4380,30,0
16776ref2,4230,4531,JUNC00000053,33,-,4230,4531,255;0;0,2,122,149,0,152,4352,4382,30,0
16776ref2,4848,5045,JUNC00000061,3,+,4848,5045,255;0;0,2,145,23,0,174,4993,5022,29,0
16776ref2,3023,3351,JUNC00000041,393,-,3023,3351,255;0;0,2,150,150,0,178,3173,3201,28,0
16776ref2,3766,4035,JUNC00000045,40,+,3766,4035,255;0;0,2,92,149,0,120,3858,3886,28,0
16776ref2,3182,3434,JUNC00000042,41,-,3182,3434,255;0;0,2,75,150,0,102,3257,3284,27,0
16776ref2,7383,7703,JUNC00000081,7,-,7383,7703,255;0;0,2,147,147,0,173,7530,7556,26,0
16776ref2,3785,4043,JUNC00000046,495,+,3785,4043,255;0;0,2,85,149,0,109,3870,3894,24,0
16776ref2,4836,5151,JUNC00000060,15,-,4836,5151,255;0;0,2,144,149,0,166,4980,5002,22,0
16776ref2,5019,5237,JUNC00000063,34,-,5019,5237,255;0;0,2,47,150,0,68,5066,5087,21,0
16776ref2,977,1293,JUNC00000017,48,+,977,1293,255;0;0,2,150,146,0,170,1127,1147,20,0
16776ref2,824,1138,JUNC00000007,15,+,824,1138,255;0;0,2,145,150,0,164,969,988,19,0
16776ref2,2240,2556,JUNC00000028,9,+,2240,2556,255;0;0,2,148,149,0,167,2388,2407,19,0
16776ref2,8815,9131,JUNC00000097,12,+,8815,9131,255;0;0,2,150,147,0,169,8965,8984,19,0
16776ref2,4616,4933,JUNC00000059,951,+,4616,4933,255;0;0,2,149,150,0,167,4765,4783,18,0
16776ref2,6006,6175,JUNC00000072,3,-,6006,6175,255;0;0,2,120,31,0,138,6126,6144,18,0
16776ref2,534,846,JUNC00000002,3,+,534,846,255;0;0,2,147,148,0,164,681,698,17,0
16776ref2,968,1281,JUNC00000015,9,+,968,1281,255;0;0,2,148,148,0,165,1116,1133,17,0
16776ref2,2668,2879,JUNC00000036,88,-,2668,2879,255;0;0,2,148,47,0,164,2816,2832,16,0
16776ref2,2449,2763,JUNC00000034,12,+,2449,2763,255;0;0,2,149,150,0,164,2598,2613,15,0
16776ref2,5921,6231,JUNC00000071,4,-,5921,6231,255;0;0,2,145,150,0,160,6066,6081,15,0
16776ref2,4129,4418,JUNC00000050,21,+,4129,4418,255;0;0,2,128,147,0,142,4257,4271,14,0
16776ref2,5732,5935,JUNC00000066,2,+,5732,5935,255;0;0,2,109,81,0,122,5841,5854,13,0
16776ref2,830,1017,JUNC00000009,12,+,830,1017,255;0;0,2,148,29,0,158,978,988,10,0
16776ref2,2697,3006,JUNC00000038,28,+,2697,3006,255;0;0,2,149,150,0,159,2846,2856,10,0
16776ref2,8954,9144,JUNC00000098,2,+,8954,9144,255;0;0,2,34,147,0,43,8988,8997,9,0
16776ref2,1068,1271,JUNC00000014,8,+,1068,1271,255;0;0,2,46,149,0,54,1114,1122,8,0
16776ref2,1003,1216,JUNC00000019,57,-,1003,1216,255;0;0,2,147,58,0,155,1150,1158,8,0
16776ref2,824,1125,JUNC00000006,75,+,824,1125,255;0;0,2,145,149,0,152,969,976,7,0
16776ref2,4228,4531,JUNC00000054,10,-,4228,4531,255;0;0,2,147,149,0,154,4375,4382,7,0
16776ref2,7713,7940,JUNC00000086,3,+,7713,7940,255;0;0,2,144,76,0,151,7857,7864,7,0
16776ref2,666,828,JUNC00000001,38,+,666,828,255;0;0,2,8,148,0,14,674,680,6,0
16776ref2,976,1273,JUNC00000016,3,+,976,1273,255;0;0,2,146,145,0,152,1122,1128,6,0
16776ref2,2444,2746,JUNC00000033,10,+,2444,2746,255;0;0,2,149,147,0,155,2593,2599,6,0
16776ref2,5741,6031,JUNC00000067,4,+,5741,6031,255;0;0,2,137,147,0,143,5878,5884,6,0
16776ref2,1000,1301,JUNC00000018,5,-,1000,1301,255;0;0,2,150,146,0,155,1150,1155,5,0
16776ref2,2897,3127,JUNC00000040,30,+,2897,3127,255;0;0,2,75,150,0,80,2972,2977,5,0
16776ref2,6987,7271,JUNC00000074,74,+,6987,7271,255;0;0,2,150,129,0,155,7137,7142,5,0
16776ref2,7725,7976,JUNC00000089,12,-,7725,7976,255;0;0,2,150,96,0,155,7875,7880,5,0
16776ref2,8795,9078,JUNC00000094,2611,+,8795,9078,255;0;0,2,128,150,0,133,8923,8928,5,0
18366ref2,137,534,JUNC00000001,5,-,137,534,255;0;0,2,94,150,0,247,231,384,153,0
18366ref2,184,614,JUNC00000002,29,+,184,614,255;0;0,2,147,148,0,282,331,466,135,0
18366ref2,533,1018,JUNC00000003,47,-,533,1018,255;0;0,2,10,143,0,342,543,875,332,0
18366ref2,531,768,JUNC00000004,90,+,531,768,255;0;0,2,21,149,0,88,552,619,67,0
18366ref2,480,834,JUNC00000005,33,+,480,834,255;0;0,2,147,148,0,206,627,686,59,0
18366ref2,596,878,JUNC00000006,27,+,596,878,255;0;0,2,60,148,0,134,656,730,74,0
18366ref2,641,824,JUNC00000007,272,+,641,824,255;0;0,2,26,150,0,33,667,674,7,0
18366ref2,615,878,JUNC00000008,28,+,615,878,255;0;0,2,59,148,0,115,674,730,56,0
18366ref2,650,851,JUNC00000009,310,+,650,851,255;0;0,2,26,150,0,51,676,701,25,0
18366ref2,706,1012,JUNC00000010,17,+,706,1012,255;0;0,2,24,148,0,158,730,864,134,0
18366ref2,591,1024,JUNC00000011,8,+,591,1024,255;0;0,2,147,146,0,287,738,878,140,0
18366ref2,619,1074,JUNC00000012,86,+,619,1074,255;0;0,2,145,59,0,396,764,1015,251,0
18366ref2,764,1013,JUNC00000013,21,+,764,1013,255;0;0,2,9,147,0,102,773,866,93,0
18366ref2,701,1026,JUNC00000014,88,-,701,1026,255;0;0,2,84,148,0,177,785,878,93,0
18366ref2,647,982,JUNC00000015,70,+,647,982,255;0;0,2,148,150,0,185,795,832,37,0
18366ref2,755,976,JUNC00000016,71,+,755,976,255;0;0,2,49,150,0,71,804,826,22,0
18366ref2,700,1065,JUNC00000017,3,+,700,1065,255;0;0,2,149,149,0,216,849,916,67,0
18366ref2,722,8595,JUNC00000018,93,-,722,8595,255;0;0,2,138,115,0,7758,860,8480,7620,0
18366ref2,729,1058,JUNC00000019,14,+,729,1058,255;0;0,2,149,148,0,181,878,910,32,0
18366ref2,882,1085,JUNC00000020,11,+,882,1085,255;0;0,2,48,150,0,53,930,935,5,0
18366ref2,823,1125,JUNC00000021,29,+,823,1125,255;0;0,2,146,149,0,153,969,976,7,0
18366ref2,823,1148,JUNC00000022,9,+,823,1148,255;0;0,2,146,126,0,199,969,1022,53,0
18366ref2,871,1200,JUNC00000023,3,+,871,1200,255;0;0,2,144,145,0,184,1015,1055,40,0
18366ref2,955,1227,JUNC00000024,1171,-,955,1227,255;0;0,2,146,69,0,203,1101,1158,57,0
18366ref2,975,1225,JUNC00000025,6,+,975,1225,255;0;0,2,147,78,0,172,1122,1147,25,0
18366ref2,978,1297,JUNC00000026,36,+,978,1297,255;0;0,2,149,150,0,169,1127,1147,20,0
18366ref2,1003,1301,JUNC00000027,145,-,1003,1301,255;0;0,2,147,143,0,155,1150,1158,8,0
18366ref2,1075,1755,JUNC00000028,35,+,1075,1755,255;0;0,2,149,149,0,531,1224,1606,382,0
18366ref2,1293,1791,JUNC00000029,613,+,1293,1791,255;0;0,2,150,148,0,350,1443,1643,200,0
18366ref2,1315,1709,JUNC00000030,686,+,1315,1709,255;0;0,2,150,144,0,250,1465,1565,100,0
18366ref2,1442,1739,JUNC00000031,45,-,1442,1739,255;0;0,2,107,148,0,149,1549,1591,42,0
18366ref2,1573,1763,JUNC00000032,22,-,1573,1763,255;0;0,2,8,148,0,42,1581,1615,34,0
18366ref2,1642,1826,JUNC00000033,11,+,1642,1826,255;0;0,2,26,146,0,38,1668,1680,12,0
18366ref2,1638,1999,JUNC00000034,1,+,1638,1999,255;0;0,2,75,76,0,285,1713,1923,210,0
18366ref2,1712,1925,JUNC00000035,198,+,1712,1925,255;0;0,2,39,148,0,65,1751,1777,26,0
18366ref2,1777,2041,JUNC00000036,16,+,1777,2041,255;0;0,2,47,149,0,115,1824,1892,68,0
18366ref2,1740,1959,JUNC00000037,1,+,1740,1959,255;0;0,2,98,53,0,166,1838,1906,68,0
18366ref2,1859,2081,JUNC00000038,22,+,1859,2081,255;0;0,2,145,69,0,153,2004,2012,8,0
18366ref2,1924,2295,JUNC00000039,218,+,1924,2295,255;0;0,2,110,145,0,226,2034,2150,116,0
18366ref2,2216,2473,JUNC00000040,3,+,2216,2473,255;0;0,2,9,146,0,111,2225,2327,102,0
18366ref2,2163,2989,JUNC00000041,37,+,2163,2989,255;0;0,2,147,149,0,677,2310,2840,530,0
18366ref2,2269,2630,JUNC00000042,207,+,2269,2630,255;0;0,2,58,129,0,232,2327,2501,174,0
18366ref2,2239,2665,JUNC00000043,41,-,2239,2665,255;0;0,2,149,150,0,276,2388,2515,127,0
18366ref2,2344,2799,JUNC00000044,72,+,2344,2799,255;0;0,2,49,147,0,308,2393,2652,259,0
18366ref2,2333,2860,JUNC00000045,231,+,2333,2860,255;0;0,2,85,145,0,382,2418,2715,297,0
18366ref2,2305,2613,JUNC00000046,2,-,2305,2613,255;0;0,2,128,149,0,159,2433,2464,31,0
18366ref2,2314,2644,JUNC00000047,9,+,2314,2644,255;0;0,2,148,147,0,183,2462,2497,35,0
18366ref2,2443,2755,JUNC00000048,16,+,2443,2755,255;0;0,2,24,149,0,163,2467,2606,139,0
18366ref2,2344,2756,JUNC00000049,4,+,2344,2756,255;0;0,2,149,150,0,262,2493,2606,113,0
18366ref2,2393,2784,JUNC00000050,11,+,2393,2784,255;0;0,2,126,132,0,259,2519,2652,133,0
18366ref2,2435,2761,JUNC00000051,2,+,2435,2761,255;0;0,2,149,148,0,178,2584,2613,29,0
18366ref2,2545,2779,JUNC00000052,5,+,2545,2779,255;0;0,2,44,150,0,84,2589,2629,40,0
18366ref2,2449,2763,JUNC00000053,9,+,2449,2763,255;0;0,2,149,150,0,164,2598,2613,15,0
18366ref2,2449,2781,JUNC00000054,66,-,2449,2781,255;0;0,2,149,148,0,184,2598,2633,35,0
18366ref2,2590,2799,JUNC00000055,2,+,2590,2799,255;0;0,2,24,147,0,62,2614,2652,38,0
18366ref2,2528,2813,JUNC00000056,12,-,2528,2813,255;0;0,2,93,146,0,139,2621,2667,46,0
18366ref2,2629,2833,JUNC00000057,11,-,2629,2833,255;0;0,2,46,146,0,58,2675,2687,12,0
18366ref2,2689,2988,JUNC00000058,21,+,2689,2988,255;0;0,2,8,148,0,151,2697,2840,143,0
18366ref2,2748,2989,JUNC00000059,20,+,2748,2989,255;0;0,2,58,149,0,92,2806,2840,34,0
18366ref2,2715,2989,JUNC00000060,7,+,2715,2989,255;0;0,2,112,149,0,125,2827,2840,13,0
18366ref2,2680,3005,JUNC00000061,7,+,2680,3005,255;0;0,2,147,149,0,176,2827,2856,29,0
18366ref2,2699,3006,JUNC00000062,16,+,2699,3006,255;0;0,2,147,150,0,157,2846,2856,10,0
18366ref2,2698,3009,JUNC00000063,7,+,2698,3009,255;0;0,2,148,147,0,164,2846,2862,16,0
18366ref2,2698,3027,JUNC00000064,7,+,2698,3027,255;0;0,2,150,143,0,186,2848,2884,36,0
18366ref2,2698,3126,JUNC00000065,10,+,2698,3126,255;0;0,2,150,146,0,282,2848,2980,132,0
18366ref2,2715,2976,JUNC00000066,23,+,2715,2976,255;0;0,2,150,95,0,166,2865,2881,16,0
18366ref2,2843,3115,JUNC00000067,42,+,2843,3115,255;0;0,2,76,147,0,125,2919,2968,49,0
18366ref2,2948,3188,JUNC00000068,23,-,2948,3188,255;0;0,2,8,146,0,94,2956,3042,86,0
18366ref2,2953,3215,JUNC00000069,86,-,2953,3215,255;0;0,2,83,150,0,112,3036,3065,29,0
18366ref2,3023,3265,JUNC00000070,240,-,3023,3265,255;0;0,2,150,64,0,178,3173,3201,28,0
18366ref2,3072,3363,JUNC00000071,3,-,3072,3363,255;0;0,2,149,94,0,197,3221,3269,48,0
18366ref2,3179,3434,JUNC00000072,14,-,3179,3434,255;0;0,2,78,150,0,105,3257,3284,27,0
18366ref2,3624,4334,JUNC00000073,96,+,3624,4334,255;0;0,2,30,147,0,563,3654,4187,533,0
18366ref2,3753,3965,JUNC00000074,17,+,3753,3965,255;0;0,2,8,147,0,65,3761,3818,57,0
18366ref2,3722,3988,JUNC00000075,7,+,3722,3988,255;0;0,2,58,150,0,116,3780,3838,58,0
18366ref2,3793,4131,JUNC00000076,3,-,3793,4131,255;0;0,2,54,147,0,191,3847,3984,137,0
18366ref2,3854,6295,JUNC00000077,682,+,3854,6295,255;0;0,2,48,114,0,2327,3902,6181,2279,0
18366ref2,3901,4165,JUNC00000078,97,-,3901,4165,255;0;0,2,8,150,0,114,3909,4015,106,0
18366ref2,3903,4014,JUNC00000079,2,+,3903,4014,255;0;0,2,18,25,0,86,3921,3989,68,0
18366ref2,3827,4177,JUNC00000080,16,-,3827,4177,255;0;0,2,148,150,0,200,3975,4027,52,0
18366ref2,3994,4244,JUNC00000081,51,+,3994,4244,255;0;0,2,31,141,0,109,4025,4103,78,0
18366ref2,3961,4390,JUNC00000082,22,-,3961,4390,255;0;0,2,148,150,0,279,4109,4240,131,0
18366ref2,4039,4473,JUNC00000083,10,+,4039,4473,255;0;0,2,81,150,0,284,4120,4323,203,0
18366ref2,4113,4225,JUNC00000084,53,+,4113,4225,255;0;0,2,23,38,0,74,4136,4187,51,0
18366ref2,4108,4417,JUNC00000085,9,+,4108,4417,255;0;0,2,149,146,0,163,4257,4271,14,0
18366ref2,4130,4471,JUNC00000086,25,+,4130,4471,255;0;0,2,145,148,0,193,4275,4323,48,0
18366ref2,4246,4564,JUNC00000087,9,-,4246,4564,255;0;0,2,54,150,0,168,4300,4414,114,0
18366ref2,4254,4459,JUNC00000088,23,+,4254,4459,255;0;0,2,51,149,0,56,4305,4310,5,0
18366ref2,4296,4531,JUNC00000089,62,-,4296,4531,255;0;0,2,56,149,0,86,4352,4382,30,0
18366ref2,4226,4546,JUNC00000090,31,+,4226,4546,255;0;0,2,149,141,0,179,4375,4405,30,0
18366ref2,4325,4647,JUNC00000091,20,+,4325,4647,255;0;0,2,145,150,0,172,4470,4497,27,0
18366ref2,4359,4662,JUNC00000092,1109,-,4359,4662,255;0;0,2,138,107,0,196,4497,4555,58,0
18366ref2,4507,4755,JUNC00000093,1,+,4507,4755,255;0;0,2,22,100,0,148,4529,4655,126,0
18366ref2,4481,4751,JUNC00000094,25,-,4481,4751,255;0;0,2,51,84,0,186,4532,4667,135,0
18366ref2,4398,4814,JUNC00000095,22,-,4398,4814,255;0;0,2,141,140,0,276,4539,4674,135,0
18366ref2,4617,4927,JUNC00000096,73,+,4617,4927,255;0;0,2,148,144,0,166,4765,4783,18,0
18366ref2,4629,4928,JUNC00000097,185,+,4629,4928,255;0;0,2,136,124,0,175,4765,4804,39,0
18366ref2,4815,5127,JUNC00000098,25,-,4815,5127,255;0;0,2,107,150,0,162,4922,4977,55,0
18366ref2,4886,5252,JUNC00000099,2,+,4886,5252,255;0;0,2,148,149,0,217,5034,5103,69,0
18366ref2,4899,5506,JUNC00000100,6,+,4899,5506,255;0;0,2,145,148,0,459,5044,5358,314,0
18366ref2,5451,5779,JUNC00000101,40,-,5451,5779,255;0;0,2,149,146,0,182,5600,5633,33,0
18366ref2,5546,5942,JUNC00000102,29,-,5546,5942,255;0;0,2,149,149,0,247,5695,5793,98,0
18366ref2,5758,6009,JUNC00000103,3,-,5758,6009,255;0;0,2,56,148,0,103,5814,5861,47,0
18366ref2,5729,6033,JUNC00000104,8,+,5729,6033,255;0;0,2,149,149,0,155,5878,5884,6,0
18366ref2,5935,6129,JUNC00000105,3,+,5935,6129,255;0;0,2,8,147,0,47,5943,5982,39,0
18366ref2,5856,6067,JUNC00000106,2,-,5856,6067,255;0;0,2,125,58,0,153,5981,6009,28,0
18366ref2,5873,6332,JUNC00000107,2,+,5873,6332,255;0;0,2,139,101,0,358,6012,6231,219,0
18366ref2,5955,6230,JUNC00000108,3,+,5955,6230,255;0;0,2,150,120,0,155,6105,6110,5,0
18366ref2,6153,6474,JUNC00000109,9,+,6153,6474,255;0;0,2,149,150,0,171,6302,6324,22,0
18366ref2,6483,7153,JUNC00000110,119,-,6483,7153,255;0;0,2,146,142,0,528,6629,7011,382,0
18366ref2,6647,6887,JUNC00000111,2,-,6647,6887,255;0;0,2,47,145,0,95,6694,6742,48,0
18366ref2,6867,7188,JUNC00000112,29,-,6867,7188,255;0;0,2,25,145,0,176,6892,7043,151,0
18366ref2,6894,7074,JUNC00000113,2,+,6894,7074,255;0;0,2,18,133,0,47,6912,6941,29,0
18366ref2,6832,7123,JUNC00000114,69,-,6832,7123,255;0;0,2,129,150,0,141,6961,6973,12,0
18366ref2,6991,7290,JUNC00000115,4,+,6991,7290,255;0;0,2,146,148,0,151,7137,7142,5,0
18366ref2,7131,7455,JUNC00000116,10,-,7131,7455,255;0;0,2,147,150,0,174,7278,7305,27,0
18366ref2,7342,7510,JUNC00000117,26,-,7342,7510,255;0;0,2,8,149,0,19,7350,7361,11,0
18366ref2,7473,7710,JUNC00000118,54,+,7473,7710,255;0;0,2,21,148,0,89,7494,7562,68,0
18366ref2,7423,7706,JUNC00000119,4,-,7423,7706,255;0;0,2,150,128,0,155,7573,7578,5,0
18366ref2,7596,7842,JUNC00000120,2,+,7596,7842,255;0;0,2,64,146,0,100,7660,7696,36,0
18366ref2,7660,7904,JUNC00000121,2,+,7660,7904,255;0;0,2,39,50,0,194,7699,7854,155,0
18366ref2,7556,7972,JUNC00000122,134,+,7556,7972,255;0;0,2,143,99,0,317,7699,7873,174,0
18366ref2,7705,8056,JUNC00000123,5,-,7705,8056,255;0;0,2,47,150,0,201,7752,7906,154,0
18366ref2,7766,8161,JUNC00000124,2,+,7766,8161,255;0;0,2,59,145,0,250,7825,8016,191,0
18366ref2,7829,8036,JUNC00000125,26,+,7829,8036,255;0;0,2,44,148,0,59,7873,7888,15,0
18366ref2,7907,8166,JUNC00000126,69,+,7907,8166,255;0;0,2,33,150,0,109,7940,8016,76,0
18366ref2,7963,8279,JUNC00000127,348,-,7963,8279,255;0;0,2,149,150,0,166,8112,8129,17,0
18366ref2,8239,8543,JUNC00000128,132,+,8239,8543,255;0;0,2,147,149,0,155,8386,8394,8,0
18366ref2,8283,8585,JUNC00000129,4,+,8283,8585,255;0;0,2,148,147,0,155,8431,8438,7,0
18366ref2,8290,8585,JUNC00000130,144,+,8290,8585,255;0;0,2,148,116,0,179,8438,8469,31,0
18366ref2,8438,8606,JUNC00000131,1,+,8438,8606,255;0;0,2,8,143,0,25,8446,8463,17,0
18366ref2,8413,8718,JUNC00000132,3,+,8413,8718,255;0;0,2,33,118,0,187,8446,8600,154,0
18366ref2,8708,9077,JUNC00000133,636,+,8708,9077,255;0;0,2,150,149,0,220,8858,8928,70,0
18366ref2,8827,9078,JUNC00000134,991,+,8827,9078,255;0;0,2,96,150,0,101,8923,8928,5,0
18366ref2,9078,9548,JUNC00000135,5,-,9078,9548,255;0;0,2,147,149,0,321,9225,9399,174,0
18366ref2,9094,9561,JUNC00000136,271,+,9094,9561,255;0;0,2,143,150,0,317,9237,9411,174,0
18366ref2,9477,9780,JUNC00000137,311,+,9477,9780,255;0;0,2,150,148,0,155,9627,9632,5,0
18366ref2,9576,10434,JUNC00000138,1,-,9576,10434,255;0;0,2,112,39,0,819,9688,10395,707,0
18366ref2,9690,9972,JUNC00000139,192,-,9690,9972,255;0;0,2,119,148,0,134,9809,9824,15,0
18366ref2,9832,10180,JUNC00000140,5,-,9832,10180,255;0;0,2,50,148,0,200,9882,10032,150,0
27222ref,1005,9655,JUNC00000037,70,-,1005,9655,255;0;0,2,149,110,0,8540,1154,9545,8391,0
27222ref,977,9577,JUNC00000035,8,+,977,9577,255;0;0,2,150,62,0,8538,1127,9515,8388,0
27222ref,665,9057,JUNC00000012,1,+,665,9057,255;0;0,2,9,142,0,8250,674,8915,8241,0
27222ref,974,9276,JUNC00000034,51,+,974,9276,255;0;0,2,148,146,0,8156,1122,9130,8008,0
27222ref,1053,9135,JUNC00000033,1,-,1053,9135,255;0;0,2,56,95,0,7987,1109,9040,7931,0
27222ref,993,9020,JUNC00000028,21,+,993,9020,255;0;0,2,9,143,0,7884,1002,8877,7875,0
27222ref,322,8272,JUNC00000003,104,+,322,8272,255;0;0,2,149,57,0,7893,471,8215,7744,0
27222ref,2525,10033,JUNC00000076,20,+,2525,10033,255;0;0,2,40,146,0,7362,2565,9887,7322,0
27222ref,2286,9709,JUNC00000072,371,-,2286,9709,255;0;0,2,150,148,0,7275,2436,9561,7125,0
27222ref,2388,9590,JUNC00000073,2,-,2388,9590,255;0;0,2,148,45,0,7157,2536,9545,7009,0
27222ref,939,7914,JUNC00000030,40,+,939,7914,255;0;0,2,144,41,0,6934,1083,7873,6790,0
27222ref,1855,8202,JUNC00000062,6,+,1855,8202,255;0;0,2,149,149,0,6198,2004,8053,6049,0
27222ref,4959,10426,JUNC00000123,2,+,4959,10426,255;0;0,2,41,143,0,5324,5000,10283,5283,0
27222ref,3842,9206,JUNC00000102,3,-,3842,9206,255;0;0,2,148,94,0,5270,3990,9112,5122,0
27222ref,3744,9014,JUNC00000097,1,+,3744,9014,255;0;0,2,114,37,0,5233,3858,8977,5119,0
27222ref,5162,10288,JUNC00000126,1,+,5162,10288,255;0;0,2,117,34,0,5092,5279,10254,4975,0
27222ref,1144,6255,JUNC00000039,6,+,1144,6255,255;0;0,2,126,145,0,4966,1270,6110,4840,0
27222ref,2183,6888,JUNC00000069,1,-,2183,6888,255;0;0,2,81,70,0,4635,2264,6818,4554,0
27222ref,3306,8007,JUNC00000094,549,-,3306,8007,255;0;0,2,150,91,0,4610,3456,7916,4460,0
27222ref,4685,9237,JUNC00000120,16,+,4685,9237,255;0;0,2,80,137,0,4415,4765,9100,4335,0
27222ref,759,5236,JUNC00000022,1,-,759,5236,255;0;0,2,101,50,0,4427,860,5186,4326,0
27222ref,4580,8448,JUNC00000117,1,+,4580,8448,255;0;0,2,141,10,0,3858,4721,8438,3717,0
27222ref,846,4418,JUNC00000027,7,+,846,4418,255;0;0,2,150,147,0,3425,996,4271,3275,0
27222ref,5729,9298,JUNC00000130,2,+,5729,9298,255;0;0,2,149,147,0,3422,5878,9151,3273,0
27222ref,4493,7977,JUNC00000114,2,+,4493,7977,255;0;0,2,145,83,0,3401,4638,7894,3256,0
27222ref,2698,6109,JUNC00000084,17,-,2698,6109,255;0;0,2,150,21,0,3390,2848,6088,3240,0
27222ref,2669,6073,JUNC00000082,23,-,2669,6073,255;0;0,2,147,51,0,3353,2816,6022,3206,0
27222ref,1906,5173,JUNC00000065,8,-,1906,5173,255;0;0,2,141,76,0,3191,2047,5097,3050,0
27222ref,6478,9531,JUNC00000135,1,+,6478,9531,255;0;0,2,93,47,0,3006,6571,9484,2913,0
27222ref,621,3718,JUNC00000017,147,+,621,3718,255;0;0,2,143,150,0,2947,764,3568,2804,0
27222ref,5992,8861,JUNC00000131,2,-,5992,8861,255;0;0,2,30,121,0,2748,6022,8740,2718,0
27222ref,6067,9078,JUNC00000133,198,+,6067,9078,255;0;0,2,147,150,0,2861,6214,8928,2714,0
27222ref,4715,7564,JUNC00000121,87,-,4715,7564,255;0;0,2,148,8,0,2841,4863,7556,2693,0
27222ref,3286,6105,JUNC00000093,2,-,3286,6105,255;0;0,2,146,47,0,2772,3432,6058,2626,0
27222ref,5026,7868,JUNC00000124,17,-,5026,7868,255;0;0,2,71,146,0,2696,5097,7722,2625,0
27222ref,7406,10120,JUNC00000148,31,+,7406,10120,255;0;0,2,148,129,0,2585,7554,9991,2437,0
27222ref,1963,4144,JUNC00000060,2,-,1963,4144,255;0;0,2,22,126,0,2055,1985,4018,2033,0
27222ref,7368,9158,JUNC00000142,2,+,7368,9158,255;0;0,2,126,38,0,1752,7494,9120,1626,0
27222ref,7537,9227,JUNC00000150,1,+,7537,9227,255;0;0,2,39,112,0,1578,7576,9115,1539,0
27222ref,749,2271,JUNC00000020,36,+,749,2271,255;0;0,2,77,124,0,1398,826,2147,1321,0
27222ref,1255,2610,JUNC00000040,1,-,1255,2610,255;0;0,2,34,117,0,1238,1289,2493,1204,0
27222ref,9081,10429,JUNC00000186,77,+,9081,10429,255;0;0,2,144,150,0,1198,9225,10279,1054,0
27222ref,4988,6289,JUNC00000125,2,-,4988,6289,255;0;0,2,142,145,0,1156,5130,6144,1014,0
27222ref,1455,2598,JUNC00000046,23,+,1455,2598,255;0;0,2,93,144,0,999,1548,2454,906,0
27222ref,8006,9079,JUNC00000163,3,+,8006,9079,255;0;0,2,148,69,0,1004,8154,9010,856,0
27222ref,285,1125,JUNC00000001,139,+,285,1125,255;0;0,2,150,149,0,691,435,976,541,0
27222ref,8283,9076,JUNC00000168,13,+,8283,9076,255;0;0,2,111,148,0,645,8394,8928,534,0
27222ref,2555,3251,JUNC00000080,47,+,2555,3251,255;0;0,2,115,110,0,586,2670,3141,471,0
27222ref,8354,8948,JUNC00000171,3,+,8354,8948,255;0;0,2,131,20,0,574,8485,8928,443,0
27222ref,4541,5152,JUNC00000116,3,-,4541,5152,255;0;0,2,148,24,0,587,4689,5128,439,0
27222ref,6923,7635,JUNC00000136,269,+,6923,7635,255;0;0,2,150,141,0,571,7073,7494,421,0
27222ref,4130,4740,JUNC00000106,2,-,4130,4740,255;0;0,2,120,73,0,537,4250,4667,417,0
27222ref,7985,8523,JUNC00000160,2,+,7985,8523,255;0;0,2,9,142,0,396,7994,8381,387,0
27222ref,7885,8537,JUNC00000162,235,+,7885,8537,255;0;0,2,122,143,0,509,8007,8394,387,0
27222ref,9091,9650,JUNC00000188,17,+,9091,9650,255;0;0,2,146,32,0,527,9237,9618,381,0
27222ref,3601,4270,JUNC00000095,3,-,3601,4270,255;0;0,2,149,148,0,521,3750,4122,372,0
27222ref,1741,2308,JUNC00000053,18,+,1741,2308,255;0;0,2,48,150,0,417,1789,2158,369,0
27222ref,587,1097,JUNC00000011,1,+,587,1097,255;0;0,2,69,82,0,428,656,1015,359,0
27222ref,4619,5167,JUNC00000119,2,+,4619,5167,255;0;0,2,146,54,0,494,4765,5113,348,0
27222ref,8245,8743,JUNC00000167,2,+,8245,8743,255;0;0,2,82,69,0,429,8327,8674,347,0
27222ref,1879,2483,JUNC00000063,14,+,1879,2483,255;0;0,2,149,148,0,456,2028,2335,307,0
27222ref,1376,1827,JUNC00000045,6,-,1376,1827,255;0;0,2,130,21,0,430,1506,1806,300,0
27222ref,974,1453,JUNC00000029,12,+,974,1453,255;0;0,2,41,145,0,334,1015,1308,293,0
27222ref,2042,2617,JUNC00000067,3,-,2042,2617,255;0;0,2,149,148,0,427,2191,2469,278,0
27222ref,5483,5948,JUNC00000128,2,+,5483,5948,255;0;0,2,148,61,0,404,5631,5887,256,0
27222ref,674,1083,JUNC00000016,15,+,674,1083,255;0;0,2,90,68,0,341,764,1015,251,0
27222ref,606,1101,JUNC00000013,4,-,606,1101,255;0;0,2,117,141,0,354,723,960,237,0
27222ref,8526,8923,JUNC00000174,10,+,8526,8923,255;0;0,2,148,21,0,376,8674,8902,228,0
27222ref,7633,8009,JUNC00000151,2,+,7633,8009,255;0;0,2,27,124,0,252,7660,7885,225,0
27222ref,2434,2948,JUNC00000077,8,+,2434,2948,255;0;0,2,150,148,0,366,2584,2800,216,0
27222ref,7552,7957,JUNC00000155,3,+,7552,7957,255;0;0,2,147,69,0,336,7699,7888,189,0
27222ref,1925,2330,JUNC00000061,2,+,1925,2330,255;0;0,2,70,148,0,257,1995,2182,187,0
27222ref,622,1099,JUNC00000018,161,-,622,1099,255;0;0,2,148,146,0,331,770,953,183,0
27222ref,7214,7583,JUNC00000138,5,-,7214,7583,255;0;0,2,47,148,0,221,7261,7435,174,0
27222ref,7566,8000,JUNC00000154,16,+,7566,8000,255;0;0,2,133,127,0,307,7699,7873,174,0
27222ref,9094,9465,JUNC00000187,118,+,9094,9465,255;0;0,2,143,54,0,317,9237,9411,174,0
27222ref,1819,2138,JUNC00000057,1,+,1819,2138,255;0;0,2,80,71,0,248,1899,2067,168,0
27222ref,7554,7906,JUNC00000153,12,+,7554,7906,255;0;0,2,145,39,0,313,7699,7867,168,0
27222ref,377,833,JUNC00000004,2,+,377,833,255;0;0,2,149,145,0,311,526,688,162,0
27222ref,8773,9233,JUNC00000177,2273,+,8773,9233,255;0;0,2,148,150,0,310,8921,9083,162,0
27222ref,379,837,JUNC00000005,9,+,379,837,255;0;0,2,149,149,0,309,528,688,160,0
27222ref,514,837,JUNC00000007,15,+,514,837,255;0;0,2,20,143,0,180,534,694,160,0
27222ref,1559,1993,JUNC00000048,4,+,1559,1993,255;0;0,2,127,147,0,287,1686,1846,160,0
27222ref,578,960,JUNC00000010,35,+,578,960,255;0;0,2,78,148,0,234,656,812,156,0
27222ref,2420,2755,JUNC00000075,8,+,2420,2755,255;0;0,2,145,36,0,299,2565,2719,154,0
27222ref,2817,3179,JUNC00000086,24,-,2817,3179,255;0;0,2,150,71,0,291,2967,3108,141,0
27222ref,7852,8287,JUNC00000161,2,-,7852,8287,255;0;0,2,150,146,0,289,8002,8141,139,0
27222ref,1263,1626,JUNC00000043,29,+,1263,1626,255;0;0,2,148,78,0,285,1411,1548,137,0
27222ref,4513,4733,JUNC00000112,7,-,4513,4733,255;0;0,2,19,66,0,154,4532,4667,135,0
27222ref,4405,4732,JUNC00000113,11,-,4405,4732,255;0;0,2,134,58,0,269,4539,4674,135,0
27222ref,9194,9511,JUNC00000189,14,+,9194,9511,255;0;0,2,148,35,0,282,9342,9476,134,0
27222ref,3994,4278,JUNC00000105,15,-,3994,4278,255;0;0,2,113,38,0,246,4107,4240,133,0
27222ref,3912,4331,JUNC00000103,23,+,3912,4331,255;0;0,2,147,148,0,271,4059,4183,124,0
27222ref,494,767,JUNC00000008,3,+,494,767,255;0;0,2,58,93,0,180,552,674,122,0
27222ref,454,827,JUNC00000009,4,-,454,827,255;0;0,2,104,147,0,226,558,680,122,0
27222ref,9775,10045,JUNC00000193,2,-,9775,10045,255;0;0,2,107,44,0,226,9882,10001,119,0
27222ref,1889,2220,JUNC00000064,201,+,1889,2220,255;0;0,2,145,70,0,261,2034,2150,116,0
27222ref,4183,4493,JUNC00000108,33,+,4183,4493,255;0;0,2,140,58,0,252,4323,4435,112,0
27222ref,721,981,JUNC00000019,1,+,721,981,255;0;0,2,62,89,0,171,783,892,109,0
27222ref,8209,8380,JUNC00000165,2,+,8209,8380,255;0;0,2,49,19,0,152,8258,8361,103,0
27222ref,2214,2386,JUNC00000068,1,+,2214,2386,255;0;0,2,11,59,0,113,2225,2327,102,0
27222ref,8928,9242,JUNC00000180,9,+,8928,9242,255;0;0,2,65,148,0,166,8993,9094,101,0
27222ref,9765,10017,JUNC00000192,2,-,9765,10017,255;0;0,2,117,34,0,218,9882,9983,101,0
27222ref,2356,2477,JUNC00000070,2,-,2356,2477,255;0;0,2,8,13,0,108,2364,2464,100,0
27222ref,7278,7532,JUNC00000139,116,-,7278,7532,255;0;0,2,9,147,0,107,7287,7385,98,0
27222ref,8928,9237,JUNC00000182,6,+,8928,9237,255;0;0,2,74,137,0,172,9002,9100,98,0
27222ref,7819,8158,JUNC00000159,5,+,7819,8158,255;0;0,2,143,99,0,240,7962,8059,97,0
27222ref,1121,1367,JUNC00000038,2,+,1121,1367,255;0;0,2,122,29,0,217,1243,1338,95,0
27222ref,2394,2782,JUNC00000074,139,-,2394,2782,255;0;0,2,150,146,0,242,2544,2636,92,0
27222ref,1639,2024,JUNC00000052,2,+,1639,2024,255;0;0,2,148,148,0,237,1787,1876,89,0
27222ref,1740,2052,JUNC00000054,15,-,1740,2052,255;0;0,2,86,140,0,172,1826,1912,86,0
27222ref,419,763,JUNC00000006,5,+,419,763,255;0;0,2,115,144,0,200,534,619,85,0
27222ref,8890,9144,JUNC00000176,496,+,8890,9144,255;0;0,2,25,147,0,107,8915,8997,82,0
27222ref,9377,9609,JUNC00000190,1,+,9377,9609,255;0;0,2,129,22,0,210,9506,9587,81,0
27222ref,3760,4138,JUNC00000100,8,-,3760,4138,255;0;0,2,149,149,0,229,3909,3989,80,0
27222ref,3772,4046,JUNC00000099,2,+,3772,4046,255;0;0,2,130,70,0,204,3902,3976,74,0
27222ref,8759,9131,JUNC00000175,12,+,8759,9131,255;0;0,2,149,150,0,222,8908,8981,73,0
27222ref,10242,10466,JUNC00000196,2,+,10242,10466,255;0;0,2,66,85,0,139,10308,10381,73,0
27222ref,8156,8390,JUNC00000164,17,+,8156,8390,255;0;0,2,94,69,0,165,8250,8321,71,0
27222ref,1645,1865,JUNC00000051,1,-,1645,1865,255;0;0,2,124,27,0,193,1769,1838,69,0
27222ref,7808,8029,JUNC00000157,3,+,7808,8029,255;0;0,2,8,144,0,77,7816,7885,69,0
27222ref,1723,2066,JUNC00000055,8,+,1723,2066,255;0;0,2,127,148,0,195,1850,1918,68,0
27222ref,7362,7724,JUNC00000144,263,-,7362,7724,255;0;0,2,149,146,0,216,7511,7578,67,0
27222ref,7347,7577,JUNC00000141,11,+,7347,7577,255;0;0,2,147,17,0,213,7494,7560,66,0
27222ref,2784,3136,JUNC00000085,9,+,2784,3136,255;0;0,2,140,147,0,205,2924,2989,65,0
27222ref,3770,4130,JUNC00000101,2,-,3770,4130,255;0;0,2,149,146,0,214,3919,3984,65,0
27222ref,964,1314,JUNC00000032,2,-,964,1314,255;0;0,2,137,149,0,201,1101,1165,64,0
27222ref,8526,8882,JUNC00000173,3,+,8526,8882,255;0;0,2,148,146,0,210,8674,8736,62,0
27222ref,1393,1628,JUNC00000044,2,+,1393,1628,255;0;0,2,111,63,0,172,1504,1565,61,0
27222ref,2890,3105,JUNC00000088,6,-,2890,3105,255;0;0,2,146,8,0,207,3036,3097,61,0
27222ref,2939,3151,JUNC00000089,1,+,2939,3151,255;0;0,2,108,43,0,169,3047,3108,61,0
27222ref,4386,4700,JUNC00000111,14,-,4386,4700,255;0;0,2,111,145,0,169,4497,4555,58,0
27222ref,8439,8644,JUNC00000172,1,+,8439,8644,255;0;0,2,49,98,0,107,8488,8546,58,0
27222ref,953,1285,JUNC00000031,1284,-,953,1285,255;0;0,2,148,127,0,205,1101,1158,57,0
27222ref,1623,1957,JUNC00000050,4,-,1623,1957,255;0;0,2,146,131,0,203,1769,1826,57,0
27222ref,8815,9148,JUNC00000179,11,+,8815,9148,255;0;0,2,150,126,0,207,8965,9022,57,0
27222ref,4033,4159,JUNC00000104,1,+,4033,4159,255;0;0,2,42,29,0,97,4075,4130,55,0
27222ref,9033,9278,JUNC00000183,4,-,9033,9278,255;0;0,2,45,146,0,99,9078,9132,54,0
27222ref,825,1171,JUNC00000026,57,+,825,1171,255;0;0,2,144,149,0,197,969,1022,53,0
27222ref,2884,3235,JUNC00000087,3,+,2884,3235,255;0;0,2,149,149,0,202,3033,3086,53,0
27222ref,5645,5848,JUNC00000129,1,+,5645,5848,255;0;0,2,103,48,0,155,5748,5800,52,0
27222ref,1896,2097,JUNC00000058,1,+,1896,2097,255;0;0,2,76,75,0,126,1972,2022,50,0
27222ref,2477,2763,JUNC00000079,7,+,2477,2763,255;0;0,2,144,93,0,193,2621,2670,49,0
27222ref,7317,7516,JUNC00000140,2,+,7317,7516,255;0;0,2,68,83,0,116,7385,7433,48,0
27222ref,8294,8639,JUNC00000170,2,+,8294,8639,255;0;0,2,150,147,0,198,8444,8492,48,0
27222ref,3681,3977,JUNC00000096,6,+,3681,3977,255;0;0,2,105,146,0,150,3786,3831,45,0
27222ref,7491,7687,JUNC00000143,1,-,7491,7687,255;0;0,2,20,131,0,65,7511,7556,45,0
27222ref,718,892,JUNC00000015,1,-,718,892,255;0;0,2,26,107,0,67,744,785,41,0
27222ref,701,1039,JUNC00000021,3,+,701,1039,255;0;0,2,148,149,0,189,849,890,41,0
27222ref,3051,3386,JUNC00000091,1793,+,3051,3386,255;0;0,2,145,150,0,185,3196,3236,40,0
27222ref,8294,8485,JUNC00000166,1,+,8294,8485,255;0;0,2,27,124,0,67,8321,8361,40,0
27222ref,2238,2572,JUNC00000071,17,-,2238,2572,255;0;0,2,150,148,0,186,2388,2424,36,0
27222ref,9831,10130,JUNC00000194,2,-,9831,10130,255;0;0,2,119,144,0,155,9950,9986,36,0
27222ref,730,1058,JUNC00000023,3,+,730,1058,255;0;0,2,148,148,0,180,878,910,32,0
27222ref,7625,7807,JUNC00000156,1,+,7625,7807,255;0;0,2,116,35,0,147,7741,7772,31,0
27222ref,4224,4405,JUNC00000109,1,-,4224,4405,255;0;0,2,128,23,0,158,4352,4382,30,0
27222ref,5594,5774,JUNC00000127,13,-,5594,5774,255;0;0,2,10,141,0,39,5604,5633,29,0
27222ref,6106,6433,JUNC00000134,10,+,6106,6433,255;0;0,2,149,149,0,178,6255,6284,29,0
27222ref,7385,7617,JUNC00000145,44,-,7385,7617,255;0;0,2,142,61,0,171,7527,7556,29,0
27222ref,3207,3434,JUNC00000092,1307,-,3207,3434,255;0;0,2,50,150,0,77,3257,3284,27,0
27222ref,1727,1927,JUNC00000049,14,+,1727,1927,255;0;0,2,24,150,0,50,1751,1777,26,0
27222ref,3764,4041,JUNC00000098,3,+,3764,4041,255;0;0,2,106,147,0,130,3870,3894,24,0
27222ref,1991,2308,JUNC00000066,4,+,1991,2308,255;0;0,2,147,147,0,170,2138,2161,23,0
27222ref,7391,7710,JUNC00000146,5,+,7391,7710,255;0;0,2,148,148,0,171,7539,7562,23,0
27222ref,4882,5151,JUNC00000122,41,-,4882,5151,255;0;0,2,98,149,0,120,4980,5002,22,0
27222ref,8994,9173,JUNC00000181,3687,+,8994,9173,255;0;0,2,8,149,0,30,9002,9024,22,0
27222ref,7498,7669,JUNC00000147,1,+,7498,7669,255;0;0,2,44,107,0,64,7542,7562,20,0
27222ref,4655,4824,JUNC00000118,1,+,4655,4824,255;0;0,2,110,41,0,128,4765,4783,18,0
27222ref,9025,9340,JUNC00000185,3,+,9025,9340,255;0;0,2,149,149,0,166,9174,9191,17,0
27222ref,2668,2857,JUNC00000081,12,-,2668,2857,255;0;0,2,148,25,0,164,2816,2832,16,0
27222ref,9014,9326,JUNC00000184,8,+,9014,9326,255;0;0,2,148,148,0,164,9162,9178,16,0
27222ref,2448,2761,JUNC00000078,33,+,2448,2761,255;0;0,2,150,148,0,165,2598,2613,15,0
27222ref,5994,6231,JUNC00000132,20,-,5994,6231,255;0;0,2,72,150,0,87,6066,6081,15,0
27222ref,4136,4418,JUNC00000107,20,+,4136,4418,255;0;0,2,121,147,0,135,4257,4271,14,0
27222ref,4550,4715,JUNC00000115,1,+,4550,4715,255;0;0,2,115,36,0,129,4665,4679,14,0
27222ref,8294,8607,JUNC00000169,4,+,8294,8607,255;0;0,2,150,149,0,164,8444,8458,14,0
27222ref,773,1085,JUNC00000024,18,-,773,1085,255;0;0,2,149,150,0,162,922,935,13,0
27222ref,1456,1626,JUNC00000047,112,+,1456,1626,255;0;0,2,149,8,0,162,1605,1618,13,0
27222ref,2677,2979,JUNC00000083,2,-,2677,2979,255;0;0,2,143,147,0,155,2820,2832,12,0
27222ref,2993,3106,JUNC00000090,1,-,2993,3106,255;0;0,2,93,9,0,104,3086,3097,11,0
27222ref,304,471,JUNC00000002,13,+,304,471,255;0;0,2,150,8,0,159,454,463,9,0
27222ref,1238,1544,JUNC00000041,10,-,1238,1544,255;0;0,2,148,149,0,157,1386,1395,9,0
27222ref,1827,2009,JUNC00000059,2,-,1827,2009,255;0;0,2,150,23,0,159,1977,1986,9,0
27222ref,689,850,JUNC00000014,2,-,689,850,255;0;0,2,43,110,0,51,732,740,8,0
27222ref,1001,1259,JUNC00000036,1555,-,1001,1259,255;0;0,2,149,101,0,157,1150,1158,8,0
27222ref,824,1126,JUNC00000025,358,+,824,1126,255;0;0,2,145,150,0,152,969,976,7,0
27222ref,7540,7845,JUNC00000152,9,+,7540,7845,255;0;0,2,149,149,0,156,7689,7696,7,0
27222ref,7718,7891,JUNC00000158,10,+,7718,7891,255;0;0,2,148,18,0,155,7866,7873,7,0
27222ref,1749,2014,JUNC00000056,14,+,1749,2014,255;0;0,2,111,148,0,117,1860,1866,6,0
27222ref,4323,4480,JUNC00000110,1,-,4323,4480,255;0;0,2,143,8,0,149,4466,4472,6,0
27222ref,9803,10107,JUNC00000195,4,-,9803,10107,255;0;0,2,150,148,0,156,9953,9959,6,0
27222ref,1262,1512,JUNC00000042,14,+,1262,1512,255;0;0,2,149,96,0,154,1411,1416,5,0
27222ref,6990,7240,JUNC00000137,25,+,6990,7240,255;0;0,2,147,98,0,152,7137,7142,5,0
27222ref,7427,7724,JUNC00000149,8,-,7427,7724,255;0;0,2,146,146,0,151,7573,7578,5,0
27222ref,8779,9078,JUNC00000178,41331,+,8779,9078,255;0;0,2,144,150,0,149,8923,8928,5,0
27222ref,9478,9779,JUNC00000191,3,+,9478,9779,255;0;0,2,149,147,0,154,9627,9632,5,0
16747ref1,823,1099,JUNC00000001,170,+,823,1099,255;0;0,2,120,150,0,126,943,949,6,0
16747ref1,824,1126,JUNC00000002,264,+,824,1126,255;0;0,2,145,150,0,152,969,976,7,0
16747ref1,951,1308,JUNC00000003,610,-,951,1308,255;0;0,2,150,150,0,207,1101,1158,57,0
16747ref1,974,1275,JUNC00000004,2,+,974,1275,255;0;0,2,148,147,0,154,1122,1128,6,0
16747ref1,1071,1537,JUNC00000005,165,+,1071,1537,255;0;0,2,51,150,0,316,1122,1387,265,0
16747ref1,1001,1308,JUNC00000006,76,-,1001,1308,255;0;0,2,149,150,0,157,1150,1158,8,0
16747ref1,1217,1439,JUNC00000007,16,-,1217,1439,255;0;0,2,150,9,0,213,1367,1430,63,0
16747ref1,1642,1973,JUNC00000008,3,-,1642,1973,255;0;0,2,109,147,0,184,1751,1826,75,0
16747ref1,1790,2062,JUNC00000009,291,-,1790,2062,255;0;0,2,36,150,0,122,1826,1912,86,0
16747ref1,2238,6375,JUNC00000010,76,+,2238,6375,255;0;0,2,150,150,0,3987,2388,6225,3837,0
16747ref1,2532,2800,JUNC00000011,1,+,2532,2800,255;0;0,2,46,105,0,163,2578,2695,117,0
16747ref1,2435,2755,JUNC00000012,34,+,2435,2755,255;0;0,2,149,149,0,171,2584,2606,22,0
16747ref1,2448,2763,JUNC00000013,3,+,2448,2763,255;0;0,2,150,150,0,165,2598,2613,15,0
16747ref1,2698,3055,JUNC00000014,10,+,2698,3055,255;0;0,2,150,150,0,207,2848,2905,57,0
16747ref1,2898,3091,JUNC00000015,4,+,2898,3091,255;0;0,2,21,123,0,70,2919,2968,49,0
16747ref1,3023,3210,JUNC00000016,76,+,3023,3210,255;0;0,2,148,14,0,173,3171,3196,25,0
16747ref1,3234,3434,JUNC00000017,58,-,3234,3434,255;0;0,2,23,150,0,50,3257,3284,27,0
16747ref1,3241,3416,JUNC00000018,2,+,3241,3416,255;0;0,2,121,45,0,130,3362,3371,9,0
16747ref1,4249,4418,JUNC00000019,13,+,4249,4418,255;0;0,2,8,147,0,22,4257,4271,14,0
16747ref1,4206,4564,JUNC00000020,5,+,4206,4564,255;0;0,2,150,150,0,208,4356,4414,58,0
16747ref1,4244,4568,JUNC00000021,8,+,4244,4568,255;0;0,2,149,150,0,174,4393,4418,25,0
16747ref1,4264,4568,JUNC00000022,2235,-,4264,4568,255;0;0,2,149,150,0,154,4413,4418,5,0
16747ref1,4424,4673,JUNC00000023,132,-,4424,4673,255;0;0,2,73,118,0,131,4497,4555,58,0
16747ref1,4418,4824,JUNC00000024,130,-,4418,4824,255;0;0,2,121,150,0,256,4539,4674,135,0
16747ref1,4552,4730,JUNC00000025,1,-,4552,4730,255;0;0,2,122,29,0,149,4674,4701,27,0
16747ref1,4848,5171,JUNC00000026,8,+,4848,5171,255;0;0,2,145,149,0,174,4993,5022,29,0
16747ref1,5570,5777,JUNC00000027,44,-,5570,5777,255;0;0,2,34,149,0,58,5604,5628,24,0
16747ref1,5586,5925,JUNC00000028,464,+,5586,5925,255;0;0,2,150,150,0,189,5736,5775,39,0
16747ref1,6025,6467,JUNC00000029,36,+,6025,6467,255;0;0,2,149,150,0,292,6174,6317,143,0
16747ref1,6070,6375,JUNC00000030,11,+,6070,6375,255;0;0,2,149,150,0,155,6219,6225,6,0
16747ref1,6414,6743,JUNC00000031,210,-,6414,6743,255;0;0,2,150,150,0,179,6564,6593,29,0
16747ref1,6871,7699,JUNC00000032,2,-,6871,7699,255;0;0,2,54,143,0,685,6925,7556,631,0
16747ref1,7427,7749,JUNC00000033,1,-,7427,7749,255;0;0,2,9,122,0,200,7436,7627,191,0
16747ref1,7451,7607,JUNC00000034,9,-,7451,7607,255;0;0,2,122,29,0,127,7573,7578,5,0
16747ref1,7510,7816,JUNC00000035,17,-,7510,7816,255;0;0,2,150,149,0,157,7660,7667,7,0
16747ref1,7579,7939,JUNC00000036,12,+,7579,7939,255;0;0,2,149,150,0,210,7728,7789,61,0
16747ref1,7699,8041,JUNC00000037,37,-,7699,8041,255;0;0,2,149,150,0,192,7848,7891,43,0
16747ref1,7737,8013,JUNC00000038,3,+,7737,8013,255;0;0,2,120,149,0,127,7857,7864,7,0
16747ref1,7712,7875,JUNC00000039,7,+,7712,7875,255;0;0,2,145,8,0,155,7857,7867,10,0
16747ref1,8338,8610,JUNC00000040,528,+,8338,8610,255;0;0,2,150,64,0,208,8488,8546,58,0
16747ref1,8368,8695,JUNC00000041,419,+,8368,8695,255;0;0,2,149,41,0,286,8517,8654,137,0
16747ref1,8811,9094,JUNC00000042,2,+,8811,9094,255;0;0,2,104,97,0,186,8915,8997,82,0
16747ref1,8773,9078,JUNC00000043,2147,+,8773,9078,255;0;0,2,150,150,0,155,8923,8928,5,0
16747ref1,8801,9244,JUNC00000044,5,+,8801,9244,255;0;0,2,150,114,0,329,8951,9130,179,0
16747ref1,9021,9269,JUNC00000045,2,+,9021,9269,255;0;0,2,9,141,0,107,9030,9128,98,0
16747ref1,8911,9251,JUNC00000046,3,-,8911,9251,255;0;0,2,145,148,0,192,9056,9103,47,0
16747ref1,8987,9227,JUNC00000047,2,+,8987,9227,255;0;0,2,149,73,0,167,9136,9154,18,0
16747ref1,9994,10160,JUNC00000048,1,+,9994,10160,255;0;0,2,143,8,0,158,10137,10152,15,0
17075ref1,207,534,JUNC00000001,6,-,207,534,255;0;0,2,24,150,0,177,231,384,153,0
17075ref1,304,518,JUNC00000002,80,+,304,518,255;0;0,2,150,55,0,159,454,463,9,0
17075ref1,322,725,JUNC00000003,83,+,322,725,255;0;0,2,149,146,0,257,471,579,108,0
17075ref1,379,834,JUNC00000004,2,+,379,834,255;0;0,2,149,146,0,309,528,688,160,0
17075ref1,505,816,JUNC00000005,1,+,505,816,255;0;0,2,29,122,0,189,534,694,160,0
17075ref1,656,844,JUNC00000006,4,-,656,844,255;0;0,2,8,150,0,38,664,694,30,0
17075ref1,611,843,JUNC00000007,23,+,611,843,255;0;0,2,56,149,0,83,667,694,27,0
17075ref1,526,842,JUNC00000008,21,+,526,842,255;0;0,2,148,148,0,168,674,694,20,0
17075ref1,533,721,JUNC00000009,6,+,533,721,255;0;0,2,148,23,0,165,681,698,17,0
17075ref1,533,858,JUNC00000010,5,+,533,858,255;0;0,2,148,148,0,177,681,710,29,0
17075ref1,722,900,JUNC00000011,171,+,722,900,255;0;0,2,8,146,0,32,730,754,24,0
17075ref1,708,1008,JUNC00000012,13,+,708,1008,255;0;0,2,22,144,0,156,730,864,134,0
17075ref1,599,919,JUNC00000013,12,-,599,919,255;0;0,2,145,134,0,186,744,785,41,0
17075ref1,711,1010,JUNC00000014,18,-,711,1010,255;0;0,2,149,144,0,155,860,866,6,0
17075ref1,714,5336,JUNC00000015,1913,-,714,5336,255;0;0,2,146,150,0,4472,860,5186,4326,0
17075ref1,811,1028,JUNC00000016,10,+,811,1028,255;0;0,2,56,150,0,67,867,878,11,0
17075ref1,766,1149,JUNC00000017,33,+,766,1149,255;0;0,2,112,147,0,236,878,1002,124,0
17075ref1,824,1126,JUNC00000018,33,+,824,1126,255;0;0,2,145,150,0,152,969,976,7,0
17075ref1,943,1132,JUNC00000019,4,+,943,1132,255;0;0,2,26,147,0,42,969,985,16,0
17075ref1,946,1171,JUNC00000020,5,+,946,1171,255;0;0,2,23,149,0,76,969,1022,53,0
17075ref1,1002,7735,JUNC00000021,7,+,1002,7735,255;0;0,2,22,150,0,6583,1024,7585,6561,0
17075ref1,955,1191,JUNC00000022,1104,-,955,1191,255;0;0,2,146,33,0,203,1101,1158,57,0
17075ref1,963,1287,JUNC00000023,6,+,963,1287,255;0;0,2,148,150,0,174,1111,1137,26,0
17075ref1,967,1283,JUNC00000024,3,+,967,1283,255;0;0,2,149,150,0,166,1116,1133,17,0
17075ref1,974,1275,JUNC00000025,8,+,974,1275,255;0;0,2,148,147,0,154,1122,1128,6,0
17075ref1,977,1292,JUNC00000026,54,+,977,1292,255;0;0,2,150,145,0,170,1127,1147,20,0
17075ref1,979,1167,JUNC00000027,54,-,979,1167,255;0;0,2,149,9,0,179,1128,1158,30,0
17075ref1,1002,1303,JUNC00000028,77,-,1002,1303,255;0;0,2,148,145,0,156,1150,1158,8,0
17075ref1,1005,1312,JUNC00000029,15,-,1005,1312,255;0;0,2,149,149,0,158,1154,1163,9,0
17075ref1,1075,1381,JUNC00000030,4,+,1075,1381,255;0;0,2,149,149,0,157,1224,1232,8,0
17075ref1,1541,2126,JUNC00000031,2,+,1541,2126,255;0;0,2,106,145,0,440,1647,1981,334,0
17075ref1,1731,2030,JUNC00000032,2,+,1731,2030,255;0;0,2,18,150,0,149,1749,1880,131,0
17075ref1,1606,1973,JUNC00000033,101,-,1606,1973,255;0;0,2,145,147,0,220,1751,1826,75,0
17075ref1,1607,1924,JUNC00000034,34,+,1607,1924,255;0;0,2,147,144,0,173,1754,1780,26,0
17075ref1,1780,2025,JUNC00000035,2,+,1780,2025,255;0;0,2,20,140,0,105,1800,1885,85,0
17075ref1,1683,2062,JUNC00000036,527,-,1683,2062,255;0;0,2,143,150,0,229,1826,1912,86,0
17075ref1,1976,2298,JUNC00000037,5,-,1976,2298,255;0;0,2,149,148,0,174,2125,2150,25,0
17075ref1,2240,2556,JUNC00000038,12,+,2240,2556,255;0;0,2,148,149,0,167,2388,2407,19,0
17075ref1,2354,2782,JUNC00000039,2,+,2354,2782,255;0;0,2,147,146,0,282,2501,2636,135,0
17075ref1,2417,2723,JUNC00000040,90,+,2417,2723,255;0;0,2,148,145,0,161,2565,2578,13,0
17075ref1,2432,7791,JUNC00000041,65,+,2432,7791,255;0;0,2,146,92,0,5267,2578,7699,5121,0
17075ref1,2435,2756,JUNC00000042,36,+,2435,2756,255;0;0,2,149,150,0,171,2584,2606,22,0
17075ref1,2449,2763,JUNC00000043,10,+,2449,2763,255;0;0,2,149,150,0,164,2598,2613,15,0
17075ref1,2640,2839,JUNC00000044,82,+,2640,2839,255;0;0,2,45,149,0,50,2685,2690,5,0
17075ref1,2639,2846,JUNC00000045,142,+,2639,2846,255;0;0,2,46,149,0,58,2685,2697,12,0
17075ref1,2654,2988,JUNC00000046,14,+,2654,2988,255;0;0,2,43,148,0,186,2697,2840,143,0
17075ref1,2658,3005,JUNC00000047,7,-,2658,3005,255;0;0,2,144,149,0,198,2802,2856,54,0
17075ref1,2668,2856,JUNC00000048,46,-,2668,2856,255;0;0,2,148,24,0,164,2816,2832,16,0
17075ref1,2819,3033,JUNC00000049,136,+,2819,3033,255;0;0,2,11,149,0,65,2830,2884,54,0
17075ref1,2807,3169,JUNC00000050,40,-,2807,3169,255;0;0,2,149,148,0,214,2956,3021,65,0
17075ref1,2853,3203,JUNC00000051,12,+,2853,3203,255;0;0,2,147,149,0,201,3000,3054,54,0
17075ref1,3063,3382,JUNC00000052,3524,+,3063,3382,255;0;0,2,150,150,0,169,3213,3232,19,0
17075ref1,3094,3382,JUNC00000053,362,+,3094,3382,255;0;0,2,130,150,0,138,3224,3232,8,0
17075ref1,3108,3434,JUNC00000054,50,-,3108,3434,255;0;0,2,149,150,0,176,3257,3284,27,0
17075ref1,3274,3420,JUNC00000055,2,+,3274,3420,255;0;0,2,79,26,0,120,3353,3394,41,0
17075ref1,3636,3916,JUNC00000056,135,-,3636,3916,255;0;0,2,126,149,0,131,3762,3767,5,0
17075ref1,3687,3944,JUNC00000057,1295,+,3687,3944,255;0;0,2,99,148,0,109,3786,3796,10,0
17075ref1,3798,4043,JUNC00000058,54,+,3798,4043,255;0;0,2,52,149,0,96,3850,3894,44,0
17075ref1,3897,4403,JUNC00000059,2,+,3897,4403,255;0;0,2,128,146,0,360,4025,4257,232,0
17075ref1,4020,4191,JUNC00000060,28,-,4020,4191,255;0;0,2,8,148,0,23,4028,4043,15,0
17075ref1,3913,4224,JUNC00000061,15,+,3913,4224,255;0;0,2,148,149,0,162,4061,4075,14,0
17075ref1,4128,4407,JUNC00000062,5,+,4128,4407,255;0;0,2,24,146,0,133,4152,4261,109,0
17075ref1,4090,4406,JUNC00000063,4,-,4090,4406,255;0;0,2,149,145,0,171,4239,4261,22,0
17075ref1,4184,4417,JUNC00000064,13,+,4184,4417,255;0;0,2,73,146,0,87,4257,4271,14,0
17075ref1,4257,4530,JUNC00000065,86,-,4257,4530,255;0;0,2,95,148,0,125,4352,4382,30,0
17075ref1,4314,4730,JUNC00000066,12,-,4314,4730,255;0;0,2,61,149,0,267,4375,4581,206,0
17075ref1,4235,4414,JUNC00000067,184,-,4235,4414,255;0;0,2,147,26,0,153,4382,4388,6,0
17075ref1,4372,4564,JUNC00000068,72,-,4372,4564,255;0;0,2,10,143,0,49,4382,4421,39,0
17075ref1,4264,4568,JUNC00000069,86,-,4264,4568,255;0;0,2,149,150,0,154,4413,4418,5,0
17075ref1,4410,4666,JUNC00000070,120,-,4410,4666,255;0;0,2,87,111,0,145,4497,4555,58,0
17075ref1,4426,4720,JUNC00000071,2,-,4426,4720,255;0;0,2,106,53,0,241,4532,4667,135,0
17075ref1,4579,7626,JUNC00000072,3,+,4579,7626,255;0;0,2,102,146,0,2901,4681,7480,2799,0
17075ref1,4540,4862,JUNC00000073,10,+,4540,4862,255;0;0,2,149,150,0,172,4689,4712,23,0
17075ref1,4541,7640,JUNC00000074,8,-,4541,7640,255;0;0,2,150,150,0,2949,4691,7490,2799,0
17075ref1,4724,4927,JUNC00000075,85,+,4724,4927,255;0;0,2,41,144,0,59,4765,4783,18,0
17075ref1,4712,5249,JUNC00000076,124,+,4712,5249,255;0;0,2,97,142,0,395,4809,5107,298,0
17075ref1,4695,5187,JUNC00000077,1,+,4695,5187,255;0;0,2,128,23,0,469,4823,5164,341,0
17075ref1,4842,5236,JUNC00000078,4,-,4842,5236,255;0;0,2,21,149,0,245,4863,5087,224,0
17075ref1,4960,5299,JUNC00000079,7,+,4960,5299,255;0;0,2,149,150,0,189,5109,5149,40,0
17075ref1,4982,5393,JUNC00000080,582,-,4982,5393,255;0;0,2,148,146,0,265,5130,5247,117,0
17075ref1,5229,5617,JUNC00000081,2,+,5229,5617,255;0;0,2,147,129,0,259,5376,5488,112,0
17075ref1,5370,5752,JUNC00000082,2,+,5370,5752,255;0;0,2,30,121,0,261,5400,5631,231,0
17075ref1,5375,5713,JUNC00000083,66,+,5375,5713,255;0;0,2,79,150,0,188,5454,5563,109,0
17075ref1,5513,5778,JUNC00000084,17,-,5513,5778,255;0;0,2,87,145,0,120,5600,5633,33,0
17075ref1,5579,5759,JUNC00000085,1,-,5579,5759,255;0;0,2,25,126,0,54,5604,5633,29,0
17075ref1,5693,5999,JUNC00000086,747,+,5693,5999,255;0;0,2,148,145,0,161,5841,5854,13,0
17075ref1,5854,6053,JUNC00000087,8,+,5854,6053,255;0;0,2,29,148,0,51,5883,5905,22,0
17075ref1,5854,6089,JUNC00000088,23,+,5854,6089,255;0;0,2,72,146,0,89,5926,5943,17,0
17075ref1,5854,6128,JUNC00000089,27,+,5854,6128,255;0;0,2,85,148,0,126,5939,5980,41,0
17075ref1,5807,6142,JUNC00000090,2,-,5807,6142,255;0;0,2,148,149,0,186,5955,5993,38,0
17075ref1,5825,6142,JUNC00000091,25,+,5825,6142,255;0;0,2,149,150,0,167,5974,5992,18,0
17075ref1,5825,6164,JUNC00000092,289,-,5825,6164,255;0;0,2,149,150,0,189,5974,6014,40,0
17075ref1,5900,6174,JUNC00000093,2,+,5900,6174,255;0;0,2,150,119,0,155,6050,6055,5,0
17075ref1,5955,6258,JUNC00000094,18,+,5955,6258,255;0;0,2,150,148,0,155,6105,6110,5,0
17075ref1,6024,6467,JUNC00000095,376,+,6024,6467,255;0;0,2,150,150,0,293,6174,6317,143,0
17075ref1,6214,6530,JUNC00000096,355,-,6214,6530,255;0;0,2,150,147,0,169,6364,6383,19,0
17075ref1,6237,7280,JUNC00000097,26,-,6237,7280,255;0;0,2,147,146,0,897,6384,7134,750,0
17075ref1,6407,7184,JUNC00000098,176,-,6407,7184,255;0;0,2,148,149,0,628,6555,7035,480,0
17075ref1,6577,6880,JUNC00000099,9,-,6577,6880,255;0;0,2,148,150,0,153,6725,6730,5,0
17075ref1,6652,7120,JUNC00000100,98,+,6652,7120,255;0;0,2,143,149,0,319,6795,6971,176,0
17075ref1,6748,7405,JUNC00000101,27,+,6748,7405,255;0;0,2,47,148,0,509,6795,7257,462,0
17075ref1,6744,7103,JUNC00000102,7,-,6744,7103,255;0;0,2,148,144,0,215,6892,6959,67,0
17075ref1,6742,7108,JUNC00000103,80,-,6742,7108,255;0;0,2,150,146,0,220,6892,6962,70,0
17075ref1,6742,7343,JUNC00000104,8,-,6742,7343,255;0;0,2,150,129,0,472,6892,7214,322,0
17075ref1,6875,7093,JUNC00000105,15,-,6875,7093,255;0;0,2,47,145,0,73,6922,6948,26,0
17075ref1,6916,7103,JUNC00000106,23,-,6916,7103,255;0;0,2,9,147,0,40,6925,6956,31,0
17075ref1,6793,7121,JUNC00000107,7,-,6793,7121,255;0;0,2,149,148,0,180,6942,6973,31,0
17075ref1,6928,7642,JUNC00000108,249,+,6928,7642,255;0;0,2,145,148,0,566,7073,7494,421,0
17075ref1,6966,7367,JUNC00000109,19,+,6966,7367,255;0;0,2,149,148,0,253,7115,7219,104,0
17075ref1,6970,7371,JUNC00000110,32,+,6970,7371,255;0;0,2,147,150,0,251,7117,7221,104,0
17075ref1,6988,7175,JUNC00000111,19,+,6988,7175,255;0;0,2,149,33,0,154,7137,7142,5,0
17075ref1,7009,7330,JUNC00000112,23,-,7009,7330,255;0;0,2,149,149,0,172,7158,7181,23,0
17075ref1,7307,7556,JUNC00000113,97,+,7307,7556,255;0;0,2,78,123,0,126,7385,7433,48,0
17075ref1,7325,9145,JUNC00000114,8,-,7325,9145,255;0;0,2,146,88,0,1732,7471,9057,1586,0
17075ref1,7382,7579,JUNC00000115,3,-,7382,7579,255;0;0,2,148,23,0,174,7530,7556,26,0
17075ref1,7409,7899,JUNC00000116,47,+,7409,7899,255;0;0,2,145,26,0,464,7554,7873,319,0
17075ref1,7440,7727,JUNC00000117,8,-,7440,7727,255;0;0,2,133,149,0,138,7573,7578,5,0
17075ref1,7516,7716,JUNC00000118,7,+,7516,7716,255;0;0,2,144,20,0,180,7660,7696,36,0
17075ref1,7512,7811,JUNC00000119,17,+,7512,7811,255;0;0,2,148,112,0,187,7660,7699,39,0
17075ref1,7710,7952,JUNC00000120,33,+,7710,7952,255;0;0,2,147,79,0,163,7857,7873,16,0
17075ref1,7788,7998,JUNC00000121,43,-,7788,7998,255;0;0,2,147,20,0,190,7935,7978,43,0
17075ref1,7870,8194,JUNC00000122,23,+,7870,8194,255;0;0,2,145,150,0,174,8015,8044,29,0
17075ref1,7963,8544,JUNC00000123,496,+,7963,8544,255;0;0,2,143,150,0,431,8106,8394,288,0
17075ref1,8041,8345,JUNC00000124,9,+,8041,8345,255;0;0,2,150,148,0,156,8191,8197,6,0
17075ref1,8765,9073,JUNC00000125,845,+,8765,9073,255;0;0,2,150,145,0,163,8915,8928,13,0
17075ref1,8766,9282,JUNC00000126,502,+,8766,9282,255;0;0,2,149,150,0,366,8915,9132,217,0
17075ref1,8795,9078,JUNC00000127,883,+,8795,9078,255;0;0,2,128,150,0,133,8923,8928,5,0
17075ref1,8974,9227,JUNC00000128,11,+,8974,9227,255;0;0,2,56,144,0,109,9030,9083,53,0
17075ref1,8951,10119,JUNC00000129,3,-,8951,10119,255;0;0,2,127,149,0,1019,9078,9970,892,0
17075ref1,9036,9198,JUNC00000130,2,+,9036,9198,255;0;0,2,143,10,0,152,9179,9188,9,0
17075ref1,9661,9970,JUNC00000131,71,-,9661,9970,255;0;0,2,148,146,0,163,9809,9824,15,0
17075ref1,9778,10114,JUNC00000132,187,-,9778,10114,255;0;0,2,46,149,0,187,9824,9965,141,0
17075ref1,9678,10138,JUNC00000133,3,-,9678,10138,255;0;0,2,148,57,0,403,9826,10081,255,0
17075ref1,9917,10106,JUNC00000134,3,+,9917,10106,255;0;0,2,8,143,0,46,9925,9963,38,0
18010ref1,629,822,JUNC00000001,9,-,629,822,255;0;0,2,21,146,0,47,650,676,26,0
18010ref1,513,1074,JUNC00000002,10,+,513,1074,255;0;0,2,143,59,0,502,656,1015,359,0
18010ref1,666,842,JUNC00000003,22,+,666,842,255;0;0,2,8,148,0,28,674,694,20,0
18010ref1,625,928,JUNC00000004,1,+,625,928,255;0;0,2,49,102,0,201,674,826,152,0
18010ref1,632,1039,JUNC00000005,3,+,632,1039,255;0;0,2,42,24,0,383,674,1015,341,0
18010ref1,672,1019,JUNC00000006,108,+,672,1019,255;0;0,2,45,148,0,199,717,871,154,0
18010ref1,713,892,JUNC00000007,15,+,713,892,255;0;0,2,17,147,0,32,730,745,15,0
18010ref1,681,1020,JUNC00000008,22,+,681,1020,255;0;0,2,51,149,0,190,732,871,139,0
18010ref1,648,828,JUNC00000009,35,-,648,828,255;0;0,2,96,43,0,137,744,785,41,0
18010ref1,620,1014,JUNC00000010,70,-,620,1014,255;0;0,2,150,61,0,333,770,953,183,0
18010ref1,700,1901,JUNC00000011,1814,-,700,1901,255;0;0,2,70,150,0,1051,770,1751,981,0
18010ref1,757,1852,JUNC00000012,314,-,757,1852,255;0;0,2,28,140,0,955,785,1712,927,0
18010ref1,671,984,JUNC00000013,37,-,671,984,255;0;0,2,147,150,0,163,818,834,16,0
18010ref1,690,1058,JUNC00000014,4,+,690,1058,255;0;0,2,150,148,0,220,840,910,70,0
18010ref1,707,1007,JUNC00000015,23,-,707,1007,255;0;0,2,148,147,0,153,855,860,5,0
18010ref1,721,1023,JUNC00000016,85,+,721,1023,255;0;0,2,146,145,0,157,867,878,11,0
18010ref1,871,1096,JUNC00000017,7,+,871,1096,255;0;0,2,47,147,0,78,918,949,31,0
18010ref1,826,1171,JUNC00000018,9,+,826,1171,255;0;0,2,143,149,0,196,969,1022,53,0
18010ref1,871,1458,JUNC00000019,802,+,871,1458,255;0;0,2,144,150,0,437,1015,1308,293,0
18010ref1,955,1239,JUNC00000020,1706,-,955,1239,255;0;0,2,146,81,0,203,1101,1158,57,0
18010ref1,975,1315,JUNC00000021,2,+,975,1315,255;0;0,2,147,144,0,196,1122,1171,49,0
18010ref1,993,1293,JUNC00000022,18,+,993,1293,255;0;0,2,134,146,0,154,1127,1147,20,0
18010ref1,1003,1272,JUNC00000023,52,-,1003,1272,255;0;0,2,147,114,0,155,1150,1158,8,0
18010ref1,1474,1783,JUNC00000024,414,+,1474,1783,255;0;0,2,150,150,0,159,1624,1633,9,0
18010ref1,1599,2122,JUNC00000025,5084,+,1599,2122,255;0;0,2,150,150,0,373,1749,1972,223,0
18010ref1,1759,2032,JUNC00000026,4,-,1759,2032,255;0;0,2,56,147,0,126,1815,1885,70,0
18010ref1,1690,2062,JUNC00000027,303,-,1690,2062,255;0;0,2,136,150,0,222,1826,1912,86,0
18010ref1,1884,2300,JUNC00000028,2545,+,1884,2300,255;0;0,2,150,150,0,266,2034,2150,116,0
18010ref1,2157,2501,JUNC00000029,1104,-,2157,2501,255;0;0,2,150,147,0,197,2307,2354,47,0
18010ref1,2171,2488,JUNC00000030,20,-,2171,2488,255;0;0,2,148,149,0,168,2319,2339,20,0
18010ref1,2371,2659,JUNC00000031,10,+,2371,2659,255;0;0,2,122,150,0,138,2493,2509,16,0
18010ref1,2371,2763,JUNC00000032,12,+,2371,2763,255;0;0,2,122,150,0,242,2493,2613,120,0
18010ref1,2505,2779,JUNC00000033,5,+,2505,2779,255;0;0,2,26,150,0,124,2531,2629,98,0
18010ref1,2535,2836,JUNC00000034,120,+,2535,2836,255;0;0,2,43,141,0,160,2578,2695,117,0
18010ref1,2529,2835,JUNC00000035,99,+,2529,2835,255;0;0,2,51,138,0,168,2580,2697,117,0
18010ref1,2565,2779,JUNC00000036,5,+,2565,2779,255;0;0,2,24,150,0,64,2589,2629,40,0
18010ref1,2450,2763,JUNC00000037,2,+,2450,2763,255;0;0,2,148,150,0,163,2598,2613,15,0
18010ref1,2570,2779,JUNC00000038,5,+,2570,2779,255;0;0,2,44,150,0,59,2614,2629,15,0
18010ref1,2593,2801,JUNC00000039,19,+,2593,2801,255;0;0,2,26,149,0,59,2619,2652,33,0
18010ref1,2623,2823,JUNC00000040,15,+,2623,2823,255;0;0,2,47,147,0,53,2670,2676,6,0
18010ref1,2637,2990,JUNC00000041,18,+,2637,2990,255;0;0,2,45,150,0,203,2682,2840,158,0
18010ref1,2667,2960,JUNC00000042,138,+,2667,2960,255;0;0,2,139,146,0,147,2806,2814,8,0
18010ref1,2721,2989,JUNC00000043,137,+,2721,2989,255;0;0,2,85,149,0,119,2806,2840,34,0
18010ref1,2697,2989,JUNC00000044,8,+,2697,2989,255;0;0,2,130,149,0,143,2827,2840,13,0
18010ref1,3023,3346,JUNC00000045,153,+,3023,3346,255;0;0,2,148,150,0,173,3171,3196,25,0
18010ref1,3218,3412,JUNC00000046,3,-,3218,3412,255;0;0,2,39,128,0,66,3257,3284,27,0
18010ref1,3611,3815,JUNC00000047,16,+,3611,3815,255;0;0,2,20,150,0,54,3631,3665,34,0
18010ref1,3770,4120,JUNC00000048,2,-,3770,4120,255;0;0,2,132,150,0,200,3902,3970,68,0
18010ref1,3831,4137,JUNC00000049,6,-,3831,4137,255;0;0,2,149,148,0,158,3980,3989,9,0
18010ref1,3954,4297,JUNC00000050,457,+,3954,4297,255;0;0,2,105,148,0,195,4059,4149,90,0
18010ref1,4125,4418,JUNC00000051,21,+,4125,4418,255;0;0,2,132,147,0,146,4257,4271,14,0
18010ref1,4449,4705,JUNC00000052,404,-,4449,4705,255;0;0,2,48,150,0,106,4497,4555,58,0
18010ref1,4713,5235,JUNC00000053,308,-,4713,5235,255;0;0,2,150,148,0,374,4863,5087,224,0
18010ref1,4848,5165,JUNC00000054,3,-,4848,5165,255;0;0,2,145,150,0,167,4993,5015,22,0
18010ref1,5021,6728,JUNC00000055,1,+,5021,6728,255;0;0,2,43,108,0,1599,5064,6620,1556,0
18010ref1,5535,5778,JUNC00000056,20,-,5535,5778,255;0;0,2,65,145,0,98,5600,5633,33,0
18010ref1,5586,5923,JUNC00000057,830,+,5586,5923,255;0;0,2,150,148,0,189,5736,5775,39,0
18010ref1,5695,6126,JUNC00000058,68,+,5695,6126,255;0;0,2,149,146,0,285,5844,5980,136,0
18010ref1,5955,6256,JUNC00000059,6,+,5955,6256,255;0;0,2,150,146,0,155,6105,6110,5,0
18010ref1,6404,6710,JUNC00000060,639,-,6404,6710,255;0;0,2,150,150,0,156,6554,6560,6,0
18010ref1,6929,7641,JUNC00000061,4,+,6929,7641,255;0;0,2,144,147,0,565,7073,7494,421,0
18010ref1,7361,7726,JUNC00000062,24,-,7361,7726,255;0;0,2,150,148,0,217,7511,7578,67,0
18010ref1,7539,7730,JUNC00000063,2,+,7539,7730,255;0;0,2,121,34,0,157,7660,7696,36,0
18010ref1,7708,8122,JUNC00000064,12,+,7708,8122,255;0;0,2,147,149,0,265,7855,7973,118,0
18010ref1,7723,7968,JUNC00000065,68,-,7723,7968,255;0;0,2,143,52,0,193,7866,7916,50,0
18010ref1,7725,8028,JUNC00000066,109,-,7725,8028,255;0;0,2,150,148,0,155,7875,7880,5,0
18010ref1,7920,7970,JUNC00000067,1,-,7920,7970,255;0;0,2,22,8,0,42,7942,7962,20,0
18010ref1,8872,9233,JUNC00000068,243,+,8872,9233,255;0;0,2,49,150,0,211,8921,9083,162,0
18010ref1,8773,9078,JUNC00000069,2850,+,8773,9078,255;0;0,2,150,150,0,155,8923,8928,5,0
18010ref1,9659,9973,JUNC00000070,2161,-,9659,9973,255;0;0,2,150,149,0,165,9809,9824,15,0
18010ref1,9787,10280,JUNC00000071,2,-,9787,10280,255;0;0,2,37,114,0,379,9824,10166,342,0
18010ref1,9817,10119,JUNC00000072,2,+,9817,10119,255;0;0,2,77,74,0,228,9894,10045,151,0
18010ref1,9964,10276,JUNC00000073,1,+,9964,10276,255;0;0,2,29,121,0,191,9993,10155,162,0
16752ref1,197,534,JUNC00000001,21,-,197,534,255;0;0,2,34,150,0,187,231,384,153,0
16752ref1,281,9223,JUNC00000002,1,+,281,9223,255;0;0,2,43,108,0,8834,324,9115,8791,0
16752ref1,628,1060,JUNC00000003,1,+,628,1060,255;0;0,2,28,45,0,387,656,1015,359,0
16752ref1,510,693,JUNC00000004,921,-,510,693,255;0;0,2,150,24,0,159,660,669,9,0
16752ref1,651,878,JUNC00000005,35,+,651,878,255;0;0,2,23,148,0,79,674,730,56,0
16752ref1,549,885,JUNC00000006,583,+,549,885,255;0;0,2,125,140,0,196,674,745,71,0
16752ref1,599,915,JUNC00000007,72,-,599,915,255;0;0,2,145,130,0,186,744,785,41,0
16752ref1,676,3971,JUNC00000008,142,+,676,3971,255;0;0,2,88,77,0,3218,764,3894,3130,0
16752ref1,729,970,JUNC00000009,131,+,729,970,255;0;0,2,149,60,0,181,878,910,32,0
16752ref1,826,1124,JUNC00000010,8,+,826,1124,255;0;0,2,143,148,0,150,969,976,7,0
16752ref1,925,1145,JUNC00000011,3,+,925,1145,255;0;0,2,44,123,0,97,969,1022,53,0
16752ref1,989,10137,JUNC00000012,3,+,989,10137,255;0;0,2,26,126,0,9022,1015,10011,8996,0
16752ref1,955,1307,JUNC00000013,493,-,955,1307,255;0;0,2,146,149,0,203,1101,1158,57,0
16752ref1,963,1287,JUNC00000014,3,+,963,1287,255;0;0,2,148,150,0,174,1111,1137,26,0
16752ref1,964,1270,JUNC00000015,6,+,964,1270,255;0;0,2,150,150,0,156,1114,1120,6,0
16752ref1,1005,1250,JUNC00000016,21,-,1005,1250,255;0;0,2,145,92,0,153,1150,1158,8,0
16752ref1,1159,1818,JUNC00000017,230,+,1159,1818,255;0;0,2,149,140,0,519,1308,1678,370,0
16752ref1,1418,1868,JUNC00000018,286,+,1418,1868,255;0;0,2,150,149,0,301,1568,1719,151,0
16752ref1,1606,1972,JUNC00000019,290,-,1606,1972,255;0;0,2,145,146,0,220,1751,1826,75,0
16752ref1,1656,2034,JUNC00000020,199,+,1656,2034,255;0;0,2,144,149,0,229,1800,1885,85,0
16752ref1,1752,2062,JUNC00000021,258,-,1752,2062,255;0;0,2,74,150,0,160,1826,1912,86,0
16752ref1,1806,2068,JUNC00000022,21,+,1806,2068,255;0;0,2,51,150,0,112,1857,1918,61,0
16752ref1,2169,2640,JUNC00000023,639,-,2169,2640,255;0;0,2,150,147,0,324,2319,2493,174,0
16752ref1,2172,2473,JUNC00000024,679,+,2172,2473,255;0;0,2,150,146,0,155,2322,2327,5,0
16752ref1,2177,2622,JUNC00000025,1938,+,2177,2622,255;0;0,2,150,121,0,324,2327,2501,174,0
16752ref1,2240,2556,JUNC00000026,12,+,2240,2556,255;0;0,2,148,149,0,167,2388,2407,19,0
16752ref1,2450,2781,JUNC00000027,124,-,2450,2781,255;0;0,2,148,148,0,183,2598,2633,35,0
16752ref1,2677,2981,JUNC00000028,2,-,2677,2981,255;0;0,2,143,149,0,155,2820,2832,12,0
16752ref1,2821,2991,JUNC00000029,57,+,2821,2991,255;0;0,2,9,149,0,21,2830,2842,12,0
16752ref1,2697,3009,JUNC00000030,32,+,2697,3009,255;0;0,2,149,147,0,165,2846,2862,16,0
16752ref1,2717,3030,JUNC00000031,14,+,2717,3030,255;0;0,2,148,149,0,164,2865,2881,16,0
16752ref1,2852,3129,JUNC00000032,2,+,2852,3129,255;0;0,2,69,82,0,195,2921,3047,126,0
16752ref1,2948,3138,JUNC00000033,11,+,2948,3138,255;0;0,2,8,149,0,41,2956,2989,33,0
16752ref1,3023,3327,JUNC00000034,62,+,3023,3327,255;0;0,2,124,149,0,155,3147,3178,31,0
16752ref1,3023,3346,JUNC00000035,77,+,3023,3346,255;0;0,2,148,150,0,173,3171,3196,25,0
16752ref1,3048,3212,JUNC00000036,10,-,3048,3212,255;0;0,2,149,8,0,156,3197,3204,7,0
16752ref1,3181,3433,JUNC00000037,14,-,3181,3433,255;0;0,2,76,149,0,103,3257,3284,27,0
16752ref1,3647,3844,JUNC00000038,3,+,3647,3844,255;0;0,2,19,149,0,48,3666,3695,29,0
16752ref1,3573,3930,JUNC00000039,620,-,3573,3930,255;0;0,2,150,148,0,209,3723,3782,59,0
16752ref1,3912,4262,JUNC00000040,2,+,3912,4262,255;0;0,2,149,147,0,203,4061,4115,54,0
16752ref1,3960,4268,JUNC00000041,1711,-,3960,4268,255;0;0,2,147,150,0,158,4107,4118,11,0
16752ref1,4130,4418,JUNC00000042,6,+,4130,4418,255;0;0,2,127,147,0,141,4257,4271,14,0
16752ref1,4217,4674,JUNC00000043,23,+,4217,4674,255;0;0,2,147,101,0,356,4364,4573,209,0
16752ref1,4225,4564,JUNC00000044,9,+,4225,4564,255;0;0,2,147,150,0,189,4372,4414,42,0
16752ref1,4388,4705,JUNC00000045,1350,-,4388,4705,255;0;0,2,109,150,0,167,4497,4555,58,0
16752ref1,4504,4674,JUNC00000046,1,+,4504,4674,255;0;0,2,25,10,0,160,4529,4664,135,0
16752ref1,4408,4694,JUNC00000047,1,-,4408,4694,255;0;0,2,131,20,0,266,4539,4674,135,0
16752ref1,4731,4933,JUNC00000048,1552,+,4731,4933,255;0;0,2,34,150,0,52,4765,4783,18,0
16752ref1,5077,10423,JUNC00000049,1,+,5077,10423,255;0;0,2,11,140,0,5206,5088,10283,5195,0
16752ref1,6711,6890,JUNC00000050,111,+,6711,6890,255;0;0,2,9,148,0,31,6720,6742,22,0
16752ref1,6855,7159,JUNC00000051,2322,-,6855,7159,255;0;0,2,150,148,0,156,7005,7011,6,0
16752ref1,6946,7641,JUNC00000052,3,+,6946,7641,255;0;0,2,127,147,0,548,7073,7494,421,0
16752ref1,7255,7436,JUNC00000053,3,+,7255,7436,255;0;0,2,26,149,0,32,7281,7287,6,0
16752ref1,7220,7543,JUNC00000054,109,-,7220,7543,255;0;0,2,115,147,0,176,7335,7396,61,0
16752ref1,7673,7884,JUNC00000055,2,+,7673,7884,255;0;0,2,26,17,0,194,7699,7867,168,0
16752ref1,7675,7980,JUNC00000056,2,-,7675,7980,255;0;0,2,77,74,0,231,7752,7906,154,0
16752ref1,7757,8053,JUNC00000057,677,+,7757,8053,255;0;0,2,22,150,0,146,7779,7903,124,0
16752ref1,7736,8005,JUNC00000058,20,-,7736,8005,255;0;0,2,61,148,0,121,7797,7857,60,0
16752ref1,7694,8143,JUNC00000059,59,+,7694,8143,255;0;0,2,143,149,0,300,7837,7994,157,0
16752ref1,7714,7872,JUNC00000060,1,+,7714,7872,255;0;0,2,143,8,0,150,7857,7864,7,0
16752ref1,7788,7935,JUNC00000061,2,+,7788,7935,255;0;0,2,69,68,0,79,7857,7867,10,0
16752ref1,7718,8021,JUNC00000062,5,+,7718,8021,255;0;0,2,148,148,0,155,7866,7873,7,0
16752ref1,7725,7997,JUNC00000063,93,-,7725,7997,255;0;0,2,150,117,0,155,7875,7880,5,0
16752ref1,7962,8279,JUNC00000064,662,-,7962,8279,255;0;0,2,150,150,0,167,8112,8129,17,0
16752ref1,7966,8281,JUNC00000065,58,-,7966,8281,255;0;0,2,149,150,0,165,8115,8131,16,0
16752ref1,8374,8583,JUNC00000066,1,+,8374,8583,255;0;0,2,114,37,0,172,8488,8546,58,0
16752ref1,8780,9050,JUNC00000067,1,-,8780,9050,255;0;0,2,29,122,0,148,8809,8928,119,0
16752ref1,8771,9231,JUNC00000068,31,+,8771,9231,255;0;0,2,150,148,0,312,8921,9083,162,0
16752ref1,8773,9078,JUNC00000069,744,+,8773,9078,255;0;0,2,150,150,0,155,8923,8928,5,0
16752ref1,8820,9110,JUNC00000070,432,+,8820,9110,255;0;0,2,150,133,0,157,8970,8977,7,0
16752ref1,9036,9196,JUNC00000071,1,+,9036,9196,255;0;0,2,143,8,0,152,9179,9188,9,0
16752ref1,9531,9689,JUNC00000072,1,+,9531,9689,255;0;0,2,108,43,0,115,9639,9646,7,0
16752ref1,9707,9972,JUNC00000073,53,+,9707,9972,255;0;0,2,68,149,0,116,9775,9823,48,0
16752ref1,9659,9972,JUNC00000074,1424,-,9659,9972,255;0;0,2,150,148,0,165,9809,9824,15,0
16752ref1,9690,10023,JUNC00000075,5,-,9690,10023,255;0;0,2,148,150,0,183,9838,9873,35,0
16752ref1,9986,10229,JUNC00000076,1,+,9986,10229,255;0;0,2,122,29,0,214,10108,10200,92,0
17379ref1,256,430,JUNC00000001,30,-,256,430,255;0;0,2,8,149,0,25,264,281,17,0
17379ref1,244,443,JUNC00000002,3,+,244,443,255;0;0,2,31,129,0,70,275,314,39,0
17379ref1,296,595,JUNC00000003,67,+,296,595,255;0;0,2,146,146,0,153,442,449,7,0
17379ref1,304,575,JUNC00000004,67,+,304,575,255;0;0,2,150,112,0,159,454,463,9,0
17379ref1,525,707,JUNC00000005,24,+,525,707,255;0;0,2,27,149,0,33,552,558,6,0
17379ref1,472,818,JUNC00000006,37,-,472,818,255;0;0,2,123,149,0,197,595,669,74,0
17379ref1,480,779,JUNC00000007,61,+,480,779,255;0;0,2,147,146,0,153,627,633,6,0
17379ref1,612,1123,JUNC00000008,10,+,612,1123,255;0;0,2,44,121,0,390,656,1002,346,0
17379ref1,559,1044,JUNC00000009,22,+,559,1044,255;0;0,2,97,29,0,456,656,1015,359,0
17379ref1,652,833,JUNC00000010,8,+,652,833,255;0;0,2,22,147,0,34,674,686,12,0
17379ref1,528,838,JUNC00000011,37,+,528,838,255;0;0,2,146,144,0,166,674,694,20,0
17379ref1,627,970,JUNC00000012,40,+,627,970,255;0;0,2,47,144,0,199,674,826,152,0
17379ref1,528,1059,JUNC00000013,135,+,528,1059,255;0;0,2,146,145,0,386,674,914,240,0
17379ref1,687,1025,JUNC00000014,10,+,687,1025,255;0;0,2,23,150,0,188,710,875,165,0
17379ref1,574,1020,JUNC00000015,2,+,574,1020,255;0;0,2,149,149,0,297,723,871,148,0
17379ref1,741,819,JUNC00000016,26,+,741,819,255;0;0,2,23,26,0,52,764,793,29,0
17379ref1,745,951,JUNC00000017,23,+,745,951,255;0;0,2,19,139,0,67,764,812,48,0
17379ref1,746,993,JUNC00000018,50,-,746,993,255;0;0,2,24,148,0,99,770,845,75,0
17379ref1,734,994,JUNC00000019,1,+,734,994,255;0;0,2,49,102,0,158,783,892,109,0
17379ref1,698,888,JUNC00000020,20,-,698,888,255;0;0,2,87,28,0,162,785,860,75,0
17379ref1,696,1013,JUNC00000021,6,+,696,1013,255;0;0,2,147,149,0,168,843,864,21,0
17379ref1,696,1027,JUNC00000022,12,+,696,1027,255;0;0,2,147,149,0,182,843,878,35,0
17379ref1,842,1028,JUNC00000023,21,+,842,1028,255;0;0,2,25,150,0,36,867,878,11,0
17379ref1,812,1148,JUNC00000024,7,+,812,1148,255;0;0,2,66,146,0,190,878,1002,124,0
17379ref1,922,993,JUNC00000025,5,+,922,993,255;0;0,2,31,27,0,44,953,966,13,0
17379ref1,824,1125,JUNC00000026,21,+,824,1125,255;0;0,2,145,149,0,152,969,976,7,0
17379ref1,945,1277,JUNC00000027,9,+,945,1277,255;0;0,2,150,149,0,183,1095,1128,33,0
17379ref1,955,1232,JUNC00000028,661,-,955,1232,255;0;0,2,146,74,0,203,1101,1158,57,0
17379ref1,966,1285,JUNC00000029,2,+,966,1285,255;0;0,2,145,148,0,171,1111,1137,26,0
17379ref1,978,1293,JUNC00000030,34,+,978,1293,255;0;0,2,149,146,0,169,1127,1147,20,0
17379ref1,1000,1304,JUNC00000031,9,-,1000,1304,255;0;0,2,150,149,0,155,1150,1155,5,0
17379ref1,1001,1214,JUNC00000032,92,-,1001,1214,255;0;0,2,149,56,0,157,1150,1158,8,0
17379ref1,1202,1391,JUNC00000033,3,+,1202,1391,255;0;0,2,148,23,0,166,1350,1368,18,0
17379ref1,1236,1755,JUNC00000034,17,+,1236,1755,255;0;0,2,150,149,0,370,1386,1606,220,0
17379ref1,1284,1673,JUNC00000035,110,+,1284,1673,255;0;0,2,127,125,0,264,1411,1548,137,0
17379ref1,1469,1940,JUNC00000036,49,+,1469,1940,255;0;0,2,126,147,0,324,1595,1793,198,0
17379ref1,1600,1801,JUNC00000037,6,+,1600,1801,255;0;0,2,24,149,0,52,1624,1652,28,0
17379ref1,1653,1925,JUNC00000038,42,+,1653,1925,255;0;0,2,33,148,0,124,1686,1777,91,0
17379ref1,1663,1924,JUNC00000039,16,+,1663,1924,255;0;0,2,26,147,0,114,1689,1777,88,0
17379ref1,1682,1942,JUNC00000040,18,+,1682,1942,255;0;0,2,28,149,0,111,1710,1793,83,0
17379ref1,1606,2121,JUNC00000041,57,+,1606,2121,255;0;0,2,143,149,0,366,1749,1972,223,0
17379ref1,1767,2056,JUNC00000042,51,-,1767,2056,255;0;0,2,59,144,0,145,1826,1912,86,0
17379ref1,1719,2041,JUNC00000043,2,-,1719,2041,255;0;0,2,119,146,0,176,1838,1895,57,0
17379ref1,1902,2502,JUNC00000044,109,-,1902,2502,255;0;0,2,145,148,0,452,2047,2354,307,0
17379ref1,2217,2473,JUNC00000045,2,+,2217,2473,255;0;0,2,8,146,0,110,2225,2327,102,0
17379ref1,2154,2477,JUNC00000046,175,+,2154,2477,255;0;0,2,144,150,0,173,2298,2327,29,0
17379ref1,2169,2489,JUNC00000047,574,-,2169,2489,255;0;0,2,150,150,0,170,2319,2339,20,0
17379ref1,2291,2812,JUNC00000048,1,+,2291,2812,255;0;0,2,36,115,0,406,2327,2697,370,0
17379ref1,2240,2556,JUNC00000049,7,+,2240,2556,255;0;0,2,148,149,0,167,2388,2407,19,0
17379ref1,2239,2574,JUNC00000050,7,-,2239,2574,255;0;0,2,149,150,0,185,2388,2424,36,0
17379ref1,2385,2631,JUNC00000051,9,+,2385,2631,255;0;0,2,8,145,0,101,2393,2486,93,0
17379ref1,2402,2664,JUNC00000052,6,-,2402,2664,255;0;0,2,26,149,0,113,2428,2515,87,0
17379ref1,2314,2644,JUNC00000053,19,+,2314,2644,255;0;0,2,148,147,0,183,2462,2497,35,0
17379ref1,2354,2769,JUNC00000054,14,-,2354,2769,255;0;0,2,139,148,0,267,2493,2621,128,0
17379ref1,2354,2995,JUNC00000055,51,-,2354,2995,255;0;0,2,139,147,0,494,2493,2848,355,0
17379ref1,2396,2780,JUNC00000056,6,-,2396,2780,255;0;0,2,148,144,0,240,2544,2636,92,0
17379ref1,2492,2722,JUNC00000057,32,+,2492,2722,255;0;0,2,73,144,0,86,2565,2578,13,0
17379ref1,2435,2831,JUNC00000058,28,+,2435,2831,255;0;0,2,145,134,0,262,2580,2697,117,0
17379ref1,2450,2780,JUNC00000059,85,-,2450,2780,255;0;0,2,148,147,0,183,2598,2633,35,0
17379ref1,2599,2961,JUNC00000060,28,+,2599,2961,255;0;0,2,53,145,0,217,2652,2816,164,0
17379ref1,2651,2893,JUNC00000061,202,+,2651,2893,255;0;0,2,19,142,0,100,2670,2751,81,0
17379ref1,2651,2846,JUNC00000062,51,+,2651,2846,255;0;0,2,34,149,0,46,2685,2697,12,0
17379ref1,2685,2989,JUNC00000063,9,+,2685,2989,255;0;0,2,24,149,0,155,2709,2840,131,0
17379ref1,2659,2989,JUNC00000064,35,+,2659,2989,255;0;0,2,147,149,0,181,2806,2840,34,0
17379ref1,2668,2981,JUNC00000065,7,-,2668,2981,255;0;0,2,148,149,0,164,2816,2832,16,0
17379ref1,2666,2988,JUNC00000066,7,-,2666,2988,255;0;0,2,150,148,0,174,2816,2840,24,0
17379ref1,2666,2992,JUNC00000067,9,-,2666,2992,255;0;0,2,150,149,0,177,2816,2843,27,0
17379ref1,2773,3010,JUNC00000068,70,+,2773,3010,255;0;0,2,50,148,0,89,2823,2862,39,0
17379ref1,2824,3009,JUNC00000069,17,+,2824,3009,255;0;0,2,22,147,0,38,2846,2862,16,0
17379ref1,2715,3030,JUNC00000070,32,+,2715,3030,255;0;0,2,150,149,0,166,2865,2881,16,0
17379ref1,2948,3126,JUNC00000071,100,+,2948,3126,255;0;0,2,8,149,0,29,2956,2977,21,0
17379ref1,2882,3139,JUNC00000072,10,+,2882,3139,255;0;0,2,74,150,0,107,2956,2989,33,0
17379ref1,2959,3141,JUNC00000073,105,+,2959,3141,255;0;0,2,23,147,0,35,2982,2994,12,0
17379ref1,2883,3231,JUNC00000074,3,+,2883,3231,255;0;0,2,150,145,0,203,3033,3086,53,0
17379ref1,3023,3346,JUNC00000075,64,+,3023,3346,255;0;0,2,148,150,0,173,3171,3196,25,0
17379ref1,3248,3433,JUNC00000076,6,-,3248,3433,255;0;0,2,9,149,0,36,3257,3284,27,0
17379ref1,3793,4048,JUNC00000077,3,-,3793,4048,255;0;0,2,61,90,0,165,3854,3958,104,0
17379ref1,3868,4164,JUNC00000078,52,-,3868,4164,255;0;0,2,51,149,0,147,3919,4015,96,0
17379ref1,3942,4220,JUNC00000079,216,+,3942,4220,255;0;0,2,117,145,0,133,4059,4075,16,0
17379ref1,4004,4389,JUNC00000080,18,-,4004,4389,255;0;0,2,103,149,0,236,4107,4240,133,0
17379ref1,3975,4280,JUNC00000081,144,+,3975,4280,255;0;0,2,145,150,0,155,4120,4130,10,0
17379ref1,4045,4389,JUNC00000082,22,-,4045,4389,255;0;0,2,146,149,0,195,4191,4240,49,0
17379ref1,4198,4394,JUNC00000083,9,+,4198,4394,255;0;0,2,25,147,0,49,4223,4247,24,0
17379ref1,4227,4407,JUNC00000084,7,-,4227,4407,255;0;0,2,19,150,0,30,4246,4257,11,0
17379ref1,4132,4418,JUNC00000085,12,+,4132,4418,255;0;0,2,125,147,0,139,4257,4271,14,0
17379ref1,4161,4444,JUNC00000086,19,+,4161,4444,255;0;0,2,96,149,0,134,4257,4295,38,0
17379ref1,4130,4467,JUNC00000087,10,+,4130,4467,255;0;0,2,149,146,0,191,4279,4321,42,0
17379ref1,4300,4510,JUNC00000088,12,+,4300,4510,255;0;0,2,31,149,0,61,4331,4361,30,0
17379ref1,4223,4531,JUNC00000089,56,-,4223,4531,255;0;0,2,129,149,0,159,4352,4382,30,0
17379ref1,4354,4508,JUNC00000090,1,+,4354,4508,255;0;0,2,8,100,0,54,4362,4408,46,0
17379ref1,4423,4638,JUNC00000091,2,-,4423,4638,255;0;0,2,20,146,0,69,4443,4492,49,0
17379ref1,4415,4688,JUNC00000092,2,-,4415,4688,255;0;0,2,117,149,0,124,4532,4539,7,0
17379ref1,4395,4793,JUNC00000093,3,-,4395,4793,255;0;0,2,144,119,0,279,4539,4674,135,0
17379ref1,4742,4933,JUNC00000094,1809,+,4742,4933,255;0;0,2,23,150,0,41,4765,4783,18,0
17379ref1,4939,5158,JUNC00000095,2,-,4939,5158,255;0;0,2,26,146,0,73,4965,5012,47,0
17379ref1,4836,5151,JUNC00000096,3,-,4836,5151,255;0;0,2,144,149,0,166,4980,5002,22,0
17379ref1,5399,5710,JUNC00000097,1357,+,5399,5710,255;0;0,2,150,147,0,164,5549,5563,14,0
17379ref1,5407,5713,JUNC00000098,18,-,5407,5713,255;0;0,2,150,150,0,156,5557,5563,6,0
17379ref1,5519,5778,JUNC00000099,14,-,5519,5778,255;0;0,2,81,145,0,114,5600,5633,33,0
17379ref1,5633,6006,JUNC00000100,16,-,5633,6006,255;0;0,2,143,149,0,224,5776,5857,81,0
17379ref1,5701,5987,JUNC00000101,42,+,5701,5987,255;0;0,2,140,133,0,153,5841,5854,13,0
17379ref1,5696,6128,JUNC00000102,12,+,5696,6128,255;0;0,2,148,148,0,284,5844,5980,136,0
17379ref1,5728,6033,JUNC00000103,10,+,5728,6033,255;0;0,2,150,149,0,156,5878,5884,6,0
17379ref1,5825,6142,JUNC00000104,8,+,5825,6142,255;0;0,2,149,150,0,167,5974,5992,18,0
17379ref1,5952,6157,JUNC00000105,3,+,5952,6157,255;0;0,2,24,150,0,55,5976,6007,31,0
17379ref1,5949,6339,JUNC00000106,67,+,5949,6339,255;0;0,2,117,136,0,254,6066,6203,137,0
17379ref1,6101,9992,JUNC00000107,938,-,6101,9992,255;0;0,2,148,141,0,3750,6249,9851,3602,0
17379ref1,6441,6825,JUNC00000108,746,+,6441,6825,255;0;0,2,150,149,0,235,6591,6676,85,0
17379ref1,6546,6824,JUNC00000109,119,+,6546,6824,255;0;0,2,58,74,0,204,6604,6750,146,0
17379ref1,6484,7157,JUNC00000110,131,-,6484,7157,255;0;0,2,145,146,0,527,6629,7011,382,0
17379ref1,6656,6887,JUNC00000111,17,-,6656,6887,255;0;0,2,38,145,0,86,6694,6742,48,0
17379ref1,6711,6889,JUNC00000112,23,+,6711,6889,255;0;0,2,9,147,0,31,6720,6742,22,0
17379ref1,6582,6907,JUNC00000113,6,-,6582,6907,255;0;0,2,147,149,0,176,6729,6758,29,0
17379ref1,6650,7405,JUNC00000114,36,+,6650,7405,255;0;0,2,145,148,0,607,6795,7257,462,0
17379ref1,6855,7108,JUNC00000115,1191,-,6855,7108,255;0;0,2,150,39,0,214,7005,7069,64,0
17379ref1,6928,7640,JUNC00000116,2,+,6928,7640,255;0;0,2,145,146,0,566,7073,7494,421,0
17379ref1,6968,7338,JUNC00000117,4,+,6968,7338,255;0;0,2,147,149,0,221,7115,7189,74,0
17379ref1,6970,7284,JUNC00000118,7,-,6970,7284,255;0;0,2,148,150,0,164,7118,7134,16,0
17379ref1,6989,7290,JUNC00000119,77,+,6989,7290,255;0;0,2,148,148,0,153,7137,7142,5,0
17379ref1,7100,7840,JUNC00000120,99,+,7100,7840,255;0;0,2,143,141,0,599,7243,7699,456,0
17379ref1,7126,7427,JUNC00000121,3,+,7126,7427,255;0;0,2,146,150,0,151,7272,7277,5,0
17379ref1,7154,7491,JUNC00000122,4,-,7154,7491,255;0;0,2,147,149,0,188,7301,7342,41,0
17379ref1,7157,7482,JUNC00000123,9,+,7157,7482,255;0;0,2,149,149,0,176,7306,7333,27,0
17379ref1,7179,7526,JUNC00000124,94,-,7179,7526,255;0;0,2,146,150,0,197,7325,7376,51,0
17379ref1,7312,7671,JUNC00000125,4,+,7312,7671,255;0;0,2,62,88,0,271,7374,7583,209,0
17379ref1,7280,7531,JUNC00000126,2,-,7280,7531,255;0;0,2,149,96,0,155,7429,7435,6,0
17379ref1,7415,7713,JUNC00000127,1,-,7415,7713,255;0;0,2,21,86,0,212,7436,7627,191,0
17379ref1,7362,7725,JUNC00000128,91,-,7362,7725,255;0;0,2,149,147,0,216,7511,7578,67,0
17379ref1,7385,7701,JUNC00000129,3,-,7385,7701,255;0;0,2,145,145,0,171,7530,7556,26,0
17379ref1,7425,7596,JUNC00000130,4,-,7425,7596,255;0;0,2,148,18,0,153,7573,7578,5,0
17379ref1,7571,7804,JUNC00000131,5,+,7571,7804,255;0;0,2,89,108,0,125,7660,7696,36,0
17379ref1,7555,8006,JUNC00000132,13,+,7555,8006,255;0;0,2,144,139,0,312,7699,7867,168,0
17379ref1,7551,7971,JUNC00000133,132,+,7551,7971,255;0;0,2,148,98,0,322,7699,7873,174,0
17379ref1,7765,7897,JUNC00000134,2,-,7765,7897,255;0;0,2,11,48,0,84,7776,7849,73,0
17379ref1,7695,8035,JUNC00000135,19,+,7695,8035,255;0;0,2,145,150,0,190,7840,7885,45,0
17379ref1,7830,7995,JUNC00000136,3,+,7830,7995,255;0;0,2,27,128,0,37,7857,7867,10,0
17379ref1,7710,8064,JUNC00000137,3,-,7710,8064,255;0;0,2,147,148,0,206,7857,7916,59,0
17379ref1,7723,8065,JUNC00000138,104,-,7723,8065,255;0;0,2,143,149,0,193,7866,7916,50,0
17379ref1,7772,8027,JUNC00000139,24,-,7772,8027,255;0;0,2,103,147,0,108,7875,7880,5,0
17379ref1,7963,8279,JUNC00000140,106,-,7963,8279,255;0;0,2,149,150,0,166,8112,8129,17,0
17379ref1,7968,8296,JUNC00000141,5,-,7968,8296,255;0;0,2,144,146,0,182,8112,8150,38,0
17379ref1,7968,8270,JUNC00000142,6,-,7968,8270,255;0;0,2,147,149,0,153,8115,8121,6,0
17379ref1,8137,8418,JUNC00000143,3,+,8137,8418,255;0;0,2,149,126,0,155,8286,8292,6,0
17379ref1,8429,8747,JUNC00000144,1,+,8429,8747,255;0;0,2,9,141,0,177,8438,8606,168,0
17379ref1,8394,8623,JUNC00000145,19,+,8394,8623,255;0;0,2,94,77,0,152,8488,8546,58,0
17379ref1,8767,9078,JUNC00000146,544,-,8767,9078,255;0;0,2,150,145,0,166,8917,8933,16,0
17379ref1,8802,9078,JUNC00000147,1011,+,8802,9078,255;0;0,2,121,150,0,126,8923,8928,5,0
17379ref1,9036,9281,JUNC00000148,2,-,9036,9281,255;0;0,2,38,149,0,96,9074,9132,58,0
17379ref1,9478,9699,JUNC00000149,2,+,9478,9699,255;0;0,2,149,67,0,154,9627,9632,5,0
17379ref1,9497,9848,JUNC00000150,103,+,9497,9848,255;0;0,2,150,148,0,203,9647,9700,53,0
17379ref1,9646,9851,JUNC00000151,10,+,9646,9851,255;0;0,2,19,149,0,56,9665,9702,37,0
17379ref1,9655,9872,JUNC00000152,17,-,9655,9872,255;0;0,2,29,150,0,67,9684,9722,38,0
17379ref1,9680,9846,JUNC00000153,2,-,9680,9846,255;0;0,2,8,146,0,20,9688,9700,12,0
17379ref1,9722,9973,JUNC00000154,168,-,9722,9973,255;0;0,2,87,149,0,102,9809,9824,15,0
17379ref1,9678,10119,JUNC00000155,3,-,9678,10119,255;0;0,2,146,149,0,292,9824,9970,146,0
17379ref1,9827,10028,JUNC00000156,2,+,9827,10028,255;0;0,2,22,146,0,55,9849,9882,33,0
17379ref1,9955,10252,JUNC00000157,1,-,9955,10252,255;0;0,2,19,131,0,166,9974,10121,147,0
17379ref1,10021,10218,JUNC00000158,1,+,10021,10218,255;0;0,2,125,26,0,171,10146,10192,46,0
17640ref1,552,10282,JUNC00000001,4,+,552,10282,255;0;0,2,75,76,0,9654,627,10206,9579,0
17640ref1,635,7531,JUNC00000002,225,+,635,7531,255;0;0,2,21,146,0,6750,656,7385,6729,0
17640ref1,613,844,JUNC00000003,48,+,613,844,255;0;0,2,61,148,0,83,674,696,22,0
17640ref1,647,8149,JUNC00000004,6,+,647,8149,255;0;0,2,27,142,0,7360,674,8007,7333,0
17640ref1,676,969,JUNC00000005,249,+,676,969,255;0;0,2,117,143,0,150,793,826,33,0
17640ref1,789,967,JUNC00000006,1,-,789,967,255;0;0,2,44,107,0,71,833,860,27,0
17640ref1,711,1096,JUNC00000007,38,+,711,1096,255;0;0,2,147,147,0,238,858,949,91,0
17640ref1,811,1027,JUNC00000008,37,+,811,1027,255;0;0,2,56,149,0,67,867,878,11,0
17640ref1,729,1058,JUNC00000009,10,+,729,1058,255;0;0,2,149,148,0,181,878,910,32,0
17640ref1,825,1125,JUNC00000010,91,+,825,1125,255;0;0,2,144,149,0,151,969,976,7,0
17640ref1,899,8777,JUNC00000011,1,+,899,8777,255;0;0,2,92,16,0,7862,991,8761,7770,0
17640ref1,973,2601,JUNC00000012,11,+,973,2601,255;0;0,2,42,143,0,1485,1015,2458,1443,0
17640ref1,971,4431,JUNC00000013,27,+,971,4431,255;0;0,2,44,143,0,3317,1015,4288,3273,0
17640ref1,913,1087,JUNC00000014,53,+,913,1087,255;0;0,2,147,8,0,166,1060,1079,19,0
17640ref1,955,1243,JUNC00000015,1165,-,955,1243,255;0;0,2,146,85,0,203,1101,1158,57,0
17640ref1,965,1269,JUNC00000016,15,+,965,1269,255;0;0,2,149,149,0,155,1114,1120,6,0
17640ref1,973,1276,JUNC00000017,13,+,973,1276,255;0;0,2,149,148,0,155,1122,1128,6,0
17640ref1,979,1142,JUNC00000018,47,-,979,1142,255;0;0,2,149,9,0,154,1128,1133,5,0
17640ref1,979,1308,JUNC00000019,107,-,979,1308,255;0;0,2,149,150,0,179,1128,1158,30,0
17640ref1,1000,1302,JUNC00000020,15,-,1000,1302,255;0;0,2,150,147,0,155,1150,1155,5,0
17640ref1,1001,1304,JUNC00000021,65,-,1001,1304,255;0;0,2,149,146,0,157,1150,1158,8,0
17640ref1,1004,7698,JUNC00000022,22,-,1004,7698,255;0;0,2,150,147,0,6547,1154,7551,6397,0
17640ref1,1196,1506,JUNC00000023,5,-,1196,1506,255;0;0,2,147,148,0,162,1343,1358,15,0
17640ref1,1373,1683,JUNC00000024,48,+,1373,1683,255;0;0,2,131,118,0,192,1504,1565,61,0
17640ref1,1526,2789,JUNC00000025,3,+,1526,2789,255;0;0,2,60,92,0,1171,1586,2697,1111,0
17640ref1,1537,1854,JUNC00000026,14,+,1537,1854,255;0;0,2,149,149,0,168,1686,1705,19,0
17640ref1,1606,1973,JUNC00000027,408,-,1606,1973,255;0;0,2,145,147,0,220,1751,1826,75,0
17640ref1,1771,1853,JUNC00000028,1,+,1771,1853,255;0;0,2,9,47,0,35,1780,1806,26,0
17640ref1,1692,2035,JUNC00000029,10,-,1692,2035,255;0;0,2,123,150,0,193,1815,1885,70,0
17640ref1,1776,2042,JUNC00000030,12,+,1776,2042,255;0;0,2,48,150,0,116,1824,1892,68,0
17640ref1,1701,2058,JUNC00000031,37,-,1701,2058,255;0;0,2,125,146,0,211,1826,1912,86,0
17640ref1,1704,2066,JUNC00000032,2,+,1704,2066,255;0;0,2,146,148,0,214,1850,1918,68,0
17640ref1,1834,2013,JUNC00000033,5,+,1834,2013,255;0;0,2,26,147,0,32,1860,1866,6,0
17640ref1,1873,2194,JUNC00000034,3,+,1873,2194,255;0;0,2,150,150,0,171,2023,2044,21,0
17640ref1,2169,2473,JUNC00000035,63,-,2169,2473,255;0;0,2,150,149,0,155,2319,2324,5,0
17640ref1,2172,2476,JUNC00000036,695,+,2172,2476,255;0;0,2,150,149,0,155,2322,2327,5,0
17640ref1,2238,2574,JUNC00000037,68,-,2238,2574,255;0;0,2,150,150,0,186,2388,2424,36,0
17640ref1,2386,2720,JUNC00000038,26,-,2386,2720,255;0;0,2,150,68,0,266,2536,2652,116,0
17640ref1,2557,2720,JUNC00000039,2,+,2557,2720,255;0;0,2,8,142,0,21,2565,2578,13,0
17640ref1,2436,2747,JUNC00000040,11,+,2436,2747,255;0;0,2,148,148,0,163,2584,2599,15,0
17640ref1,2490,2776,JUNC00000041,31,+,2490,2776,255;0;0,2,99,147,0,139,2589,2629,40,0
17640ref1,2449,2763,JUNC00000042,12,+,2449,2763,255;0;0,2,149,150,0,164,2598,2613,15,0
17640ref1,2479,2817,JUNC00000043,28,+,2479,2817,255;0;0,2,142,147,0,191,2621,2670,49,0
17640ref1,2610,2920,JUNC00000044,196,+,2610,2920,255;0;0,2,99,149,0,161,2709,2771,62,0
17640ref1,2634,4040,JUNC00000045,192,+,2634,4040,255;0;0,2,137,146,0,1260,2771,3894,1123,0
17640ref1,2660,2988,JUNC00000046,132,+,2660,2988,255;0;0,2,146,148,0,180,2806,2840,34,0
17640ref1,2667,2905,JUNC00000047,204,-,2667,2905,255;0;0,2,149,49,0,189,2816,2856,40,0
17640ref1,2670,3004,JUNC00000048,10,-,2670,3004,255;0;0,2,150,146,0,188,2820,2858,38,0
17640ref1,2698,2864,JUNC00000049,30,+,2698,2864,255;0;0,2,148,8,0,158,2846,2856,10,0
17640ref1,2715,3030,JUNC00000050,38,+,2715,3030,255;0;0,2,150,149,0,166,2865,2881,16,0
17640ref1,2857,2960,JUNC00000051,1,-,2857,2960,255;0;0,2,34,41,0,62,2891,2919,28,0
17640ref1,2848,6157,JUNC00000052,78,-,2848,6157,255;0;0,2,119,31,0,3278,2967,6126,3159,0
17640ref1,2891,3204,JUNC00000053,2,+,2891,3204,255;0;0,2,109,150,0,163,3000,3054,54,0
17640ref1,2911,3215,JUNC00000054,30,-,2911,3215,255;0;0,2,125,150,0,154,3036,3065,29,0
17640ref1,2981,3150,JUNC00000055,3,-,2981,3150,255;0;0,2,111,40,0,129,3092,3110,18,0
17640ref1,2994,3317,JUNC00000056,9,+,2994,3317,255;0;0,2,150,148,0,175,3144,3169,25,0
17640ref1,3022,3319,JUNC00000057,139,+,3022,3319,255;0;0,2,149,123,0,174,3171,3196,25,0
17640ref1,3036,3343,JUNC00000058,14,+,3036,3343,255;0;0,2,148,150,0,157,3184,3193,9,0
17640ref1,3037,9492,JUNC00000059,97,+,3037,9492,255;0;0,2,147,150,0,6305,3184,9342,6158,0
17640ref1,3047,3357,JUNC00000060,10,-,3047,3357,255;0;0,2,150,149,0,161,3197,3208,11,0
17640ref1,3199,3434,JUNC00000061,73,-,3199,3434,255;0;0,2,58,150,0,85,3257,3284,27,0
17640ref1,3229,3421,JUNC00000062,3,+,3229,3421,255;0;0,2,124,27,0,165,3353,3394,41,0
17640ref1,3612,3913,JUNC00000063,703,-,3612,3913,255;0;0,2,150,146,0,155,3762,3767,5,0
17640ref1,3739,3965,JUNC00000064,336,+,3739,3965,255;0;0,2,47,149,0,77,3786,3816,30,0
17640ref1,3789,8501,JUNC00000065,1,-,3789,8501,255;0;0,2,130,21,0,4691,3919,8480,4561,0
17640ref1,3833,4173,JUNC00000066,68,+,3833,4173,255;0;0,2,97,148,0,192,3930,4025,95,0
17640ref1,3923,4141,JUNC00000067,11,+,3923,4141,255;0;0,2,23,150,0,68,3946,3991,45,0
17640ref1,3912,4110,JUNC00000068,47,+,3912,4110,255;0;0,2,44,149,0,49,3956,3961,5,0
17640ref1,3856,4195,JUNC00000069,7,-,3856,4195,255;0;0,2,149,148,0,191,4005,4047,42,0
17640ref1,3958,7273,JUNC00000070,21,-,3958,7273,255;0;0,2,149,147,0,3168,4107,7126,3019,0
17640ref1,4096,4386,JUNC00000071,216,+,4096,4386,255;0;0,2,90,149,0,141,4186,4237,51,0
17640ref1,4211,4418,JUNC00000072,18,+,4211,4418,255;0;0,2,46,147,0,60,4257,4271,14,0
17640ref1,4228,4460,JUNC00000073,18,+,4228,4460,255;0;0,2,29,150,0,82,4257,4310,53,0
17640ref1,4159,4471,JUNC00000074,5,+,4159,4471,255;0;0,2,116,148,0,164,4275,4323,48,0
17640ref1,4262,4583,JUNC00000075,16,-,4262,4583,255;0;0,2,25,145,0,176,4287,4438,151,0
17640ref1,4225,4430,JUNC00000076,44,+,4225,4430,255;0;0,2,150,25,0,180,4375,4405,30,0
17640ref1,4237,8507,JUNC00000077,77,+,4237,8507,255;0;0,2,143,146,0,4124,4380,8361,3981,0
17640ref1,4397,4698,JUNC00000078,423,-,4397,4698,255;0;0,2,100,143,0,158,4497,4555,58,0
17640ref1,4381,4734,JUNC00000079,42,+,4381,4734,255;0;0,2,148,70,0,283,4529,4664,135,0
17640ref1,4430,4817,JUNC00000080,215,-,4430,4817,255;0;0,2,102,150,0,237,4532,4667,135,0
17640ref1,4402,4824,JUNC00000081,93,-,4402,4824,255;0;0,2,137,150,0,272,4539,4674,135,0
17640ref1,4577,5002,JUNC00000082,62,+,4577,5002,255;0;0,2,147,149,0,276,4724,4853,129,0
17640ref1,4850,8622,JUNC00000083,244,-,4850,8622,255;0;0,2,115,142,0,3630,4965,8480,3515,0
17640ref1,5276,9205,JUNC00000084,1,+,5276,9205,255;0;0,2,100,51,0,3878,5376,9154,3778,0
17640ref1,5450,5860,JUNC00000085,263,+,5450,5860,255;0;0,2,150,146,0,264,5600,5714,114,0
17640ref1,5583,5776,JUNC00000086,47,-,5583,5776,255;0;0,2,21,148,0,45,5604,5628,24,0
17640ref1,5492,5791,JUNC00000087,90,-,5492,5791,255;0;0,2,146,148,0,151,5638,5643,5,0
17640ref1,5886,7717,JUNC00000088,3,-,5886,7717,255;0;0,2,67,143,0,1688,5953,7574,1621,0
17640ref1,5837,6155,JUNC00000089,3,+,5837,6155,255;0;0,2,125,143,0,175,5962,6012,50,0
17640ref1,5825,6161,JUNC00000090,278,-,5825,6161,255;0;0,2,149,147,0,189,5974,6014,40,0
17640ref1,5864,6265,JUNC00000091,3,+,5864,6265,255;0;0,2,148,34,0,367,6012,6231,219,0
17640ref1,5902,7650,JUNC00000092,2,+,5902,7650,255;0;0,2,148,62,0,1686,6050,7588,1538,0
17640ref1,6074,6280,JUNC00000093,121,-,6074,6280,255;0;0,2,46,149,0,57,6120,6131,11,0
17640ref1,6068,6294,JUNC00000094,1030,-,6068,6294,255;0;0,2,58,150,0,76,6126,6144,18,0
17640ref1,6212,6519,JUNC00000095,5,+,6212,6519,255;0;0,2,148,148,0,159,6360,6371,11,0
17640ref1,6535,6758,JUNC00000096,3,-,6535,6758,255;0;0,2,148,16,0,207,6683,6742,59,0
17640ref1,6547,6886,JUNC00000097,54,-,6547,6886,255;0;0,2,147,144,0,195,6694,6742,48,0
17640ref1,6894,7124,JUNC00000098,1,+,6894,7124,255;0;0,2,72,35,0,195,6966,7089,123,0
17640ref1,6977,7364,JUNC00000099,270,-,6977,7364,255;0;0,2,38,150,0,237,7015,7214,199,0
17640ref1,6971,7276,JUNC00000100,73,+,6971,7276,255;0;0,2,149,150,0,155,7120,7126,6,0
17640ref1,7120,7390,JUNC00000101,36,+,7120,7390,255;0;0,2,8,150,0,120,7128,7240,112,0
17640ref1,7201,7509,JUNC00000102,4,-,7201,7509,255;0;0,2,149,148,0,160,7350,7361,11,0
17640ref1,7362,7580,JUNC00000103,3,-,7362,7580,255;0;0,2,149,24,0,194,7511,7556,45,0
17640ref1,7382,7701,JUNC00000104,20,-,7382,7701,255;0;0,2,150,150,0,169,7532,7551,19,0
17640ref1,7423,7727,JUNC00000105,18,-,7423,7727,255;0;0,2,150,149,0,155,7573,7578,5,0
17640ref1,7513,7796,JUNC00000106,17,+,7513,7796,255;0;0,2,147,97,0,186,7660,7699,39,0
17640ref1,7539,7845,JUNC00000107,22,+,7539,7845,255;0;0,2,150,149,0,157,7689,7696,7,0
17640ref1,7549,9774,JUNC00000108,72,+,7549,9774,255;0;0,2,150,137,0,2088,7699,9637,1938,0
17640ref1,7624,7929,JUNC00000109,3,+,7624,7929,255;0;0,2,104,140,0,165,7728,7789,61,0
17640ref1,7594,7987,JUNC00000110,25,-,7594,7987,255;0;0,2,139,148,0,245,7733,7839,106,0
17640ref1,7742,8044,JUNC00000111,11,+,7742,8044,255;0;0,2,22,150,0,152,7764,7894,130,0
17640ref1,7673,7931,JUNC00000112,2,-,7673,7931,255;0;0,2,103,25,0,233,7776,7906,130,0
17640ref1,7703,7877,JUNC00000113,1,-,7703,7877,255;0;0,2,123,28,0,146,7826,7849,23,0
17640ref1,7692,8014,JUNC00000114,2,+,7692,8014,255;0;0,2,148,147,0,175,7840,7867,27,0
17640ref1,7702,7883,JUNC00000115,13,-,7702,7883,255;0;0,2,146,8,0,173,7848,7875,27,0
17640ref1,7699,8041,JUNC00000116,6,-,7699,8041,255;0;0,2,149,150,0,192,7848,7891,43,0
17640ref1,7709,8014,JUNC00000117,3,+,7709,8014,255;0;0,2,148,150,0,155,7857,7864,7,0
17640ref1,7718,7881,JUNC00000118,6,+,7718,7881,255;0;0,2,148,8,0,155,7866,7873,7,0
17640ref1,7723,8064,JUNC00000119,49,-,7723,8064,255;0;0,2,143,148,0,193,7866,7916,50,0
17640ref1,7901,8083,JUNC00000120,3,-,7901,8083,255;0;0,2,71,105,0,77,7972,7978,6,0
17640ref1,7941,9321,JUNC00000121,2,-,7941,9321,255;0;0,2,46,105,0,1275,7987,9216,1229,0
17640ref1,7978,9135,JUNC00000122,3,+,7978,9135,255;0;0,2,149,23,0,1134,8127,9112,985,0
17640ref1,8332,9250,JUNC00000123,2,+,8332,9250,255;0;0,2,42,150,0,768,8374,9100,726,0
17640ref1,8283,8587,JUNC00000124,194,+,8283,8587,255;0;0,2,148,149,0,155,8431,8438,7,0
17640ref1,8367,8696,JUNC00000125,587,+,8367,8696,255;0;0,2,150,42,0,287,8517,8654,137,0
17640ref1,8765,9076,JUNC00000126,501,+,8765,9076,255;0;0,2,150,148,0,163,8915,8928,13,0
17640ref1,8765,9144,JUNC00000127,859,+,8765,9144,255;0;0,2,150,147,0,232,8915,8997,82,0
17640ref1,8773,9078,JUNC00000128,2829,+,8773,9078,255;0;0,2,150,150,0,155,8923,8928,5,0
17640ref1,8955,9281,JUNC00000129,24,-,8955,9281,255;0;0,2,147,149,0,177,9102,9132,30,0
17640ref1,9008,9235,JUNC00000130,29,-,9008,9235,255;0;0,2,150,41,0,186,9158,9194,36,0
17640ref1,9031,9781,JUNC00000131,4,+,9031,9781,255;0;0,2,143,149,0,601,9174,9632,458,0
17640ref1,9033,9353,JUNC00000132,15,+,9033,9353,255;0;0,2,146,146,0,174,9179,9207,28,0
17640ref1,10049,10326,JUNC00000133,3,+,10049,10326,255;0;0,2,143,72,0,205,10192,10254,62,0
18217ref1,331,642,JUNC00000001,18,+,331,642,255;0;0,2,150,150,0,161,481,492,11,0
18217ref1,480,791,JUNC00000002,12,+,480,791,255;0;0,2,147,146,0,165,627,645,18,0
18217ref1,594,833,JUNC00000003,43,+,594,833,255;0;0,2,33,147,0,92,627,686,59,0
18217ref1,600,890,JUNC00000004,20,-,600,890,255;0;0,2,50,150,0,140,650,740,90,0
18217ref1,637,792,JUNC00000005,2,-,637,792,255;0;0,2,23,123,0,32,660,669,9,0
18217ref1,615,822,JUNC00000006,8,+,615,822,255;0;0,2,52,148,0,59,667,674,7,0
18217ref1,642,843,JUNC00000007,25,+,642,843,255;0;0,2,25,149,0,52,667,694,27,0
18217ref1,560,886,JUNC00000008,486,+,560,886,255;0;0,2,114,141,0,185,674,745,71,0
18217ref1,667,848,JUNC00000009,32,+,667,848,255;0;0,2,9,150,0,31,676,698,22,0
18217ref1,653,1012,JUNC00000010,8,+,653,1012,255;0;0,2,57,148,0,211,710,864,154,0
18217ref1,694,1019,JUNC00000011,82,+,694,1019,255;0;0,2,23,148,0,177,717,871,154,0
18217ref1,699,1025,JUNC00000012,22,+,699,1025,255;0;0,2,31,147,0,179,730,878,148,0
18217ref1,619,1869,JUNC00000013,41,+,619,1869,255;0;0,2,149,150,0,1100,768,1719,951,0
18217ref1,777,1024,JUNC00000014,7,-,777,1024,255;0;0,2,8,149,0,98,785,875,90,0
18217ref1,683,1878,JUNC00000015,210,-,683,1878,255;0;0,2,102,142,0,1053,785,1736,951,0
18217ref1,709,1008,JUNC00000016,106,-,709,1008,255;0;0,2,146,148,0,151,855,860,5,0
18217ref1,823,1123,JUNC00000017,80,+,823,1123,255;0;0,2,146,147,0,153,969,976,7,0
18217ref1,825,1168,JUNC00000018,5,+,825,1168,255;0;0,2,144,146,0,197,969,1022,53,0
18217ref1,955,6876,JUNC00000019,4,-,955,6876,255;0;0,2,23,43,0,5878,978,6833,5855,0
18217ref1,974,4729,JUNC00000020,23,-,974,4729,255;0;0,2,50,148,0,3607,1024,4581,3557,0
18217ref1,955,1228,JUNC00000021,876,-,955,1228,255;0;0,2,146,70,0,203,1101,1158,57,0
18217ref1,978,1292,JUNC00000022,8,+,978,1292,255;0;0,2,149,145,0,169,1127,1147,20,0
18217ref1,1000,1300,JUNC00000023,5,-,1000,1300,255;0;0,2,150,145,0,155,1150,1155,5,0
18217ref1,1004,1294,JUNC00000024,109,-,1004,1294,255;0;0,2,146,136,0,154,1150,1158,8,0
18217ref1,1261,1482,JUNC00000025,1,+,1261,1482,255;0;0,2,9,105,0,116,1270,1377,107,0
18217ref1,1234,1445,JUNC00000026,11,+,1234,1445,255;0;0,2,38,150,0,61,1272,1295,23,0
18217ref1,1353,1509,JUNC00000027,1,-,1353,1509,255;0;0,2,10,141,0,15,1363,1368,5,0
18217ref1,1637,1798,JUNC00000028,1,+,1637,1798,255;0;0,2,49,102,0,59,1686,1696,10,0
18217ref1,1607,1973,JUNC00000029,134,-,1607,1973,255;0;0,2,144,147,0,219,1751,1826,75,0
18217ref1,1701,2062,JUNC00000030,460,-,1701,2062,255;0;0,2,125,150,0,211,1826,1912,86,0
18217ref1,2112,2295,JUNC00000031,5,+,2112,2295,255;0;0,2,24,148,0,35,2136,2147,11,0
18217ref1,2239,2841,JUNC00000032,55,+,2239,2841,255;0;0,2,149,149,0,453,2388,2692,304,0
18217ref1,2369,2842,JUNC00000033,32,+,2369,2842,255;0;0,2,24,145,0,328,2393,2697,304,0
18217ref1,2374,2608,JUNC00000034,11,+,2374,2608,255;0;0,2,24,150,0,84,2398,2458,60,0
18217ref1,2358,2568,JUNC00000035,7,+,2358,2568,255;0;0,2,48,150,0,60,2406,2418,12,0
18217ref1,2330,2647,JUNC00000036,13,+,2330,2647,255;0;0,2,145,150,0,167,2475,2497,22,0
18217ref1,2479,2777,JUNC00000037,24,+,2479,2777,255;0;0,2,22,148,0,150,2501,2629,128,0
18217ref1,2474,2871,JUNC00000038,1,+,2474,2871,255;0;0,2,27,124,0,273,2501,2747,246,0
18217ref1,2475,2799,JUNC00000039,21,-,2475,2799,255;0;0,2,61,147,0,177,2536,2652,116,0
18217ref1,2419,2717,JUNC00000040,8,-,2419,2717,255;0;0,2,147,146,0,152,2566,2571,5,0
18217ref1,2432,2753,JUNC00000041,7,+,2432,2753,255;0;0,2,146,147,0,174,2578,2606,28,0
18217ref1,2477,2963,JUNC00000042,19,+,2477,2963,255;0;0,2,101,79,0,407,2578,2884,306,0
18217ref1,2533,2776,JUNC00000043,8,+,2533,2776,255;0;0,2,47,147,0,96,2580,2629,49,0
18217ref1,2444,2777,JUNC00000044,14,-,2444,2777,255;0;0,2,150,148,0,185,2594,2629,35,0
18217ref1,2568,2965,JUNC00000045,12,-,2568,2965,255;0;0,2,26,149,0,248,2594,2816,222,0
18217ref1,2451,2781,JUNC00000046,98,-,2451,2781,255;0;0,2,147,148,0,182,2598,2633,35,0
18217ref1,2608,2941,JUNC00000047,22,-,2608,2941,255;0;0,2,8,150,0,183,2616,2791,175,0
18217ref1,2482,2788,JUNC00000048,5,+,2482,2788,255;0;0,2,149,150,0,156,2631,2638,7,0
18217ref1,2523,2866,JUNC00000049,2,+,2523,2866,255;0;0,2,147,147,0,196,2670,2719,49,0
18217ref1,2641,2895,JUNC00000050,11,+,2641,2895,255;0;0,2,29,144,0,110,2670,2751,81,0
18217ref1,2660,2839,JUNC00000051,13,+,2660,2839,255;0;0,2,25,149,0,30,2685,2690,5,0
18217ref1,2561,8541,JUNC00000052,12,+,2561,8541,255;0;0,2,150,149,0,5831,2711,8392,5681,0
18217ref1,2629,6090,JUNC00000053,103,+,2629,6090,255;0;0,2,142,147,0,3314,2771,5943,3172,0
18217ref1,2667,2858,JUNC00000054,14,-,2667,2858,255;0;0,2,149,26,0,165,2816,2832,16,0
18217ref1,2697,2987,JUNC00000055,20,+,2697,2987,255;0;0,2,126,147,0,143,2823,2840,17,0
18217ref1,2681,2991,JUNC00000056,26,+,2681,2991,255;0;0,2,149,149,0,161,2830,2842,12,0
18217ref1,2760,3160,JUNC00000057,2,+,2760,3160,255;0;0,2,70,81,0,319,2830,3079,249,0
18217ref1,2697,3006,JUNC00000058,25,+,2697,3006,255;0;0,2,149,150,0,159,2846,2856,10,0
18217ref1,2857,5322,JUNC00000059,1,+,2857,5322,255;0;0,2,26,125,0,2340,2883,5197,2314,0
18217ref1,2751,3069,JUNC00000060,24,+,2751,3069,255;0;0,2,142,150,0,168,2893,2919,26,0
18217ref1,2787,7997,JUNC00000061,475,+,2787,7997,255;0;0,2,132,75,0,5135,2919,7922,5003,0
18217ref1,2923,2993,JUNC00000062,2,-,2923,2993,255;0;0,2,26,9,0,61,2949,2984,35,0
18217ref1,2881,3129,JUNC00000063,2,+,2881,3129,255;0;0,2,150,43,0,205,3031,3086,55,0
18217ref1,2941,4060,JUNC00000064,11,+,2941,4060,255;0;0,2,147,147,0,972,3088,3913,825,0
18217ref1,3024,3351,JUNC00000065,327,-,3024,3351,255;0;0,2,149,150,0,177,3173,3201,28,0
18217ref1,3229,3434,JUNC00000066,21,-,3229,3434,255;0;0,2,28,150,0,55,3257,3284,27,0
18217ref1,3617,3977,JUNC00000067,95,-,3617,3977,255;0;0,2,150,144,0,216,3767,3833,66,0
18217ref1,3620,4229,JUNC00000068,412,-,3620,4229,255;0;0,2,147,141,0,468,3767,4088,321,0
18217ref1,3772,6191,JUNC00000069,1102,+,3772,6191,255;0;0,2,130,10,0,2409,3902,6181,2279,0
18217ref1,3879,4076,JUNC00000070,28,-,3879,4076,255;0;0,2,40,147,0,50,3919,3929,10,0
18217ref1,3904,4170,JUNC00000071,205,+,3904,4170,255;0;0,2,26,145,0,121,3930,4025,95,0
18217ref1,3943,4139,JUNC00000072,71,+,3943,4139,255;0;0,2,25,148,0,48,3968,3991,23,0
18217ref1,3873,4477,JUNC00000073,11,+,3873,4477,255;0;0,2,126,148,0,456,3999,4329,330,0
18217ref1,3913,4220,JUNC00000074,101,+,3913,4220,255;0;0,2,146,145,0,162,4059,4075,16,0
18217ref1,3987,4238,JUNC00000075,194,+,3987,4238,255;0;0,2,94,150,0,101,4081,4088,7,0
18217ref1,4059,4297,JUNC00000076,119,+,4059,4297,255;0;0,2,61,148,0,90,4120,4149,29,0
18217ref1,4146,4467,JUNC00000077,1,+,4146,4467,255;0;0,2,24,127,0,194,4170,4340,170,0
18217ref1,4052,4604,JUNC00000078,58,+,4052,4604,255;0;0,2,124,148,0,404,4176,4456,280,0
18217ref1,4192,4407,JUNC00000079,3,-,4192,4407,255;0;0,2,47,150,0,65,4239,4257,18,0
18217ref1,4126,4418,JUNC00000080,24,+,4126,4418,255;0;0,2,131,147,0,145,4257,4271,14,0
18217ref1,4170,4562,JUNC00000081,13,-,4170,4562,255;0;0,2,130,150,0,242,4300,4412,112,0
18217ref1,4221,4564,JUNC00000082,20,-,4221,4564,255;0;0,2,79,150,0,193,4300,4414,114,0
18217ref1,4176,4526,JUNC00000083,209,+,4176,4526,255;0;0,2,147,91,0,259,4323,4435,112,0
18217ref1,4213,4523,JUNC00000084,6,-,4213,4523,255;0;0,2,129,149,0,161,4342,4374,32,0
18217ref1,4206,4624,JUNC00000085,2,+,4206,4624,255;0;0,2,150,150,0,268,4356,4474,118,0
18217ref1,4264,4567,JUNC00000086,181,-,4264,4567,255;0;0,2,149,149,0,154,4413,4418,5,0
18217ref1,4439,7572,JUNC00000087,56,-,4439,7572,255;0;0,2,47,149,0,2984,4486,7423,2937,0
18217ref1,4394,4698,JUNC00000088,250,-,4394,4698,255;0;0,2,103,143,0,161,4497,4555,58,0
18217ref1,4442,4815,JUNC00000089,2,-,4442,4815,255;0;0,2,97,141,0,232,4539,4674,135,0
18217ref1,4723,4926,JUNC00000090,160,+,4723,4926,255;0;0,2,42,143,0,60,4765,4783,18,0
18217ref1,4617,4950,JUNC00000091,5,+,4617,4950,255;0;0,2,148,146,0,187,4765,4804,39,0
18217ref1,4716,5235,JUNC00000092,5,-,4716,5235,255;0;0,2,147,148,0,371,4863,5087,224,0
18217ref1,4791,5246,JUNC00000093,133,-,4791,5246,255;0;0,2,139,149,0,306,4930,5097,167,0
18217ref1,4897,5151,JUNC00000094,23,-,4897,5151,255;0;0,2,83,149,0,105,4980,5002,22,0
18217ref1,5327,5653,JUNC00000095,3,-,5327,5653,255;0;0,2,149,148,0,178,5476,5505,29,0
18217ref1,5451,5778,JUNC00000096,6,-,5451,5778,255;0;0,2,149,145,0,182,5600,5633,33,0
18217ref1,5734,5931,JUNC00000097,3,+,5734,5931,255;0;0,2,107,77,0,120,5841,5854,13,0
18217ref1,5728,6028,JUNC00000098,7,+,5728,6028,255;0;0,2,150,144,0,156,5878,5884,6,0
18217ref1,6101,7740,JUNC00000099,203,-,6101,7740,255;0;0,2,148,134,0,1505,6249,7606,1357,0
18217ref1,6265,6448,JUNC00000100,22,+,6265,6448,255;0;0,2,25,150,0,33,6290,6298,8,0
18217ref1,6741,7087,JUNC00000101,2,+,6741,7087,255;0;0,2,146,21,0,325,6887,7066,179,0
18217ref1,7215,7561,JUNC00000102,351,-,7215,7561,255;0;0,2,72,143,0,203,7287,7418,131,0
18217ref1,7283,7545,JUNC00000103,47,-,7283,7545,255;0;0,2,52,149,0,113,7335,7396,61,0
18217ref1,7239,7604,JUNC00000104,1,+,7239,7604,255;0;0,2,128,23,0,342,7367,7581,214,0
18217ref1,7362,7671,JUNC00000105,72,-,7362,7671,255;0;0,2,149,93,0,216,7511,7578,67,0
18217ref1,7424,7671,JUNC00000106,9,-,7424,7671,255;0;0,2,149,93,0,154,7573,7578,5,0
18217ref1,7714,7896,JUNC00000107,1,+,7714,7896,255;0;0,2,27,124,0,58,7741,7772,31,0
18217ref1,7684,7965,JUNC00000108,1,-,7684,7965,255;0;0,2,92,59,0,222,7776,7906,130,0
18217ref1,7659,9984,JUNC00000109,1,-,7659,9984,255;0;0,2,117,34,0,2291,7776,9950,2174,0
18217ref1,7776,8035,JUNC00000110,20,-,7776,8035,255;0;0,2,30,144,0,115,7806,7891,85,0
18217ref1,7718,7897,JUNC00000111,12,+,7718,7897,255;0;0,2,148,24,0,155,7866,7873,7,0
18217ref1,7723,8066,JUNC00000112,63,-,7723,8066,255;0;0,2,143,150,0,193,7866,7916,50,0
18217ref1,7920,8148,JUNC00000113,23,-,7920,8148,255;0;0,2,8,149,0,79,7928,7999,71,0
18217ref1,7891,8191,JUNC00000114,2,+,7891,8191,255;0;0,2,143,147,0,153,8034,8044,10,0
18217ref1,7894,9124,JUNC00000115,16,+,7894,9124,255;0;0,2,146,147,0,1083,8040,8977,937,0
18217ref1,7965,8278,JUNC00000116,73,-,7965,8278,255;0;0,2,147,149,0,164,8112,8129,17,0
18217ref1,8007,8339,JUNC00000117,68,+,8007,8339,255;0;0,2,149,150,0,182,8156,8189,33,0
18217ref1,8333,8588,JUNC00000118,505,+,8333,8588,255;0;0,2,98,150,0,105,8431,8438,7,0
18217ref1,8286,8596,JUNC00000119,3,+,8286,8596,255;0;0,2,145,100,0,210,8431,8496,65,0
18217ref1,8431,8799,JUNC00000120,64,+,8431,8799,255;0;0,2,82,150,0,218,8513,8649,136,0
18217ref1,8555,9076,JUNC00000121,208,+,8555,9076,255;0;0,2,150,148,0,373,8705,8928,223,0
18217ref1,8828,9061,JUNC00000122,1,+,8828,9061,255;0;0,2,87,64,0,169,8915,8997,82,0
18217ref1,8802,9078,JUNC00000123,2248,+,8802,9078,255;0;0,2,121,150,0,126,8923,8928,5,0
18217ref1,9048,9381,JUNC00000124,3,+,9048,9381,255;0;0,2,149,147,0,186,9197,9234,37,0
18217ref1,9667,9972,JUNC00000125,214,-,9667,9972,255;0;0,2,142,148,0,157,9809,9824,15,0
18217ref1,9858,10032,JUNC00000126,5,-,9858,10032,255;0;0,2,8,143,0,31,9866,9889,23,0
18217ref1,9790,10049,JUNC00000127,52,-,9790,10049,255;0;0,2,87,149,0,110,9877,9900,23,0
18217ref1,9845,10097,JUNC00000128,2,-,9845,10097,255;0;0,2,37,114,0,138,9882,9983,101,0
18217ref1,9809,10246,JUNC00000129,3,+,9809,10246,255;0;0,2,148,38,0,399,9957,10208,251,0
18286ref2,871,9561,JUNC00000005,130,+,871,9561,255;0;0,2,144,150,0,8540,1015,9411,8396,0
18286ref2,1949,10427,JUNC00000012,2,+,1949,10427,255;0;0,2,32,119,0,8359,1981,10308,8327,0
18286ref2,7648,9262,JUNC00000026,2,+,7648,9262,255;0;0,2,51,114,0,1500,7699,9148,1449,0
18286ref2,5139,6126,JUNC00000023,500,+,5139,6126,255;0;0,2,150,60,0,927,5289,6066,777,0
18286ref2,9676,10249,JUNC00000029,173,+,9676,10249,255;0;0,2,150,150,0,423,9826,10099,273,0
18286ref2,2504,3005,JUNC00000013,4,+,2504,3005,255;0;0,2,148,147,0,354,2652,2858,206,0
18286ref2,5583,6072,JUNC00000024,508,-,5583,6072,255;0;0,2,150,150,0,339,5733,5922,189,0
18286ref2,700,1019,JUNC00000002,28,+,700,1019,255;0;0,2,32,148,0,171,732,871,139,0
18286ref2,1784,2044,JUNC00000009,21,-,1784,2044,255;0;0,2,42,132,0,128,1826,1912,86,0
18286ref2,1708,1973,JUNC00000008,2,-,1708,1973,255;0;0,2,43,147,0,118,1751,1826,75,0
18286ref2,506,877,JUNC00000001,1110,+,506,877,255;0;0,2,150,147,0,224,656,730,74,0
18286ref2,2941,3161,JUNC00000015,3,-,2941,3161,255;0;0,2,8,147,0,73,2949,3014,65,0
18286ref2,926,1279,JUNC00000006,2,+,926,1279,255;0;0,2,145,146,0,207,1071,1133,62,0
18286ref2,4429,4705,JUNC00000022,423,-,4429,4705,255;0;0,2,68,150,0,126,4497,4555,58,0
18286ref2,9054,9236,JUNC00000028,1,-,9054,9236,255;0;0,2,24,104,0,78,9078,9132,54,0
18286ref2,826,1128,JUNC00000004,4,+,826,1128,255;0;0,2,143,106,0,196,969,1022,53,0
18286ref2,1727,1939,JUNC00000010,2,-,1727,1939,255;0;0,2,133,27,0,185,1860,1912,52,0
18286ref2,9956,10307,JUNC00000030,26,-,9956,10307,255;0;0,2,150,150,0,201,10106,10157,51,0
18286ref2,2611,2939,JUNC00000014,67,-,2611,2939,255;0;0,2,145,150,0,178,2756,2789,33,0
18286ref2,4230,4439,JUNC00000019,35,+,4230,4439,255;0;0,2,145,34,0,175,4375,4405,30,0
18286ref2,4234,4504,JUNC00000020,48,+,4234,4504,255;0;0,2,146,96,0,174,4380,4408,28,0
18286ref2,3174,3385,JUNC00000017,2,-,3174,3385,255;0;0,2,83,101,0,110,3257,3284,27,0
18286ref2,1973,2149,JUNC00000011,2,-,1973,2149,255;0;0,2,8,143,0,33,1981,2006,25,0
18286ref2,4209,4418,JUNC00000018,4,+,4209,4418,255;0;0,2,48,147,0,62,4257,4271,14,0
18286ref2,2817,3128,JUNC00000016,46,-,2817,3128,255;0;0,2,150,150,0,161,2967,2978,11,0
18286ref2,1002,1302,JUNC00000007,15,-,1002,1302,255;0;0,2,148,144,0,156,1150,1158,8,0
18286ref2,6970,7276,JUNC00000025,455,+,6970,7276,255;0;0,2,150,150,0,156,7120,7126,6,0
18286ref2,710,1008,JUNC00000003,157,-,710,1008,255;0;0,2,145,148,0,150,855,860,5,0
18286ref2,4264,4568,JUNC00000021,227,-,4264,4568,255;0;0,2,149,150,0,154,4413,4418,5,0
18286ref2,8773,9078,JUNC00000027,928,+,8773,9078,255;0;0,2,150,150,0,155,8923,8928,5,0
18319ref2,974,6244,JUNC00000018,532,+,974,6244,255;0;0,2,148,144,0,5126,1122,6100,4978,0
18319ref2,4246,9274,JUNC00000064,1,-,4246,9274,255;0;0,2,93,58,0,4970,4339,9216,4877,0
18319ref2,4544,9704,JUNC00000075,2,-,4544,9704,255;0;0,2,145,146,0,5014,4689,9558,4869,0
18319ref2,961,6007,JUNC00000015,6,+,961,6007,255;0;0,2,150,150,0,4896,1111,5857,4746,0
18319ref2,2973,7710,JUNC00000046,23,+,2973,7710,255;0;0,2,99,148,0,4589,3072,7562,4490,0
18319ref2,2725,6493,JUNC00000038,1,-,2725,6493,255;0;0,2,77,74,0,3694,2802,6419,3617,0
18319ref2,4308,7708,JUNC00000063,1,+,4308,7708,255;0;0,2,31,120,0,3280,4339,7588,3249,0
18319ref2,2690,5314,JUNC00000041,193,+,2690,5314,255;0;0,2,140,150,0,2474,2830,5164,2334,0
18319ref2,6211,7635,JUNC00000084,17,-,6211,7635,255;0;0,2,38,29,0,1395,6249,7606,1357,0
18319ref2,6190,7737,JUNC00000087,17,+,6190,7737,255;0;0,2,146,147,0,1400,6336,7590,1254,0
18319ref2,2035,2846,JUNC00000029,3,+,2035,2846,255;0;0,2,35,149,0,662,2070,2697,627,0
18319ref2,4184,4628,JUNC00000059,13,-,4184,4628,255;0;0,2,10,147,0,297,4194,4481,287,0
18319ref2,3932,4367,JUNC00000052,6,+,3932,4367,255;0;0,2,50,148,0,287,3982,4219,237,0
18319ref2,4003,4402,JUNC00000056,2,+,4003,4402,255;0;0,2,22,145,0,254,4025,4257,232,0
18319ref2,1740,2120,JUNC00000023,4,+,1740,2120,255;0;0,2,9,148,0,232,1749,1972,223,0
18319ref2,7365,7733,JUNC00000094,17,+,7365,7733,255;0;0,2,24,148,0,220,7389,7585,196,0
18319ref2,7292,7769,JUNC00000095,34,-,7292,7769,255;0;0,2,144,146,0,331,7436,7623,187,0
18319ref2,6515,6966,JUNC00000088,40,+,6515,6966,255;0;0,2,149,148,0,303,6664,6818,154,0
18319ref2,7705,8056,JUNC00000106,22,-,7705,8056,255;0;0,2,47,150,0,201,7752,7906,154,0
18319ref2,5573,6023,JUNC00000080,7,+,5573,6023,255;0;0,2,149,149,0,301,5722,5874,152,0
18319ref2,8294,8739,JUNC00000118,72,+,8294,8739,255;0;0,2,150,150,0,295,8444,8589,145,0
18319ref2,4398,4740,JUNC00000072,21,-,4398,4740,255;0;0,2,141,66,0,276,4539,4674,135,0
18319ref2,4430,4705,JUNC00000073,2,-,4430,4705,255;0;0,2,125,26,0,249,4555,4679,124,0
18319ref2,2397,2779,JUNC00000034,3,-,2397,2779,255;0;0,2,139,127,0,255,2536,2652,116,0
18319ref2,8367,8749,JUNC00000120,3,+,8367,8749,255;0;0,2,121,147,0,235,8488,8602,114,0
18319ref2,4290,4572,JUNC00000062,159,+,4290,4572,255;0;0,2,33,137,0,145,4323,4435,112,0
18319ref2,8959,9276,JUNC00000123,33,+,8959,9276,255;0;0,2,71,146,0,171,9030,9130,100,0
18319ref2,7182,7477,JUNC00000091,3,+,7182,7477,255;0;0,2,63,144,0,151,7245,7333,88,0
18319ref2,7751,8065,JUNC00000107,147,-,7751,8065,255;0;0,2,78,149,0,165,7829,7916,87,0
18319ref2,1799,2057,JUNC00000025,7,-,1799,2057,255;0;0,2,27,145,0,113,1826,1912,86,0
18319ref2,7809,8155,JUNC00000112,187,+,7809,8155,255;0;0,2,113,148,0,198,7922,8007,85,0
18319ref2,2071,2446,JUNC00000031,2,-,2071,2446,255;0;0,2,148,146,0,229,2219,2300,81,0
18319ref2,2941,3170,JUNC00000043,2,-,2941,3170,255;0;0,2,8,144,0,85,2949,3026,77,0
18319ref2,7008,7384,JUNC00000090,18,-,7008,7384,255;0;0,2,150,149,0,227,7158,7235,77,0
18319ref2,1606,1974,JUNC00000024,177,-,1606,1974,255;0;0,2,145,148,0,220,1751,1826,75,0
18319ref2,686,946,JUNC00000004,6,+,686,946,255;0;0,2,52,134,0,126,738,812,74,0
18319ref2,10230,10567,JUNC00000128,2,-,10230,10567,255;0;0,2,115,148,0,189,10345,10419,74,0
18319ref2,10161,10443,JUNC00000127,2,+,10161,10443,255;0;0,2,147,62,0,220,10308,10381,73,0
18319ref2,1782,1946,JUNC00000026,3,+,1782,1946,255;0;0,2,68,28,0,136,1850,1918,68,0
18319ref2,9014,9331,JUNC00000124,3,+,9014,9331,255;0;0,2,106,143,0,174,9120,9188,68,0
18319ref2,7362,7725,JUNC00000096,114,-,7362,7725,255;0;0,2,149,147,0,216,7511,7578,67,0
18319ref2,5017,5257,JUNC00000078,12,+,5017,5257,255;0;0,2,147,27,0,213,5164,5230,66,0
18319ref2,7512,7865,JUNC00000103,5,+,7512,7865,255;0;0,2,148,145,0,208,7660,7720,60,0
18319ref2,8224,8578,JUNC00000117,738,-,8224,8578,255;0;0,2,150,145,0,209,8374,8433,59,0
18319ref2,4449,4674,JUNC00000070,163,-,4449,4674,255;0;0,2,48,119,0,106,4497,4555,58,0
18319ref2,8342,8569,JUNC00000119,18,+,8342,8569,255;0;0,2,146,23,0,204,8488,8546,58,0
18319ref2,955,1307,JUNC00000014,920,-,955,1307,255;0;0,2,146,149,0,203,1101,1158,57,0
18319ref2,1974,2182,JUNC00000030,1,+,1974,2182,255;0;0,2,125,26,0,182,2099,2156,57,0
18319ref2,9091,9320,JUNC00000125,11,+,9091,9320,255;0;0,2,146,26,0,203,9237,9294,57,0
18319ref2,4216,4568,JUNC00000066,2,+,4216,4568,255;0;0,2,148,150,0,202,4364,4418,54,0
18319ref2,825,1171,JUNC00000013,17,+,825,1171,255;0;0,2,144,149,0,197,969,1022,53,0
18319ref2,1818,1936,JUNC00000027,1,-,1818,1936,255;0;0,2,42,24,0,94,1860,1912,52,0
18319ref2,4118,4337,JUNC00000058,3,+,4118,4337,255;0;0,2,49,120,0,99,4167,4217,50,0
18319ref2,5742,6017,JUNC00000081,16,-,5742,6017,255;0;0,2,78,147,0,128,5820,5870,50,0
18319ref2,7926,8143,JUNC00000113,2,-,7926,8143,255;0;0,2,18,149,0,68,7944,7994,50,0
18319ref2,3985,4184,JUNC00000053,8,+,3985,4184,255;0;0,2,8,149,0,50,3993,4035,42,0
18319ref2,3905,4197,JUNC00000054,8,-,3905,4197,255;0;0,2,100,150,0,142,4005,4047,42,0
18319ref2,3988,4204,JUNC00000055,28,-,3988,4204,255;0;0,2,26,150,0,66,4014,4054,40,0
18319ref2,7512,7756,JUNC00000102,9,+,7512,7756,255;0;0,2,148,57,0,187,7660,7699,39,0
18319ref2,5808,6142,JUNC00000082,4,-,5808,6142,255;0;0,2,147,149,0,185,5955,5993,38,0
18319ref2,2182,2476,JUNC00000032,59,+,2182,2476,255;0;0,2,109,149,0,145,2291,2327,36,0
18319ref2,7517,7705,JUNC00000101,3,+,7517,7705,255;0;0,2,143,9,0,179,7660,7696,36,0
18319ref2,2661,2989,JUNC00000039,54,+,2661,2989,255;0;0,2,145,149,0,179,2806,2840,34,0
18319ref2,621,953,JUNC00000005,3,+,621,953,255;0;0,2,149,150,0,182,770,803,33,0
18319ref2,729,1058,JUNC00000009,95,+,729,1058,255;0;0,2,149,148,0,181,878,910,32,0
18319ref2,4490,4678,JUNC00000071,24,-,4490,4678,255;0;0,2,9,147,0,41,4499,4531,32,0
18319ref2,4325,4531,JUNC00000065,56,-,4325,4531,255;0;0,2,27,149,0,57,4352,4382,30,0
18319ref2,5938,6265,JUNC00000083,2,+,5938,6265,255;0;0,2,148,149,0,178,6086,6116,30,0
18319ref2,8010,8337,JUNC00000116,3,+,8010,8337,255;0;0,2,149,148,0,179,8159,8189,30,0
18319ref2,4232,4556,JUNC00000068,9,+,4232,4556,255;0;0,2,148,148,0,176,4380,4408,28,0
18319ref2,7786,8035,JUNC00000109,24,+,7786,8035,255;0;0,2,71,150,0,99,7857,7885,28,0
18319ref2,7838,8042,JUNC00000110,18,+,7838,8042,255;0;0,2,28,148,0,56,7866,7894,28,0
18319ref2,3108,3434,JUNC00000049,43,-,3108,3434,255;0;0,2,149,150,0,176,3257,3284,27,0
18319ref2,7702,7909,JUNC00000108,29,-,7702,7909,255;0;0,2,146,34,0,173,7848,7875,27,0
18319ref2,690,1010,JUNC00000007,6,+,690,1010,255;0;0,2,150,144,0,176,840,866,26,0
18319ref2,3959,4281,JUNC00000057,9,-,3959,4281,255;0;0,2,150,147,0,175,4109,4134,25,0
18319ref2,3725,4043,JUNC00000051,941,+,3725,4043,255;0;0,2,145,149,0,169,3870,3894,24,0
18319ref2,7438,7712,JUNC00000097,30,+,7438,7712,255;0;0,2,101,150,0,124,7539,7562,23,0
18319ref2,527,847,JUNC00000003,5,+,527,847,255;0;0,2,149,149,0,171,676,698,22,0
18319ref2,765,976,JUNC00000006,112,+,765,976,255;0;0,2,39,150,0,61,804,826,22,0
18319ref2,464,779,JUNC00000001,2,+,464,779,255;0;0,2,149,146,0,169,613,633,20,0
18319ref2,527,840,JUNC00000002,15,+,527,840,255;0;0,2,147,146,0,167,674,694,20,0
18319ref2,978,1293,JUNC00000019,76,+,978,1293,255;0;0,2,149,146,0,169,1127,1147,20,0
18319ref2,7495,7712,JUNC00000098,20,+,7495,7712,255;0;0,2,47,150,0,67,7542,7562,20,0
18319ref2,3047,3365,JUNC00000048,9,-,3047,3365,255;0;0,2,150,150,0,168,3197,3215,18,0
18319ref2,4726,4933,JUNC00000076,993,+,4726,4933,255;0;0,2,39,150,0,57,4765,4783,18,0
18319ref2,969,1281,JUNC00000017,14,+,969,1281,255;0;0,2,147,148,0,164,1116,1133,17,0
18319ref2,7963,8279,JUNC00000114,128,-,7963,8279,255;0;0,2,149,150,0,166,8112,8129,17,0
18319ref2,824,1133,JUNC00000012,21,+,824,1133,255;0;0,2,145,148,0,161,969,985,16,0
18319ref2,2671,2852,JUNC00000040,64,-,2671,2852,255;0;0,2,145,20,0,161,2816,2832,16,0
18319ref2,2698,3009,JUNC00000042,14,+,2698,3009,255;0;0,2,148,147,0,164,2846,2862,16,0
18319ref2,5086,5301,JUNC00000077,2,+,5086,5301,255;0;0,2,50,149,0,66,5136,5152,16,0
18319ref2,2449,2763,JUNC00000036,22,+,2449,2763,255;0;0,2,149,150,0,164,2598,2613,15,0
18319ref2,2582,2687,JUNC00000037,4,+,2582,2687,255;0;0,2,32,58,0,47,2614,2629,15,0
18319ref2,4198,4406,JUNC00000060,6,-,4198,4406,255;0;0,2,44,149,0,59,4242,4257,15,0
18319ref2,5107,5326,JUNC00000079,12,+,5107,5326,255;0;0,2,149,55,0,164,5256,5271,15,0
18319ref2,4206,4418,JUNC00000061,20,+,4206,4418,255;0;0,2,51,147,0,65,4257,4271,14,0
18319ref2,7300,7534,JUNC00000093,248,+,7300,7534,255;0;0,2,71,149,0,85,7371,7385,14,0
18319ref2,2823,3131,JUNC00000045,68,-,2823,3131,255;0;0,2,149,147,0,161,2972,2984,12,0
18319ref2,3659,3965,JUNC00000050,797,-,3659,3965,255;0;0,2,150,144,0,162,3809,3821,12,0
18319ref2,2817,3127,JUNC00000044,157,-,2817,3127,255;0;0,2,150,149,0,161,2967,2978,11,0
18319ref2,2213,2519,JUNC00000033,2,-,2213,2519,255;0;0,2,149,148,0,158,2362,2371,9,0
18319ref2,4608,4729,JUNC00000074,1,+,4608,4729,255;0;0,2,47,65,0,56,4655,4664,9,0
18319ref2,8007,8315,JUNC00000115,96,+,8007,8315,255;0;0,2,149,150,0,158,8156,8165,9,0
18319ref2,8933,9168,JUNC00000122,6,+,8933,9168,255;0;0,2,80,146,0,89,9013,9022,9,0
18319ref2,968,1269,JUNC00000016,7,+,968,1269,255;0;0,2,146,147,0,154,1114,1122,8,0
18319ref2,1001,1307,JUNC00000021,73,-,1001,1307,255;0;0,2,149,149,0,157,1150,1158,8,0
18319ref2,6107,6409,JUNC00000085,8,-,6107,6409,255;0;0,2,148,146,0,156,6255,6263,8,0
18319ref2,6112,6418,JUNC00000086,91,+,6112,6418,255;0;0,2,149,149,0,157,6261,6269,8,0
18319ref2,7423,7690,JUNC00000100,11,-,7423,7690,255;0;0,2,150,109,0,158,7573,7581,8,0
18319ref2,824,1125,JUNC00000011,77,+,824,1125,255;0;0,2,145,149,0,152,969,976,7,0
18319ref2,1289,1571,JUNC00000022,4,-,1289,1571,255;0;0,2,149,126,0,156,1438,1445,7,0
18319ref2,1756,2060,JUNC00000028,2,-,1756,2060,255;0;0,2,149,148,0,156,1905,1912,7,0
18319ref2,4229,4532,JUNC00000067,2,-,4229,4532,255;0;0,2,146,150,0,153,4375,4382,7,0
18319ref2,7528,7835,JUNC00000104,5,+,7528,7835,255;0;0,2,150,150,0,157,7678,7685,7,0
18319ref2,7539,7845,JUNC00000105,11,+,7539,7845,255;0;0,2,150,149,0,157,7689,7696,7,0
18319ref2,9491,9794,JUNC00000126,3,+,9491,9794,255;0;0,2,148,148,0,155,9639,9646,7,0
18319ref2,858,1097,JUNC00000010,45,+,858,1097,255;0;0,2,85,148,0,91,943,949,6,0
18319ref2,2444,2746,JUNC00000035,4,+,2444,2746,255;0;0,2,149,147,0,155,2593,2599,6,0
18319ref2,6970,7275,JUNC00000089,623,+,6970,7275,255;0;0,2,150,149,0,156,7120,7126,6,0
18319ref2,708,1007,JUNC00000008,6,-,708,1007,255;0;0,2,147,147,0,152,855,860,5,0
18319ref2,1002,1302,JUNC00000020,3,-,1002,1302,255;0;0,2,148,147,0,153,1150,1155,5,0
18319ref2,2943,3125,JUNC00000047,4,-,2943,3125,255;0;0,2,149,28,0,154,3092,3097,5,0
18319ref2,4264,4568,JUNC00000069,275,-,4264,4568,255;0;0,2,149,150,0,154,4413,4418,5,0
18319ref2,7245,7401,JUNC00000092,1,-,7245,7401,255;0;0,2,90,61,0,95,7335,7340,5,0
18319ref2,7423,7596,JUNC00000099,8,-,7423,7596,255;0;0,2,150,18,0,155,7573,7578,5,0
18319ref2,7725,7971,JUNC00000111,32,-,7725,7971,255;0;0,2,150,91,0,155,7875,7880,5,0
18319ref2,8814,9078,JUNC00000121,2710,+,8814,9078,255;0;0,2,109,150,0,114,8923,8928,5,0
16516ref2,981,9661,JUNC00000042,13,+,981,9661,255;0;0,2,133,150,0,8530,1114,9511,8397,0
16516ref2,892,9104,JUNC00000032,18,+,892,9104,255;0;0,2,104,148,0,8064,996,8956,7960,0
16516ref2,869,9088,JUNC00000031,19,+,869,9088,255;0;0,2,127,148,0,8071,996,8940,7944,0
16516ref2,789,8576,JUNC00000027,3,+,789,8576,255;0;0,2,149,146,0,7641,938,8430,7492,0
16516ref2,352,7841,JUNC00000004,5,+,352,7841,255;0;0,2,150,52,0,7437,502,7789,7287,0
16516ref2,1000,7700,JUNC00000046,12,+,1000,7700,255;0;0,2,148,147,0,6553,1148,7553,6405,0
16516ref2,3958,10301,JUNC00000107,13,+,3958,10301,255;0;0,2,67,146,0,6197,4025,10155,6130,0
16516ref2,758,6652,JUNC00000019,1,+,758,6652,255;0;0,2,35,116,0,5778,793,6536,5743,0
16516ref2,4208,9750,JUNC00000114,2,+,4208,9750,255;0;0,2,115,65,0,5477,4323,9685,5362,0
16516ref2,626,5646,JUNC00000017,5,-,626,5646,255;0;0,2,131,136,0,4884,757,5510,4753,0
16516ref2,980,5776,JUNC00000033,15,+,980,5776,255;0;0,2,22,145,0,4651,1002,5631,4629,0
16516ref2,4233,8902,JUNC00000115,1,-,4233,8902,255;0;0,2,109,42,0,4627,4342,8860,4518,0
16516ref2,3331,7665,JUNC00000103,105,+,3331,7665,255;0;0,2,150,137,0,4197,3481,7528,4047,0
16516ref2,967,4436,JUNC00000043,6,+,967,4436,255;0;0,2,149,148,0,3321,1116,4288,3172,0
16516ref2,6021,8957,JUNC00000150,8,+,6021,8957,255;0;0,2,147,77,0,2859,6168,8880,2712,0
16516ref2,3571,6197,JUNC00000104,1,+,3571,6197,255;0;0,2,80,71,0,2555,3651,6126,2475,0
16516ref2,847,2870,JUNC00000026,2,+,847,2870,255;0;0,2,44,119,0,1904,891,2751,1860,0
16516ref2,2216,4282,JUNC00000076,4,+,2216,4282,255;0;0,2,65,149,0,1917,2281,4133,1852,0
16516ref2,1156,2534,JUNC00000051,16,-,1156,2534,255;0;0,2,124,141,0,1237,1280,2393,1113,0
16516ref2,1274,2540,JUNC00000052,3,-,1274,2540,255;0;0,2,8,145,0,1121,1282,2395,1113,0
16516ref2,1497,2841,JUNC00000064,26,+,1497,2841,255;0;0,2,146,144,0,1200,1643,2697,1054,0
16516ref2,4531,5457,JUNC00000121,98,-,4531,5457,255;0;0,2,143,150,0,776,4674,5307,633,0
16516ref2,9211,9892,JUNC00000212,2,-,9211,9892,255;0;0,2,86,41,0,640,9297,9851,554,0
16516ref2,6836,7540,JUNC00000154,1,+,6836,7540,255;0;0,2,80,71,0,633,6916,7469,553,0
16516ref2,9752,10376,JUNC00000216,2,+,9752,10376,255;0;0,2,23,128,0,496,9775,10248,473,0
16516ref2,493,1150,JUNC00000010,10,+,493,1150,255;0;0,2,53,148,0,509,546,1002,456,0
16516ref2,7099,7709,JUNC00000156,57,+,7099,7709,255;0;0,2,144,10,0,600,7243,7699,456,0
16516ref2,7055,7627,JUNC00000155,1,+,7055,7627,255;0;0,2,18,133,0,439,7073,7494,421,0
16516ref2,7232,7830,JUNC00000158,110,-,7232,7830,255;0;0,2,55,145,0,453,7287,7685,398,0
16516ref2,867,1552,JUNC00000036,7,+,867,1552,255;0;0,2,148,144,0,541,1015,1408,393,0
16516ref2,7985,8523,JUNC00000177,1,+,7985,8523,255;0;0,2,9,142,0,396,7994,8381,387,0
16516ref2,7999,8538,JUNC00000179,663,+,7999,8538,255;0;0,2,8,144,0,395,8007,8394,387,0
16516ref2,4576,5252,JUNC00000122,5,+,4576,5252,255;0;0,2,148,149,0,527,4724,5103,379,0
16516ref2,545,1148,JUNC00000013,14,+,545,1148,255;0;0,2,82,146,0,457,627,1002,375,0
16516ref2,4528,5188,JUNC00000120,2,+,4528,5188,255;0;0,2,142,147,0,513,4670,5041,371,0
16516ref2,2228,2748,JUNC00000079,1,+,2228,2748,255;0;0,2,99,51,0,469,2327,2697,370,0
16516ref2,4617,5156,JUNC00000125,10,+,4617,5156,255;0;0,2,148,43,0,496,4765,5113,348,0
16516ref2,7981,8568,JUNC00000183,7,+,7981,8568,255;0;0,2,146,99,0,488,8127,8469,342,0
16516ref2,9674,10262,JUNC00000218,4,-,9674,10262,255;0;0,2,150,96,0,492,9824,10166,342,0
16516ref2,4690,5178,JUNC00000126,1,+,4690,5178,255;0;0,2,125,26,0,462,4815,5152,337,0
16516ref2,6743,7330,JUNC00000153,35,-,6743,7330,255;0;0,2,149,116,0,471,6892,7214,322,0
16516ref2,8737,9184,JUNC00000194,1,+,8737,9184,255;0;0,2,104,47,0,400,8841,9137,296,0
16516ref2,871,1452,JUNC00000035,27,+,871,1452,255;0;0,2,144,144,0,437,1015,1308,293,0
16516ref2,7330,7757,JUNC00000161,1,-,7330,7757,255;0;0,2,79,72,0,355,7409,7685,276,0
16516ref2,1390,1808,JUNC00000061,1,+,1390,1808,255;0;0,2,75,76,0,342,1465,1732,267,0
16516ref2,2700,3110,JUNC00000095,60,+,2700,3110,255;0;0,2,148,8,0,402,2848,3102,254,0
16516ref2,2705,3199,JUNC00000094,7,+,2705,3199,255;0;0,2,125,120,0,374,2830,3079,249,0
16516ref2,2390,2775,JUNC00000082,1,+,2390,2775,255;0;0,2,46,105,0,280,2436,2670,234,0
16516ref2,3875,4403,JUNC00000106,12,+,3875,4403,255;0;0,2,150,146,0,382,4025,4257,232,0
16516ref2,5304,5686,JUNC00000134,1,+,5304,5686,255;0;0,2,96,55,0,327,5400,5631,231,0
16516ref2,714,1232,JUNC00000024,26,-,714,1232,255;0;0,2,146,147,0,371,860,1085,225,0
16516ref2,8905,9277,JUNC00000197,426,+,8905,9277,255;0;0,2,10,145,0,227,8915,9132,217,0
16516ref2,7853,8218,JUNC00000176,1,-,7853,8218,255;0;0,2,91,60,0,305,7944,8158,214,0
16516ref2,2150,2603,JUNC00000077,22,+,2150,2603,255;0;0,2,141,102,0,351,2291,2501,210,0
16516ref2,253,750,JUNC00000001,116,+,253,750,255;0;0,2,150,142,0,355,403,608,205,0
16516ref2,7935,8428,JUNC00000181,16,+,7935,8428,255;0;0,2,146,149,0,344,8081,8279,198,0
16516ref2,596,1060,JUNC00000016,2,-,596,1060,255;0;0,2,148,120,0,344,744,940,196,0
16516ref2,1450,1942,JUNC00000063,9,+,1450,1942,255;0;0,2,148,149,0,343,1598,1793,195,0
16516ref2,8929,9259,JUNC00000200,1,+,8929,9259,255;0;0,2,22,129,0,201,8951,9130,179,0
16516ref2,4455,4783,JUNC00000119,1,+,4455,4783,255;0;0,2,111,39,0,289,4566,4744,178,0
16516ref2,7551,8015,JUNC00000170,15,+,7551,8015,255;0;0,2,148,142,0,322,7699,7873,174,0
16516ref2,2671,3139,JUNC00000092,11,-,2671,3139,255;0;0,2,149,148,0,320,2820,2991,171,0
16516ref2,7554,7980,JUNC00000169,10,+,7554,7980,255;0;0,2,145,113,0,313,7699,7867,168,0
16516ref2,4087,4469,JUNC00000110,4,+,4087,4469,255;0;0,2,71,146,0,236,4158,4323,165,0
16516ref2,8661,9069,JUNC00000193,2,+,8661,9069,255;0;0,2,114,129,0,279,8775,8940,165,0
16516ref2,8906,9233,JUNC00000198,3853,+,8906,9233,255;0;0,2,15,150,0,177,8921,9083,162,0
16516ref2,483,813,JUNC00000005,12,-,483,813,255;0;0,2,26,144,0,186,509,669,160,0
16516ref2,379,837,JUNC00000007,13,+,379,837,255;0;0,2,149,149,0,309,528,688,160,0
16516ref2,513,838,JUNC00000008,27,+,513,838,255;0;0,2,21,144,0,181,534,694,160,0
16516ref2,8907,9201,JUNC00000196,3,+,8907,9201,255;0;0,2,8,126,0,168,8915,9075,160,0
16516ref2,5467,5772,JUNC00000136,1,+,5467,5772,255;0;0,2,96,55,0,250,5563,5717,154,0
16516ref2,8360,8702,JUNC00000188,2,+,8360,8702,255;0;0,2,86,102,0,240,8446,8600,154,0
16516ref2,381,701,JUNC00000006,11,-,381,701,255;0;0,2,147,25,0,295,528,676,148,0
16516ref2,8289,8731,JUNC00000186,350,+,8289,8731,255;0;0,2,149,146,0,296,8438,8585,147,0
16516ref2,2146,2566,JUNC00000075,15,+,2146,2566,255;0;0,2,128,148,0,272,2274,2418,144,0
16516ref2,779,1112,JUNC00000020,883,+,779,1112,255;0;0,2,47,146,0,187,826,966,140,0
16516ref2,4395,4733,JUNC00000118,8,-,4395,4733,255;0;0,2,144,59,0,279,4539,4674,135,0
16516ref2,4030,4314,JUNC00000108,2,-,4030,4314,255;0;0,2,77,74,0,210,4107,4240,133,0
16516ref2,1538,1849,JUNC00000065,8,+,1538,1849,255;0;0,2,145,34,0,277,1683,1815,132,0
16516ref2,8737,9020,JUNC00000192,1327,+,8737,9020,255;0;0,2,38,113,0,170,8775,8907,132,0
16516ref2,418,837,JUNC00000011,11,+,418,837,255;0;0,2,144,149,0,270,562,688,126,0
16516ref2,1913,2246,JUNC00000074,6,-,1913,2246,255;0;0,2,150,57,0,276,2063,2189,126,0
16516ref2,8930,9224,JUNC00000202,2,+,8930,9224,255;0;0,2,40,130,0,164,8970,9094,124,0
16516ref2,7434,7724,JUNC00000163,3,+,7434,7724,255;0;0,2,142,25,0,265,7576,7699,123,0
16516ref2,9026,9447,JUNC00000210,11,+,9026,9447,255;0;0,2,148,150,0,271,9174,9297,123,0
16516ref2,5824,6121,JUNC00000144,33,-,5824,6121,255;0;0,2,148,28,0,269,5972,6093,121,0
16516ref2,9782,10054,JUNC00000219,3,+,9782,10054,255;0;0,2,67,84,0,188,9849,9970,121,0
16516ref2,1244,1662,JUNC00000057,40,+,1244,1662,255;0;0,2,149,150,0,268,1393,1512,119,0
16516ref2,3212,3409,JUNC00000102,1,+,3212,3409,255;0;0,2,64,15,0,182,3276,3394,118,0
16516ref2,8994,9382,JUNC00000208,3,+,8994,9382,255;0;0,2,126,145,0,243,9120,9237,117,0
16516ref2,1910,2295,JUNC00000073,829,+,1910,2295,255;0;0,2,124,145,0,240,2034,2150,116,0
16516ref2,7546,7867,JUNC00000164,5,+,7546,7867,255;0;0,2,58,149,0,172,7604,7718,114,0
16516ref2,1283,1583,JUNC00000059,7,-,1283,1583,255;0;0,2,142,45,0,255,1425,1538,113,0
16516ref2,4222,4563,JUNC00000113,2,+,4222,4563,255;0;0,2,101,128,0,213,4323,4435,112,0
16516ref2,4781,5044,JUNC00000127,1,-,4781,5044,255;0;0,2,119,32,0,231,4900,5012,112,0
16516ref2,1261,1670,JUNC00000058,34,+,1261,1670,255;0;0,2,150,149,0,260,1411,1521,110,0
16516ref2,7977,8260,JUNC00000178,5,+,7977,8260,255;0;0,2,25,148,0,135,8002,8112,110,0
16516ref2,8699,8954,JUNC00000191,2,+,8699,8954,255;0;0,2,76,69,0,186,8775,8885,110,0
16516ref2,1106,1510,JUNC00000049,2,+,1106,1510,255;0;0,2,150,147,0,257,1256,1363,107,0
16516ref2,1139,1493,JUNC00000050,2,+,1139,1493,255;0;0,2,131,116,0,238,1270,1377,107,0
16516ref2,3968,4322,JUNC00000109,44,-,3968,4322,255;0;0,2,149,100,0,254,4117,4222,105,0
16516ref2,5414,5710,JUNC00000135,3,+,5414,5710,255;0;0,2,46,147,0,149,5460,5563,103,0
16516ref2,1453,1704,JUNC00000060,1,+,1453,1704,255;0;0,2,12,139,0,112,1465,1565,100,0
16516ref2,1346,1648,JUNC00000062,12,+,1346,1648,255;0;0,2,125,83,0,219,1471,1565,94,0
16516ref2,9781,10026,JUNC00000217,1,-,9781,10026,255;0;0,2,25,126,0,119,9806,9900,94,0
16516ref2,2167,2554,JUNC00000078,4,+,2167,2554,255;0;0,2,149,147,0,240,2316,2407,91,0
16516ref2,5196,5584,JUNC00000133,3,+,5196,5584,255;0;0,2,149,150,0,238,5345,5434,89,0
16516ref2,8817,9200,JUNC00000201,8,-,8817,9200,255;0;0,2,148,146,0,237,8965,9054,89,0
16516ref2,388,772,JUNC00000009,3,+,388,772,255;0;0,2,150,147,0,237,538,625,87,0
16516ref2,1748,2031,JUNC00000068,4,-,1748,2031,255;0;0,2,78,119,0,164,1826,1912,86,0
16516ref2,8864,9097,JUNC00000195,1,+,8864,9097,255;0;0,2,51,100,0,133,8915,8997,82,0
16516ref2,2546,2839,JUNC00000089,2,+,2546,2839,255;0;0,2,124,88,0,205,2670,2751,81,0
16516ref2,5633,5980,JUNC00000140,33,-,5633,5980,255;0;0,2,143,123,0,224,5776,5857,81,0
16516ref2,5004,5241,JUNC00000132,10,+,5004,5241,255;0;0,2,150,8,0,229,5154,5233,79,0
16516ref2,7248,7621,JUNC00000160,3,-,7248,7621,255;0;0,2,148,146,0,227,7396,7475,79,0
16516ref2,8991,9260,JUNC00000207,4,+,8991,9260,255;0;0,2,129,63,0,206,9120,9197,77,0
16516ref2,5958,6331,JUNC00000147,17,+,5958,6331,255;0;0,2,147,150,0,223,6105,6181,76,0
16516ref2,9878,10117,JUNC00000221,4,+,9878,10117,255;0;0,2,20,147,0,92,9898,9970,72,0
16516ref2,527,867,JUNC00000015,28,+,527,867,255;0;0,2,147,122,0,218,674,745,71,0
16516ref2,8928,9242,JUNC00000203,21,+,8928,9242,255;0;0,2,95,148,0,166,9023,9094,71,0
16516ref2,2269,2547,JUNC00000081,8,+,2269,2547,255;0;0,2,149,59,0,219,2418,2488,70,0
16516ref2,6743,7106,JUNC00000152,49,-,6743,7106,255;0;0,2,149,144,0,219,6892,6962,70,0
16516ref2,525,836,JUNC00000012,4,+,525,836,255;0;0,2,102,140,0,171,627,696,69,0
16516ref2,1807,2029,JUNC00000067,5,-,1807,2029,255;0;0,2,19,134,0,88,1826,1895,69,0
16516ref2,8333,8583,JUNC00000185,23,+,8333,8583,255;0;0,2,105,77,0,173,8438,8506,68,0
16516ref2,4791,5009,JUNC00000128,1,-,4791,5009,255;0;0,2,116,35,0,183,4907,4974,67,0
16516ref2,7362,7726,JUNC00000162,338,-,7362,7726,255;0;0,2,149,148,0,216,7511,7578,67,0
16516ref2,7685,7921,JUNC00000172,22,-,7685,7921,255;0;0,2,141,30,0,206,7826,7891,65,0
16516ref2,1005,1224,JUNC00000034,4,+,1005,1224,255;0;0,2,10,145,0,74,1015,1079,64,0
16516ref2,1218,1579,JUNC00000053,30,-,1218,1579,255;0;0,2,149,149,0,212,1367,1430,63,0
16516ref2,2454,2668,JUNC00000085,1,+,2454,2668,255;0;0,2,89,62,0,152,2543,2606,63,0
16516ref2,8291,8630,JUNC00000184,23,+,8291,8630,255;0;0,2,147,129,0,210,8438,8501,63,0
16516ref2,9020,9234,JUNC00000206,1,+,9020,9234,255;0;0,2,95,56,0,158,9115,9178,63,0
16516ref2,10053,10266,JUNC00000225,1,+,10053,10266,255;0;0,2,139,12,0,201,10192,10254,62,0
16516ref2,2892,3106,JUNC00000097,10,-,2892,3106,255;0;0,2,144,9,0,205,3036,3097,61,0
16516ref2,7235,7447,JUNC00000159,1,-,7235,7447,255;0;0,2,100,51,0,161,7335,7396,61,0
16516ref2,7586,7929,JUNC00000171,4,+,7586,7929,255;0;0,2,142,140,0,203,7728,7789,61,0
16516ref2,2681,2999,JUNC00000093,3,+,2681,2999,255;0;0,2,149,109,0,209,2830,2890,60,0
16516ref2,973,1166,JUNC00000039,13,-,973,1166,255;0;0,2,126,8,0,185,1099,1158,59,0
16516ref2,4667,4968,JUNC00000124,26,+,4667,4968,255;0;0,2,98,144,0,157,4765,4824,59,0
16516ref2,4260,4558,JUNC00000116,6,-,4260,4558,255;0;0,2,90,150,0,148,4350,4408,58,0
16516ref2,4385,4698,JUNC00000117,53,-,4385,4698,255;0;0,2,112,143,0,170,4497,4555,58,0
16516ref2,8350,8633,JUNC00000189,6,+,8350,8633,255;0;0,2,138,87,0,196,8488,8546,58,0
16516ref2,750,958,JUNC00000025,3,+,750,958,255;0;0,2,128,23,0,185,878,935,57,0
16516ref2,955,1305,JUNC00000040,2075,-,955,1305,255;0;0,2,146,147,0,203,1101,1158,57,0
16516ref2,5891,6099,JUNC00000143,2,+,5891,6099,255;0;0,2,74,77,0,131,5965,6022,57,0
16516ref2,648,876,JUNC00000014,2,+,648,876,255;0;0,2,26,146,0,82,674,730,56,0
16516ref2,8444,8650,JUNC00000190,1,+,8444,8650,255;0;0,2,47,104,0,102,8491,8546,55,0
16516ref2,825,1171,JUNC00000030,88,+,825,1171,255;0;0,2,144,149,0,197,969,1022,53,0
16516ref2,1684,2030,JUNC00000069,10,+,1684,2030,255;0;0,2,145,148,0,198,1829,1882,53,0
16516ref2,9850,10052,JUNC00000220,1,+,9850,10052,255;0;0,2,48,102,0,100,9898,9950,52,0
16516ref2,1753,2055,JUNC00000070,4,+,1753,2055,255;0;0,2,104,149,0,153,1857,1906,49,0
16516ref2,2474,2820,JUNC00000088,7,+,2474,2820,255;0;0,2,147,150,0,196,2621,2670,49,0
16516ref2,8909,9149,JUNC00000204,7,-,8909,9149,255;0;0,2,147,46,0,194,9056,9103,47,0
16516ref2,5687,5889,JUNC00000138,1015,-,5687,5889,255;0;0,2,8,148,0,54,5695,5741,46,0
16516ref2,950,1249,JUNC00000038,335,-,950,1249,255;0;0,2,149,107,0,192,1099,1142,43,0
16516ref2,3049,3341,JUNC00000099,65,+,3049,3341,255;0;0,2,147,105,0,187,3196,3236,40,0
16516ref2,9565,9698,JUNC00000213,1,+,9565,9698,255;0;0,2,22,71,0,62,9587,9627,40,0
16516ref2,5589,5921,JUNC00000139,27,+,5589,5921,255;0;0,2,147,146,0,186,5736,5775,39,0
16516ref2,7512,7776,JUNC00000166,3,+,7512,7776,255;0;0,2,148,77,0,187,7660,7699,39,0
16516ref2,7608,7827,JUNC00000165,2,+,7608,7827,255;0;0,2,52,131,0,88,7660,7696,36,0
16516ref2,946,1278,JUNC00000037,5,+,946,1278,255;0;0,2,149,150,0,182,1095,1128,33,0
16516ref2,1234,1425,JUNC00000055,11,+,1234,1425,255;0;0,2,149,9,0,182,1383,1416,33,0
16516ref2,1918,2169,JUNC00000072,31,+,1918,2169,255;0;0,2,71,147,0,104,1989,2022,33,0
16516ref2,2318,2452,JUNC00000080,8,+,2318,2452,255;0;0,2,67,34,0,100,2385,2418,33,0
16516ref2,2948,3137,JUNC00000096,17,+,2948,3137,255;0;0,2,8,148,0,41,2956,2989,33,0
16516ref2,5544,5780,JUNC00000137,212,-,5544,5780,255;0;0,2,56,147,0,89,5600,5633,33,0
16516ref2,10006,10285,JUNC00000222,3,+,10006,10285,255;0;0,2,100,149,0,130,10106,10136,30,0
16516ref2,737,938,JUNC00000018,10,+,737,938,255;0;0,2,27,145,0,56,764,793,29,0
16516ref2,4993,5319,JUNC00000130,18,+,4993,5319,255;0;0,2,149,148,0,178,5142,5171,29,0
16516ref2,7871,8053,JUNC00000180,8,+,7871,8053,255;0;0,2,144,9,0,173,8015,8044,29,0
16516ref2,8293,8618,JUNC00000187,24,+,8293,8618,255;0;0,2,148,149,0,176,8441,8469,28,0
16516ref2,10081,10260,JUNC00000224,1,+,10081,10260,255;0;0,2,83,68,0,111,10164,10192,28,0
16516ref2,1233,1557,JUNC00000054,7,+,1233,1557,255;0;0,2,148,149,0,175,1381,1408,27,0
16516ref2,3157,3434,JUNC00000101,2415,-,3157,3434,255;0;0,2,100,150,0,127,3257,3284,27,0
16516ref2,1638,1870,JUNC00000066,18,+,1638,1870,255;0;0,2,142,64,0,168,1780,1806,26,0
16516ref2,698,1019,JUNC00000021,9,+,698,1019,255;0;0,2,148,148,0,173,846,871,25,0
16516ref2,974,1231,JUNC00000045,54,+,974,1231,255;0;0,2,148,84,0,173,1122,1147,25,0
16516ref2,1730,1906,JUNC00000071,2,+,1730,1906,255;0;0,2,142,9,0,167,1872,1897,25,0
16516ref2,3023,3343,JUNC00000098,118,+,3023,3343,255;0;0,2,148,147,0,173,3171,3196,25,0
16516ref2,2417,2614,JUNC00000083,8,-,2417,2614,255;0;0,2,23,150,0,47,2440,2464,24,0
16516ref2,3720,4044,JUNC00000105,346,+,3720,4044,255;0;0,2,150,150,0,174,3870,3894,24,0
16516ref2,4991,5307,JUNC00000129,2,+,4991,5307,255;0;0,2,148,146,0,170,5139,5161,22,0
16516ref2,7718,8036,JUNC00000174,8,+,7718,8036,255;0;0,2,148,148,0,170,7866,7888,22,0
16516ref2,707,1024,JUNC00000022,3,-,707,1024,255;0;0,2,147,149,0,168,854,875,21,0
16516ref2,2342,2659,JUNC00000084,19,+,2342,2659,255;0;0,2,149,147,0,170,2491,2512,21,0
16516ref2,2402,2606,JUNC00000086,6,+,2402,2606,255;0;0,2,145,41,0,163,2547,2565,18,0
16516ref2,4744,4924,JUNC00000123,4,+,4744,4924,255;0;0,2,21,141,0,39,4765,4783,18,0
16516ref2,6083,6259,JUNC00000149,10,-,6083,6259,255;0;0,2,43,115,0,61,6126,6144,18,0
16516ref2,7964,8156,JUNC00000182,33,-,7964,8156,255;0;0,2,148,27,0,165,8112,8129,17,0
16516ref2,943,1135,JUNC00000029,272,+,943,1135,255;0;0,2,26,150,0,42,969,985,16,0
16516ref2,2671,2977,JUNC00000091,4,-,2671,2977,255;0;0,2,145,145,0,161,2816,2832,16,0
16516ref2,5903,6214,JUNC00000145,573,+,5903,6214,255;0;0,2,147,148,0,163,6050,6066,16,0
16516ref2,9537,9704,JUNC00000215,1,+,9537,9704,255;0;0,2,102,49,0,118,9639,9655,16,0
16516ref2,2435,2745,JUNC00000087,3,+,2435,2745,255;0;0,2,149,146,0,164,2584,2599,15,0
16516ref2,5986,6231,JUNC00000146,11,-,5986,6231,255;0;0,2,80,150,0,95,6066,6081,15,0
16516ref2,8990,9299,JUNC00000209,3,+,8990,9299,255;0;0,2,146,148,0,161,9136,9151,15,0
16516ref2,4131,4417,JUNC00000112,28,+,4131,4417,255;0;0,2,126,146,0,140,4257,4271,14,0
16516ref2,451,635,JUNC00000002,3,+,451,635,255;0;0,2,23,148,0,36,474,487,13,0
16516ref2,329,639,JUNC00000003,6,+,329,639,255;0;0,2,148,149,0,161,477,490,13,0
16516ref2,770,1019,JUNC00000023,6,+,770,1019,255;0;0,2,88,148,0,101,858,871,13,0
16516ref2,4112,4262,JUNC00000111,2,+,4112,4262,255;0;0,2,94,45,0,105,4206,4217,11,0
16516ref2,5734,6041,JUNC00000142,2,+,5734,6041,255;0;0,2,149,147,0,160,5883,5894,11,0
16516ref2,6083,6276,JUNC00000148,18,-,6083,6276,255;0;0,2,32,150,0,43,6115,6126,11,0
16516ref2,6882,7044,JUNC00000151,2,-,6882,7044,255;0;0,2,10,141,0,21,6892,6903,11,0
16516ref2,7116,7422,JUNC00000157,2,-,7116,7422,255;0;0,2,147,148,0,158,7263,7274,11,0
16516ref2,10102,10278,JUNC00000223,2,+,10102,10278,255;0;0,2,17,148,0,28,10119,10130,11,0
16516ref2,1239,1544,JUNC00000056,11,-,1239,1544,255;0;0,2,147,149,0,156,1386,1395,9,0
16516ref2,9036,9197,JUNC00000211,6,+,9036,9197,255;0;0,2,143,9,0,152,9179,9188,9,0
16516ref2,969,1268,JUNC00000041,4,+,969,1268,255;0;0,2,145,146,0,153,1114,1122,8,0
16516ref2,1001,1255,JUNC00000047,1474,-,1001,1255,255;0;0,2,149,97,0,157,1150,1158,8,0
16516ref2,1077,1381,JUNC00000048,50,+,1077,1381,255;0;0,2,147,149,0,155,1224,1232,8,0
16516ref2,2666,2958,JUNC00000090,4,+,2666,2958,255;0;0,2,140,144,0,148,2806,2814,8,0
16516ref2,824,1126,JUNC00000028,1607,+,824,1126,255;0;0,2,145,150,0,152,969,976,7,0
16516ref2,3051,3212,JUNC00000100,13,-,3051,3212,255;0;0,2,146,8,0,153,3197,3204,7,0
16516ref2,5005,5307,JUNC00000131,2,+,5005,5307,255;0;0,2,149,146,0,156,5154,5161,7,0
16516ref2,7560,7835,JUNC00000167,3,+,7560,7835,255;0;0,2,118,150,0,125,7678,7685,7,0
16516ref2,7540,7845,JUNC00000168,3,+,7540,7845,255;0;0,2,149,149,0,156,7689,7696,7,0
16516ref2,7718,7881,JUNC00000173,13,+,7718,7881,255;0;0,2,148,8,0,155,7866,7873,7,0
16516ref2,8940,9242,JUNC00000205,7,+,8940,9242,255;0;0,2,147,148,0,154,9087,9094,7,0
16516ref2,10115,10422,JUNC00000226,71,+,10115,10422,255;0;0,2,150,150,0,157,10265,10272,7,0
16516ref2,973,1152,JUNC00000044,37,+,973,1152,255;0;0,2,149,24,0,155,1122,1128,6,0
16516ref2,5729,6015,JUNC00000141,6,+,5729,6015,255;0;0,2,149,131,0,155,5878,5884,6,0
16516ref2,7725,7956,JUNC00000175,15,-,7725,7956,255;0;0,2,150,76,0,155,7875,7880,5,0
16516ref2,8779,9078,JUNC00000199,30767,+,8779,9078,255;0;0,2,144,150,0,149,8923,8928,5,0
16516ref2,9478,9643,JUNC00000214,2,+,9478,9643,255;0;0,2,149,11,0,154,9627,9632,5,0
18009ref1,550,878,JUNC00000001,25,-,550,878,255;0;0,2,8,148,0,180,558,730,172,0
18009ref1,571,851,JUNC00000002,248,+,571,851,255;0;0,2,24,150,0,130,595,701,106,0
18009ref1,485,1407,JUNC00000003,61,+,485,1407,255;0;0,2,142,69,0,853,627,1338,711,0
18009ref1,633,815,JUNC00000004,6,-,633,815,255;0;0,2,19,150,0,32,652,665,13,0
18009ref1,631,958,JUNC00000005,89,+,631,958,255;0;0,2,25,146,0,181,656,812,156,0
18009ref1,565,1052,JUNC00000006,9,+,565,1052,255;0;0,2,91,37,0,450,656,1015,359,0
18009ref1,666,840,JUNC00000007,9,+,666,840,255;0;0,2,8,146,0,28,674,694,20,0
18009ref1,704,1391,JUNC00000008,124,+,704,1391,255;0;0,2,26,96,0,591,730,1295,565,0
18009ref1,683,1000,JUNC00000009,18,+,683,1000,255;0;0,2,49,150,0,167,732,850,118,0
18009ref1,593,899,JUNC00000010,13,+,593,899,255;0;0,2,145,147,0,159,738,752,14,0
18009ref1,630,1528,JUNC00000011,3,-,630,1528,255;0;0,2,127,115,0,783,757,1413,656,0
18009ref1,731,930,JUNC00000012,43,+,731,930,255;0;0,2,39,149,0,50,770,781,11,0
18009ref1,743,1020,JUNC00000013,99,+,743,1020,255;0;0,2,52,149,0,128,795,871,76,0
18009ref1,807,1028,JUNC00000014,6,-,807,1028,255;0;0,2,26,150,0,71,833,878,45,0
18009ref1,701,1018,JUNC00000015,41,+,701,1018,255;0;0,2,148,147,0,170,849,871,22,0
18009ref1,729,957,JUNC00000016,138,+,729,957,255;0;0,2,149,47,0,181,878,910,32,0
18009ref1,825,1124,JUNC00000017,25,+,825,1124,255;0;0,2,144,148,0,151,969,976,7,0
18009ref1,985,1179,JUNC00000018,2,-,985,1179,255;0;0,2,22,148,0,46,1007,1031,24,0
18009ref1,985,1183,JUNC00000019,2,-,985,1183,255;0;0,2,22,149,0,49,1007,1034,27,0
18009ref1,913,1106,JUNC00000020,1,+,913,1106,255;0;0,2,125,25,0,168,1038,1081,43,0
18009ref1,926,1281,JUNC00000021,2,+,926,1281,255;0;0,2,145,148,0,207,1071,1133,62,0
18009ref1,955,1294,JUNC00000022,1210,-,955,1294,255;0;0,2,146,136,0,203,1101,1158,57,0
18009ref1,978,1292,JUNC00000023,18,+,978,1292,255;0;0,2,149,145,0,169,1127,1147,20,0
18009ref1,980,1284,JUNC00000024,25,-,980,1284,255;0;0,2,148,126,0,178,1128,1158,30,0
18009ref1,1001,1255,JUNC00000025,55,-,1001,1255,255;0;0,2,149,97,0,157,1150,1158,8,0
18009ref1,1006,2504,JUNC00000026,25,-,1006,2504,255;0;0,2,144,150,0,1348,1150,2354,1204,0
18009ref1,1157,1792,JUNC00000027,23,+,1157,1792,255;0;0,2,115,149,0,486,1272,1643,371,0
18009ref1,1353,1544,JUNC00000028,2,-,1353,1544,255;0;0,2,10,144,0,47,1363,1400,37,0
18009ref1,1240,1544,JUNC00000029,2,-,1240,1544,255;0;0,2,146,149,0,155,1386,1395,9,0
18009ref1,1277,8886,JUNC00000030,18,+,1277,8886,255;0;0,2,148,150,0,7459,1425,8736,7311,0
18009ref1,1417,1746,JUNC00000031,49,-,1417,1746,255;0;0,2,140,31,0,298,1557,1715,158,0
18009ref1,1417,1867,JUNC00000032,353,+,1417,1867,255;0;0,2,148,144,0,306,1565,1723,158,0
18009ref1,1459,1676,JUNC00000033,32,+,1459,1676,255;0;0,2,146,58,0,159,1605,1618,13,0
18009ref1,1630,1973,JUNC00000034,60,-,1630,1973,255;0;0,2,121,147,0,196,1751,1826,75,0
18009ref1,1647,1987,JUNC00000035,29,-,1647,1987,255;0;0,2,122,149,0,191,1769,1838,69,0
18009ref1,1691,2031,JUNC00000036,16,+,1691,2031,255;0;0,2,109,149,0,191,1800,1882,82,0
18009ref1,1793,2030,JUNC00000037,1,-,1793,2030,255;0;0,2,33,118,0,119,1826,1912,86,0
18009ref1,1777,1941,JUNC00000038,2,-,1777,1941,255;0;0,2,73,29,0,135,1850,1912,62,0
18009ref1,1759,2025,JUNC00000039,2,-,1759,2025,255;0;0,2,101,113,0,153,1860,1912,52,0
18009ref1,1769,2286,JUNC00000040,1,+,1769,2286,255;0;0,2,103,47,0,470,1872,2239,367,0
18009ref1,1962,2194,JUNC00000041,6,+,1962,2194,255;0;0,2,61,150,0,82,2023,2044,21,0
18009ref1,2023,3346,JUNC00000042,1,-,2023,3346,255;0;0,2,24,126,0,1197,2047,3220,1173,0
18009ref1,2112,2505,JUNC00000043,1,-,2112,2505,255;0;0,2,79,72,0,321,2191,2433,242,0
18009ref1,2215,3997,JUNC00000044,29,+,2215,3997,255;0;0,2,95,149,0,1633,2310,3848,1538,0
18009ref1,2240,2556,JUNC00000045,7,+,2240,2556,255;0;0,2,148,149,0,167,2388,2407,19,0
18009ref1,2362,2575,JUNC00000046,18,+,2362,2575,255;0;0,2,26,149,0,64,2388,2426,38,0
18009ref1,2410,2614,JUNC00000047,2,+,2410,2614,255;0;0,2,8,143,0,61,2418,2471,53,0
18009ref1,2309,2768,JUNC00000048,2,-,2309,2768,255;0;0,2,148,124,0,335,2457,2644,187,0
18009ref1,2389,2719,JUNC00000049,12,-,2389,2719,255;0;0,2,147,148,0,182,2536,2571,35,0
18009ref1,2535,2723,JUNC00000050,33,+,2535,2723,255;0;0,2,30,145,0,43,2565,2578,13,0
18009ref1,2432,2778,JUNC00000051,14,+,2432,2778,255;0;0,2,148,149,0,197,2580,2629,49,0
18009ref1,2436,2749,JUNC00000052,8,+,2436,2749,255;0;0,2,148,150,0,163,2584,2599,15,0
18009ref1,2434,2755,JUNC00000053,53,+,2434,2755,255;0;0,2,150,149,0,172,2584,2606,22,0
18009ref1,2449,2781,JUNC00000054,163,-,2449,2781,255;0;0,2,149,148,0,184,2598,2633,35,0
18009ref1,2661,2800,JUNC00000055,10,+,2661,2800,255;0;0,2,9,49,0,90,2670,2751,81,0
18009ref1,2641,2989,JUNC00000056,12,+,2641,2989,255;0;0,2,44,149,0,199,2685,2840,155,0
18009ref1,2609,2939,JUNC00000057,18,-,2609,2939,255;0;0,2,147,150,0,180,2756,2789,33,0
18009ref1,2723,2946,JUNC00000058,18,+,2723,2946,255;0;0,2,48,148,0,75,2771,2798,27,0
18009ref1,2666,2958,JUNC00000059,26,+,2666,2958,255;0;0,2,140,144,0,148,2806,2814,8,0
18009ref1,2667,2858,JUNC00000060,6,-,2667,2858,255;0;0,2,149,26,0,165,2816,2832,16,0
18009ref1,2690,3093,JUNC00000061,2,-,2690,3093,255;0;0,2,126,28,0,375,2816,3065,249,0
18009ref1,2675,3010,JUNC00000062,50,+,2675,3010,255;0;0,2,148,148,0,187,2823,2862,39,0
18009ref1,2699,3016,JUNC00000063,7,+,2699,3016,255;0;0,2,149,150,0,167,2848,2866,18,0
18009ref1,2792,8033,JUNC00000064,674,+,2792,8033,255;0;0,2,127,111,0,5130,2919,7922,5003,0
18009ref1,2883,3163,JUNC00000065,161,-,2883,3163,255;0;0,2,73,149,0,131,2956,3014,58,0
18009ref1,2917,3107,JUNC00000066,2,-,2917,3107,255;0;0,2,148,20,0,170,3065,3087,22,0
18009ref1,3022,3335,JUNC00000067,25,-,3022,3335,255;0;0,2,149,149,0,164,3171,3186,15,0
18009ref1,3180,3434,JUNC00000068,3,-,3180,3434,255;0;0,2,77,150,0,104,3257,3284,27,0
18009ref1,3761,3980,JUNC00000069,113,+,3761,3980,255;0;0,2,25,149,0,70,3786,3831,45,0
18009ref1,3821,4041,JUNC00000070,21,+,3821,4041,255;0;0,2,49,147,0,73,3870,3894,24,0
18009ref1,3781,4134,JUNC00000071,52,+,3781,4134,255;0;0,2,149,148,0,205,3930,3986,56,0
18009ref1,3792,4123,JUNC00000072,25,+,3792,4123,255;0;0,2,147,149,0,182,3939,3974,35,0
18009ref1,3921,4141,JUNC00000073,26,+,3921,4141,255;0;0,2,25,150,0,70,3946,3991,45,0
18009ref1,3926,4309,JUNC00000074,2,+,3926,4309,255;0;0,2,99,52,0,331,4025,4257,232,0
18009ref1,3971,4224,JUNC00000075,104,+,3971,4224,255;0;0,2,90,149,0,104,4061,4075,14,0
18009ref1,4112,4331,JUNC00000076,5,+,4112,4331,255;0;0,2,20,148,0,71,4132,4183,51,0
18009ref1,3988,4335,JUNC00000077,4,+,3988,4335,255;0;0,2,148,148,0,199,4136,4187,51,0
18009ref1,4126,4418,JUNC00000078,15,+,4126,4418,255;0;0,2,131,147,0,145,4257,4271,14,0
18009ref1,4214,4460,JUNC00000079,8,+,4214,4460,255;0;0,2,43,150,0,96,4257,4310,53,0
18009ref1,4165,4650,JUNC00000080,4,-,4165,4650,255;0;0,2,132,82,0,403,4297,4568,271,0
18009ref1,4190,4509,JUNC00000081,2,+,4190,4509,255;0;0,2,139,148,0,171,4329,4361,32,0
18009ref1,4223,4531,JUNC00000082,122,-,4223,4531,255;0;0,2,129,149,0,159,4352,4382,30,0
18009ref1,4397,4646,JUNC00000083,6,+,4397,4646,255;0;0,2,79,149,0,100,4476,4497,21,0
18009ref1,4389,4666,JUNC00000084,1401,-,4389,4666,255;0;0,2,108,111,0,166,4497,4555,58,0
18009ref1,4566,4870,JUNC00000085,6,+,4566,4870,255;0;0,2,147,150,0,154,4713,4720,7,0
18009ref1,4609,4923,JUNC00000086,227,+,4609,4923,255;0;0,2,145,150,0,164,4754,4773,19,0
18009ref1,4757,4926,JUNC00000087,10,+,4757,4926,255;0;0,2,8,143,0,26,4765,4783,18,0
18009ref1,4914,5107,JUNC00000088,1,-,4914,5107,255;0;0,2,45,105,0,88,4959,5002,43,0
18009ref1,4844,5166,JUNC00000089,4,+,4844,5166,255;0;0,2,149,149,0,173,4993,5017,24,0
18009ref1,5299,5959,JUNC00000090,196,-,5299,5959,255;0;0,2,150,147,0,513,5449,5812,363,0
18009ref1,5495,5778,JUNC00000091,8,-,5495,5778,255;0;0,2,105,145,0,138,5600,5633,33,0
18009ref1,5729,6030,JUNC00000092,8,+,5729,6030,255;0;0,2,149,146,0,155,5878,5884,6,0
18009ref1,5893,6374,JUNC00000093,5,+,5893,6374,255;0;0,2,119,143,0,338,6012,6231,219,0
18009ref1,5957,6227,JUNC00000094,2,+,5957,6227,255;0;0,2,148,117,0,153,6105,6110,5,0
18009ref1,6479,6667,JUNC00000095,1,-,6479,6667,255;0;0,2,47,104,0,84,6526,6563,37,0
18009ref1,6687,6966,JUNC00000096,96,+,6687,6966,255;0;0,2,33,148,0,131,6720,6818,98,0
18009ref1,6770,7405,JUNC00000097,105,+,6770,7405,255;0;0,2,25,148,0,487,6795,7257,462,0
18009ref1,6841,7279,JUNC00000098,9,+,6841,7279,255;0;0,2,46,150,0,288,6887,7129,242,0
18009ref1,6744,7280,JUNC00000099,325,-,6744,7280,255;0;0,2,148,146,0,390,6892,7134,242,0
18009ref1,6834,7184,JUNC00000100,96,-,6834,7184,255;0;0,2,91,149,0,201,6925,7035,110,0
18009ref1,6817,7093,JUNC00000101,24,-,6817,7093,255;0;0,2,144,62,0,214,6961,7031,70,0
18009ref1,6994,7640,JUNC00000102,69,+,6994,7640,255;0;0,2,79,146,0,500,7073,7494,421,0
18009ref1,6955,7275,JUNC00000103,12,-,6955,7275,255;0;0,2,146,149,0,171,7101,7126,25,0
18009ref1,7200,7424,JUNC00000104,3,+,7200,7424,255;0;0,2,67,147,0,77,7267,7277,10,0
18009ref1,7217,7711,JUNC00000105,3,+,7217,7711,255;0;0,2,105,143,0,351,7322,7568,246,0
18009ref1,7335,7516,JUNC00000106,24,+,7335,7516,255;0;0,2,19,150,0,31,7354,7366,12,0
18009ref1,7414,7722,JUNC00000107,3,-,7414,7722,255;0;0,2,20,148,0,160,7434,7574,140,0
18009ref1,7363,7728,JUNC00000108,83,-,7363,7728,255;0;0,2,148,150,0,215,7511,7578,67,0
18009ref1,7404,7622,JUNC00000109,39,+,7404,7622,255;0;0,2,150,57,0,161,7554,7565,11,0
18009ref1,7423,7728,JUNC00000110,10,-,7423,7728,255;0;0,2,150,150,0,155,7573,7578,5,0
18009ref1,7551,7917,JUNC00000111,98,+,7551,7917,255;0;0,2,148,44,0,322,7699,7873,174,0
18009ref1,7744,8034,JUNC00000112,3,+,7744,8034,255;0;0,2,56,149,0,141,7800,7885,85,0
18009ref1,7698,8037,JUNC00000113,245,-,7698,8037,255;0;0,2,108,146,0,193,7806,7891,85,0
18009ref1,7718,7945,JUNC00000114,11,+,7718,7945,255;0;0,2,148,60,0,167,7866,7885,19,0
18009ref1,7726,7902,JUNC00000115,10,-,7726,7902,255;0;0,2,149,22,0,154,7875,7880,5,0
18009ref1,7789,8092,JUNC00000116,2,-,7789,8092,255;0;0,2,146,150,0,153,7935,7942,7,0
18009ref1,7899,8133,JUNC00000117,19,+,7899,8133,255;0;0,2,77,147,0,87,7976,7986,10,0
18009ref1,7963,8278,JUNC00000118,130,-,7963,8278,255;0;0,2,149,149,0,166,8112,8129,17,0
18009ref1,8773,9078,JUNC00000119,2149,+,8773,9078,255;0;0,2,150,150,0,155,8923,8928,5,0
18009ref1,8935,9245,JUNC00000120,2,-,8935,9245,255;0;0,2,98,72,0,238,9033,9173,140,0
18009ref1,9548,9780,JUNC00000121,11,+,9548,9780,255;0;0,2,79,148,0,84,9627,9632,5,0
18009ref1,9776,10233,JUNC00000122,2,-,9776,10233,255;0;0,2,48,67,0,390,9824,10166,342,0
19011ref2,1264,8829,JUNC00000042,1,+,1264,8829,255;0;0,2,44,107,0,7458,1308,8722,7414,0
19011ref2,2190,9610,JUNC00000060,2,-,2190,9610,255;0;0,2,86,65,0,7355,2276,9545,7269,0
19011ref2,1064,7622,JUNC00000036,3,-,1064,7622,255;0;0,2,110,41,0,6517,1174,7581,6407,0
19011ref2,3925,9080,JUNC00000087,64,+,3925,9080,255;0;0,2,150,28,0,5127,4075,9052,4977,0
19011ref2,6289,9588,JUNC00000115,4,+,6289,9588,255;0;0,2,47,104,0,3195,6336,9484,3148,0
19011ref2,972,3828,JUNC00000025,229,+,972,3828,255;0;0,2,30,150,0,2706,1002,3678,2676,0
19011ref2,1930,4754,JUNC00000058,1,-,1930,4754,255;0;0,2,117,34,0,2790,2047,4720,2673,0
19011ref2,6066,7738,JUNC00000113,16,+,6066,7738,255;0;0,2,142,150,0,1522,6208,7588,1380,0
19011ref2,7986,9329,JUNC00000146,2,+,7986,9329,255;0;0,2,8,141,0,1202,7994,9188,1194,0
19011ref2,6650,7747,JUNC00000120,2,-,6650,7747,255;0;0,2,148,25,0,1072,6798,7722,924,0
19011ref2,1076,2019,JUNC00000038,494,+,1076,2019,255;0;0,2,148,143,0,800,1224,1876,652,0
19011ref2,503,1158,JUNC00000005,5,+,503,1158,255;0;0,2,31,143,0,512,534,1015,481,0
19011ref2,6979,7614,JUNC00000121,2,+,6979,7614,255;0;0,2,94,120,0,515,7073,7494,421,0
19011ref2,7950,8538,JUNC00000147,222,+,7950,8538,255;0;0,2,57,144,0,444,8007,8394,387,0
19011ref2,463,1004,JUNC00000008,3,+,463,1004,255;0;0,2,145,19,0,522,608,985,377,0
19011ref2,522,1085,JUNC00000007,10,-,522,1085,255;0;0,2,47,147,0,416,569,938,369,0
19011ref2,3865,4372,JUNC00000084,1,-,3865,4372,255;0;0,2,44,107,0,400,3909,4265,356,0
19011ref2,1453,2035,JUNC00000047,7,+,1453,2035,255;0;0,2,83,150,0,432,1536,1885,349,0
19011ref2,2431,2942,JUNC00000067,9,+,2431,2942,255;0;0,2,147,58,0,453,2578,2884,306,0
19011ref2,517,1115,JUNC00000013,3,+,517,1115,255;0;0,2,150,149,0,449,667,966,299,0
19011ref2,871,1453,JUNC00000026,16,+,871,1453,255;0;0,2,144,145,0,437,1015,1308,293,0
19011ref2,355,844,JUNC00000002,3,+,355,844,255;0;0,2,50,148,0,341,405,696,291,0
19011ref2,639,1080,JUNC00000018,1,+,639,1080,255;0;0,2,125,25,0,416,764,1055,291,0
19011ref2,2235,2627,JUNC00000061,3341,+,2235,2627,255;0;0,2,92,24,0,368,2327,2603,276,0
19011ref2,9624,10072,JUNC00000172,2,+,9624,10072,255;0;0,2,96,79,0,369,9720,9993,273,0
19011ref2,4702,5124,JUNC00000098,19,+,4702,5124,255;0;0,2,143,11,0,411,4845,5113,268,0
19011ref2,9587,10115,JUNC00000171,106,+,9587,10115,255;0;0,2,122,145,0,383,9709,9970,261,0
19011ref2,7154,7659,JUNC00000123,16,-,7154,7659,255;0;0,2,147,103,0,402,7301,7556,255,0
19011ref2,9748,10154,JUNC00000174,1,-,9748,10154,255;0;0,2,78,73,0,333,9826,10081,255,0
19011ref2,619,1161,JUNC00000017,22,+,619,1161,255;0;0,2,145,146,0,396,764,1015,251,0
19011ref2,7219,7711,JUNC00000124,3,+,7219,7711,255;0;0,2,103,143,0,349,7322,7568,246,0
19011ref2,3843,4225,JUNC00000085,1,-,3843,4225,255;0;0,2,72,79,0,303,3915,4146,231,0
19011ref2,8530,9046,JUNC00000156,3,+,8530,9046,255;0;0,2,144,144,0,372,8674,8902,228,0
19011ref2,764,1161,JUNC00000020,23,+,764,1161,255;0;0,2,29,146,0,251,793,1015,222,0
19011ref2,3969,4413,JUNC00000086,2,+,3969,4413,255;0;0,2,76,148,0,296,4045,4265,220,0
19011ref2,7687,8194,JUNC00000137,19,+,7687,8194,255;0;0,2,145,147,0,360,7832,8047,215,0
19011ref2,332,838,JUNC00000003,1010,+,332,838,255;0;0,2,149,147,0,359,481,691,210,0
19011ref2,58,441,JUNC00000001,2,+,58,441,255;0;0,2,59,117,0,266,117,324,207,0
19011ref2,7541,7967,JUNC00000129,24,+,7541,7967,255;0;0,2,75,147,0,279,7616,7820,204,0
19011ref2,2701,3111,JUNC00000073,6,+,2701,3111,255;0;0,2,145,64,0,346,2846,3047,201,0
19011ref2,6575,6927,JUNC00000117,2,+,6575,6927,255;0;0,2,127,24,0,328,6702,6903,201,0
19011ref2,7385,7727,JUNC00000126,1,-,7385,7727,255;0;0,2,51,100,0,242,7436,7627,191,0
19011ref2,7790,8132,JUNC00000136,1,+,7790,8132,255;0;0,2,35,116,0,226,7825,8016,191,0
19011ref2,8153,8494,JUNC00000149,1,+,8153,8494,255;0;0,2,38,113,0,228,8191,8381,190,0
19011ref2,477,835,JUNC00000004,2,+,477,835,255;0;0,2,25,147,0,211,502,688,186,0
19011ref2,621,961,JUNC00000019,121,-,621,961,255;0;0,2,149,8,0,332,770,953,183,0
19011ref2,2611,2945,JUNC00000068,3,+,2611,2945,255;0;0,2,46,105,0,229,2657,2840,183,0
19011ref2,2594,2927,JUNC00000071,2,-,2594,2927,255;0;0,2,143,8,0,325,2737,2919,182,0
19011ref2,8815,9288,JUNC00000162,24,+,8815,9288,255;0;0,2,150,147,0,326,8965,9141,176,0
19011ref2,7557,7917,JUNC00000133,9,+,7557,7917,255;0;0,2,142,44,0,316,7699,7873,174,0
19011ref2,9094,9518,JUNC00000168,64,+,9094,9518,255;0;0,2,143,107,0,317,9237,9411,174,0
19011ref2,7550,8007,JUNC00000132,2,+,7550,8007,255;0;0,2,149,140,0,317,7699,7867,168,0
19011ref2,8387,8706,JUNC00000153,1,+,8387,8706,255;0;0,2,51,100,0,219,8438,8606,168,0
19011ref2,4582,5040,JUNC00000097,13,+,4582,5040,255;0;0,2,146,149,0,309,4728,4891,163,0
19011ref2,8816,9233,JUNC00000158,1397,+,8816,9233,255;0;0,2,105,150,0,267,8921,9083,162,0
19011ref2,8904,9215,JUNC00000163,2,+,8904,9215,255;0;0,2,66,85,0,226,8970,9130,160,0
19011ref2,7694,8143,JUNC00000138,10,+,7694,8143,255;0;0,2,143,149,0,300,7837,7994,157,0
19011ref2,649,1018,JUNC00000014,11,+,649,1018,255;0;0,2,68,147,0,222,717,871,154,0
19011ref2,1520,1790,JUNC00000049,2,+,1520,1790,255;0;0,2,48,71,0,199,1568,1719,151,0
19011ref2,693,992,JUNC00000015,1,+,693,992,255;0;0,2,37,114,0,185,730,878,148,0
19011ref2,2561,2938,JUNC00000070,14,+,2561,2938,255;0;0,2,148,82,0,295,2709,2856,147,0
19011ref2,6097,6411,JUNC00000110,3,-,6097,6411,255;0;0,2,23,148,0,166,6120,6263,143,0
19011ref2,2891,3249,JUNC00000076,4674,+,2891,3249,255;0;0,2,149,71,0,287,3040,3178,138,0
19011ref2,8368,8732,JUNC00000155,892,+,8368,8732,255;0;0,2,149,78,0,286,8517,8654,137,0
19011ref2,4432,4718,JUNC00000093,23,-,4432,4718,255;0;0,2,100,51,0,235,4532,4667,135,0
19011ref2,4392,4716,JUNC00000094,30,-,4392,4716,255;0;0,2,147,42,0,282,4539,4674,135,0
19011ref2,9262,9547,JUNC00000169,2,+,9262,9547,255;0;0,2,80,71,0,214,9342,9476,134,0
19011ref2,8675,8970,JUNC00000157,1385,+,8675,8970,255;0;0,2,100,63,0,232,8775,8907,132,0
19011ref2,3885,4167,JUNC00000083,1,+,3885,4167,255;0;0,2,9,142,0,140,3894,4025,131,0
19011ref2,2079,2500,JUNC00000059,3,+,2079,2500,255;0;0,2,146,146,0,275,2225,2354,129,0
19011ref2,420,836,JUNC00000006,7,+,420,836,255;0;0,2,142,148,0,268,562,688,126,0
19011ref2,820,1133,JUNC00000022,14,+,820,1133,255;0;0,2,58,131,0,182,878,1002,124,0
19011ref2,9844,10144,JUNC00000175,2,-,9844,10144,255;0;0,2,38,143,0,157,9882,10001,119,0
19011ref2,1885,2198,JUNC00000056,452,+,1885,2198,255;0;0,2,149,48,0,265,2034,2150,116,0
19011ref2,2343,2608,JUNC00000063,1,+,2343,2608,255;0;0,2,50,101,0,164,2393,2507,114,0
19011ref2,973,1380,JUNC00000034,481,+,973,1380,255;0;0,2,149,146,0,261,1122,1234,112,0
19011ref2,4180,4512,JUNC00000090,2,+,4180,4512,255;0;0,2,143,77,0,255,4323,4435,112,0
19011ref2,707,1078,JUNC00000021,3,+,707,1078,255;0;0,2,119,143,0,228,826,935,109,0
19011ref2,537,877,JUNC00000011,7,+,537,877,255;0;0,2,119,113,0,227,656,764,108,0
19011ref2,1141,1399,JUNC00000039,1,+,1141,1399,255;0;0,2,129,22,0,236,1270,1377,107,0
19011ref2,3830,4085,JUNC00000082,1,-,3830,4085,255;0;0,2,24,127,0,128,3854,3958,104,0
19011ref2,1147,1417,JUNC00000040,15,+,1147,1417,255;0;0,2,148,19,0,251,1295,1398,103,0
19011ref2,1263,1533,JUNC00000041,3,+,1263,1533,255;0;0,2,45,125,0,145,1308,1408,100,0
19011ref2,1290,1546,JUNC00000045,3,-,1290,1546,255;0;0,2,148,8,0,248,1438,1538,100,0
19011ref2,1342,1593,JUNC00000046,2,+,1342,1593,255;0;0,2,123,28,0,223,1465,1565,100,0
19011ref2,8956,9200,JUNC00000161,7,-,8956,9200,255;0;0,2,9,146,0,98,8965,9054,89,0
19011ref2,1744,1983,JUNC00000052,21,-,1744,1983,255;0;0,2,82,71,0,168,1826,1912,86,0
19011ref2,5826,6145,JUNC00000107,4,-,5826,6145,255;0;0,2,146,87,0,232,5972,6058,86,0
19011ref2,10211,10448,JUNC00000181,1,-,10211,10448,255;0;0,2,134,17,0,220,10345,10431,86,0
19011ref2,7804,8040,JUNC00000144,1,+,7804,8040,255;0;0,2,118,33,0,203,7922,8007,85,0
19011ref2,9448,9709,JUNC00000170,19,+,9448,9709,255;0;0,2,58,122,0,139,9506,9587,81,0
19011ref2,517,895,JUNC00000012,4,+,517,895,255;0;0,2,150,150,0,228,667,745,78,0
19011ref2,7768,8136,JUNC00000143,2,-,7768,8136,255;0;0,2,148,144,0,224,7916,7992,76,0
19011ref2,7892,8116,JUNC00000145,1,+,7892,8116,255;0;0,2,48,100,0,124,7940,8016,76,0
19011ref2,1690,1944,JUNC00000050,2,-,1690,1944,255;0;0,2,61,118,0,136,1751,1826,75,0
19011ref2,609,834,JUNC00000010,2,+,609,834,255;0;0,2,47,104,0,121,656,730,74,0
19011ref2,8955,9326,JUNC00000165,10,+,8955,9326,255;0;0,2,149,148,0,223,9104,9178,74,0
19011ref2,9794,10115,JUNC00000176,10,+,9794,10115,255;0;0,2,104,145,0,176,9898,9970,72,0
19011ref2,6635,6999,JUNC00000118,3,+,6635,6999,255;0;0,2,146,148,0,216,6781,6851,70,0
19011ref2,1341,1549,JUNC00000044,22,-,1341,1549,255;0;0,2,22,117,0,91,1363,1432,69,0
19011ref2,1722,1941,JUNC00000054,2,+,1722,1941,255;0;0,2,128,23,0,196,1850,1918,68,0
19011ref2,7362,7727,JUNC00000127,201,-,7362,7727,255;0;0,2,149,149,0,216,7511,7578,67,0
19011ref2,2239,2463,JUNC00000062,156,+,2239,2463,255;0;0,2,149,9,0,215,2388,2454,66,0
19011ref2,9024,9301,JUNC00000166,2,-,9024,9301,255;0;0,2,134,77,0,200,9158,9224,66,0
19011ref2,5805,5998,JUNC00000106,2,+,5805,5998,255;0;0,2,36,93,0,100,5841,5905,64,0
19011ref2,630,850,JUNC00000009,38,+,630,850,255;0;0,2,8,149,0,71,638,701,63,0
19011ref2,2491,2619,JUNC00000065,1,+,2491,2619,255;0;0,2,52,13,0,115,2543,2606,63,0
19011ref2,2419,2638,JUNC00000066,3,-,2419,2638,255;0;0,2,147,9,0,210,2566,2629,63,0
19011ref2,8290,8640,JUNC00000152,76,+,8290,8640,255;0;0,2,148,139,0,211,8438,8501,63,0
19011ref2,2594,2807,JUNC00000069,1,+,2594,2807,255;0;0,2,115,36,0,177,2709,2771,62,0
19011ref2,10049,10262,JUNC00000180,1,+,10049,10262,255;0;0,2,143,8,0,205,10192,10254,62,0
19011ref2,1725,2050,JUNC00000053,3,-,1725,2050,255;0;0,2,115,149,0,176,1840,1901,61,0
19011ref2,7216,7428,JUNC00000125,1,-,7216,7428,255;0;0,2,119,32,0,180,7335,7396,61,0
19011ref2,957,1167,JUNC00000029,8,-,957,1167,255;0;0,2,142,9,0,201,1099,1158,59,0
19011ref2,3626,3835,JUNC00000081,1,-,3626,3835,255;0;0,2,107,44,0,165,3733,3791,58,0
19011ref2,4385,4698,JUNC00000092,64,-,4385,4698,255;0;0,2,112,143,0,170,4497,4555,58,0
19011ref2,4803,5012,JUNC00000099,1,-,4803,5012,255;0;0,2,104,47,0,162,4907,4965,58,0
19011ref2,8378,8586,JUNC00000154,1,+,8378,8586,255;0;0,2,110,40,0,168,8488,8546,58,0
19011ref2,955,1187,JUNC00000030,1131,-,955,1187,255;0;0,2,146,29,0,203,1101,1158,57,0
19011ref2,2698,3055,JUNC00000074,5,+,2698,3055,255;0;0,2,150,150,0,207,2848,2905,57,0
19011ref2,825,1170,JUNC00000024,48,+,825,1170,255;0;0,2,144,148,0,197,969,1022,53,0
19011ref2,1733,1936,JUNC00000055,3,-,1733,1936,255;0;0,2,127,24,0,179,1860,1912,52,0
19011ref2,5653,5856,JUNC00000105,1,+,5653,5856,255;0;0,2,95,56,0,147,5748,5800,52,0
19011ref2,976,1315,JUNC00000032,8,+,976,1315,255;0;0,2,140,150,0,189,1116,1165,49,0
19011ref2,972,1243,JUNC00000033,41,+,972,1243,255;0;0,2,150,72,0,199,1122,1171,49,0
19011ref2,5648,5889,JUNC00000102,17,+,5648,5889,255;0;0,2,44,148,0,93,5692,5741,49,0
19011ref2,7642,7841,JUNC00000134,7,+,7642,7841,255;0;0,2,99,52,0,147,7741,7789,48,0
19011ref2,7789,8036,JUNC00000139,20,+,7789,8036,255;0;0,2,51,148,0,99,7840,7888,48,0
19011ref2,5687,5888,JUNC00000103,644,-,5687,5888,255;0;0,2,8,147,0,54,5695,5741,46,0
19011ref2,2004,2200,JUNC00000057,1,-,2004,2200,255;0;0,2,43,108,0,88,2047,2092,45,0
19011ref2,888,1224,JUNC00000027,57,+,888,1224,255;0;0,2,150,143,0,193,1038,1081,43,0
19011ref2,7766,7967,JUNC00000135,3,-,7766,7967,255;0;0,2,40,118,0,83,7806,7849,43,0
19011ref2,1428,1737,JUNC00000048,8,-,1428,1737,255;0;0,2,121,146,0,163,1549,1591,42,0
19011ref2,9019,9226,JUNC00000167,6,+,9019,9226,255;0;0,2,143,22,0,185,9162,9204,42,0
19011ref2,3226,3418,JUNC00000080,1,+,3226,3418,255;0;0,2,127,24,0,168,3353,3394,41,0
19011ref2,1714,1905,JUNC00000051,1,+,1714,1905,255;0;0,2,112,39,0,152,1826,1866,40,0
19011ref2,5590,5921,JUNC00000104,23,+,5590,5921,255;0;0,2,146,146,0,185,5736,5775,39,0
19011ref2,7515,7714,JUNC00000131,3,+,7515,7714,255;0;0,2,145,15,0,184,7660,7699,39,0
19011ref2,4560,4870,JUNC00000096,13,-,4560,4870,255;0;0,2,129,144,0,166,4689,4726,37,0
19011ref2,7518,7707,JUNC00000130,6,+,7518,7707,255;0;0,2,142,11,0,178,7660,7696,36,0
19011ref2,947,1276,JUNC00000028,4,+,947,1276,255;0;0,2,148,148,0,181,1095,1128,33,0
19011ref2,4228,4480,JUNC00000091,115,-,4228,4480,255;0;0,2,124,98,0,154,4352,4382,30,0
19011ref2,739,919,JUNC00000016,20,+,739,919,255;0;0,2,25,126,0,54,764,793,29,0
19011ref2,10104,10283,JUNC00000179,1,+,10104,10283,255;0;0,2,60,91,0,88,10164,10192,28,0
19011ref2,3184,3433,JUNC00000079,25,-,3184,3433,255;0;0,2,73,149,0,100,3257,3284,27,0
19011ref2,3023,3303,JUNC00000077,123,+,3023,3303,255;0;0,2,148,107,0,173,3171,3196,25,0
19011ref2,1234,1527,JUNC00000043,20,+,1234,1527,255;0;0,2,119,150,0,143,1353,1377,24,0
19011ref2,4935,5151,JUNC00000100,130,-,4935,5151,255;0;0,2,45,149,0,67,4980,5002,22,0
19011ref2,8958,9173,JUNC00000164,2838,+,8958,9173,255;0;0,2,44,149,0,66,9002,9024,22,0
19011ref2,8221,8507,JUNC00000150,13,-,8221,8507,255;0;0,2,119,146,0,140,8340,8361,21,0
19011ref2,3132,3256,JUNC00000078,2,+,3132,3256,255;0;0,2,81,24,0,100,3213,3232,19,0
19011ref2,6111,6290,JUNC00000111,3,-,6111,6290,255;0;0,2,15,146,0,33,6126,6144,18,0
19011ref2,7963,8179,JUNC00000148,31,-,7963,8179,255;0;0,2,149,50,0,166,8112,8129,17,0
19011ref2,4992,5160,JUNC00000101,3,+,4992,5160,255;0;0,2,144,8,0,160,5136,5152,16,0
19011ref2,5903,6212,JUNC00000108,261,+,5903,6212,255;0;0,2,147,146,0,163,6050,6066,16,0
19011ref2,7710,7948,JUNC00000140,7,+,7710,7948,255;0;0,2,147,75,0,163,7857,7873,16,0
19011ref2,7727,8039,JUNC00000142,3,-,7727,8039,255;0;0,2,148,148,0,164,7875,7891,16,0
19011ref2,2680,2993,JUNC00000072,4,+,2680,2993,255;0;0,2,150,148,0,165,2830,2845,15,0
19011ref2,9670,9896,JUNC00000173,24,-,9670,9896,255;0;0,2,139,72,0,154,9809,9824,15,0
19011ref2,9968,10279,JUNC00000178,196,+,9968,10279,255;0;0,2,147,149,0,162,10115,10130,15,0
19011ref2,4203,4418,JUNC00000089,18,+,4203,4418,255;0;0,2,54,147,0,68,4257,4271,14,0
19011ref2,4435,4599,JUNC00000095,1,+,4435,4599,255;0;0,2,131,20,0,144,4566,4579,13,0
19011ref2,2881,3005,JUNC00000075,1,-,2881,3005,255;0;0,2,91,21,0,103,2972,2984,12,0
19011ref2,6970,7279,JUNC00000122,4,+,6970,7279,255;0;0,2,147,150,0,159,7117,7129,12,0
19011ref2,8928,9125,JUNC00000160,7,+,8928,9125,255;0;0,2,37,148,0,49,8965,8977,12,0
19011ref2,5972,6279,JUNC00000109,40,-,5972,6279,255;0;0,2,148,148,0,159,6120,6131,11,0
19011ref2,1001,1204,JUNC00000035,924,-,1001,1204,255;0;0,2,149,46,0,157,1150,1158,8,0
19011ref2,1077,1381,JUNC00000037,9,+,1077,1381,255;0;0,2,147,149,0,155,1224,1232,8,0
19011ref2,824,1126,JUNC00000023,996,+,824,1126,255;0;0,2,145,150,0,152,969,976,7,0
19011ref2,6021,6322,JUNC00000112,4,+,6021,6322,255;0;0,2,147,147,0,154,6168,6175,7,0
19011ref2,6432,6632,JUNC00000116,2,+,6432,6632,255;0;0,2,52,141,0,59,6484,6491,7,0
19011ref2,7717,7898,JUNC00000141,15,+,7717,7898,255;0;0,2,149,25,0,156,7866,7873,7,0
19011ref2,8283,8587,JUNC00000151,6,+,8283,8587,255;0;0,2,148,149,0,155,8431,8438,7,0
19011ref2,965,1269,JUNC00000031,3,+,965,1269,255;0;0,2,149,149,0,155,1114,1120,6,0
19011ref2,3948,4251,JUNC00000088,3,-,3948,4251,255;0;0,2,149,148,0,155,4097,4103,6,0
19011ref2,6069,6233,JUNC00000114,19,+,6069,6233,255;0;0,2,150,8,0,156,6219,6225,6,0
19011ref2,9891,10048,JUNC00000177,1,-,9891,10048,255;0;0,2,125,26,0,131,10016,10022,6,0
19011ref2,2348,2558,JUNC00000064,3,-,2348,2558,255;0;0,2,58,147,0,63,2406,2411,5,0
19011ref2,6650,6951,JUNC00000119,4,-,6650,6951,255;0;0,2,148,148,0,153,6798,6803,5,0
19011ref2,7426,7672,JUNC00000128,4,-,7426,7672,255;0;0,2,147,94,0,152,7573,7578,5,0
19011ref2,8807,9078,JUNC00000159,31340,+,8807,9078,255;0;0,2,116,150,0,121,8923,8928,5,0
18409ref1,230,502,JUNC00000001,37,+,230,502,255;0;0,2,10,147,0,125,240,355,115,0
18409ref1,332,642,JUNC00000002,35,+,332,642,255;0;0,2,149,150,0,160,481,492,11,0
18409ref1,540,875,JUNC00000003,17,-,540,875,255;0;0,2,29,143,0,192,569,732,163,0
18409ref1,549,806,JUNC00000004,18,-,549,806,255;0;0,2,46,148,0,109,595,658,63,0
18409ref1,565,824,JUNC00000005,12,+,565,824,255;0;0,2,48,150,0,109,613,674,61,0
18409ref1,560,10077,JUNC00000006,1,+,560,10077,255;0;0,2,67,84,0,9433,627,9993,9366,0
18409ref1,613,964,JUNC00000007,6,-,613,964,255;0;0,2,21,122,0,229,634,842,208,0
18409ref1,635,957,JUNC00000008,13,+,635,957,255;0;0,2,21,145,0,177,656,812,156,0
18409ref1,632,1026,JUNC00000009,27,+,632,1026,255;0;0,2,24,148,0,246,656,878,222,0
18409ref1,545,1138,JUNC00000010,16,+,545,1138,255;0;0,2,111,123,0,470,656,1015,359,0
18409ref1,641,843,JUNC00000011,31,+,641,843,255;0;0,2,26,149,0,53,667,694,27,0
18409ref1,603,887,JUNC00000012,78,+,603,887,255;0;0,2,71,142,0,142,674,745,71,0
18409ref1,684,1020,JUNC00000013,93,+,684,1020,255;0;0,2,33,149,0,187,717,871,154,0
18409ref1,723,1030,JUNC00000014,25,-,723,1030,255;0;0,2,9,148,0,159,732,882,150,0
18409ref1,600,934,JUNC00000015,23,-,600,934,255;0;0,2,144,149,0,185,744,785,41,0
18409ref1,610,1011,JUNC00000016,5,-,610,1011,255;0;0,2,147,145,0,256,757,866,109,0
18409ref1,742,941,JUNC00000017,27,+,742,941,255;0;0,2,22,129,0,70,764,812,48,0
18409ref1,622,1138,JUNC00000018,17,+,622,1138,255;0;0,2,142,123,0,393,764,1015,251,0
18409ref1,705,1040,JUNC00000019,21,+,705,1040,255;0;0,2,78,148,0,187,783,892,109,0
18409ref1,766,1027,JUNC00000020,52,-,766,1027,255;0;0,2,19,149,0,112,785,878,93,0
18409ref1,773,982,JUNC00000021,51,+,773,982,255;0;0,2,22,150,0,59,795,832,37,0
18409ref1,793,994,JUNC00000022,11,-,793,994,255;0;0,2,23,149,0,52,816,845,29,0
18409ref1,745,1061,JUNC00000023,25,+,745,1061,255;0;0,2,81,147,0,169,826,914,88,0
18409ref1,704,1020,JUNC00000024,8,+,704,1020,255;0;0,2,145,149,0,167,849,871,22,0
18409ref1,708,1009,JUNC00000025,17,-,708,1009,255;0;0,2,147,149,0,152,855,860,5,0
18409ref1,706,1012,JUNC00000026,9,-,706,1012,255;0;0,2,149,146,0,160,855,866,11,0
18409ref1,706,1061,JUNC00000027,18,-,706,1061,255;0;0,2,149,147,0,208,855,914,59,0
18409ref1,817,1028,JUNC00000028,24,+,817,1028,255;0;0,2,50,150,0,61,867,878,11,0
18409ref1,814,1149,JUNC00000029,9,+,814,1149,255;0;0,2,64,147,0,188,878,1002,124,0
18409ref1,766,1069,JUNC00000030,4,-,766,1069,255;0;0,2,150,146,0,157,916,923,7,0
18409ref1,773,1083,JUNC00000031,4,-,773,1083,255;0;0,2,149,148,0,162,922,935,13,0
18409ref1,824,1125,JUNC00000032,34,+,824,1125,255;0;0,2,145,149,0,152,969,976,7,0
18409ref1,825,1171,JUNC00000033,15,+,825,1171,255;0;0,2,144,149,0,197,969,1022,53,0
18409ref1,949,1287,JUNC00000034,59,-,949,1287,255;0;0,2,150,148,0,190,1099,1139,40,0
18409ref1,955,1308,JUNC00000035,868,-,955,1308,255;0;0,2,146,150,0,203,1101,1158,57,0
18409ref1,963,1286,JUNC00000036,10,+,963,1286,255;0;0,2,148,149,0,174,1111,1137,26,0
18409ref1,971,1272,JUNC00000037,4,+,971,1272,255;0;0,2,143,150,0,151,1114,1122,8,0
18409ref1,967,1295,JUNC00000038,2,+,967,1295,255;0;0,2,147,148,0,180,1114,1147,33,0
18409ref1,978,1292,JUNC00000039,36,+,978,1292,255;0;0,2,149,145,0,169,1127,1147,20,0
18409ref1,1142,1304,JUNC00000040,18,-,1142,1304,255;0;0,2,8,149,0,13,1150,1155,5,0
18409ref1,1003,1308,JUNC00000041,108,-,1003,1308,255;0;0,2,147,150,0,155,1150,1158,8,0
18409ref1,1124,1508,JUNC00000042,137,+,1124,1508,255;0;0,2,146,131,0,253,1270,1377,107,0
18409ref1,1385,1710,JUNC00000043,203,+,1385,1710,255;0;0,2,80,145,0,180,1465,1565,100,0
18409ref1,1513,1761,JUNC00000044,77,+,1513,1761,255;0;0,2,35,143,0,105,1548,1618,70,0
18409ref1,1632,2063,JUNC00000045,3,+,1632,2063,255;0;0,2,11,140,0,291,1643,1923,280,0
18409ref1,1642,1829,JUNC00000046,14,+,1642,1829,255;0;0,2,24,146,0,41,1666,1683,17,0
18409ref1,1618,1923,JUNC00000047,9,+,1618,1923,255;0;0,2,131,148,0,157,1749,1775,26,0
18409ref1,1668,1927,JUNC00000048,90,+,1668,1927,255;0;0,2,83,150,0,109,1751,1777,26,0
18409ref1,1804,2030,JUNC00000049,1,-,1804,2030,255;0;0,2,22,129,0,97,1826,1901,75,0
18409ref1,1770,2056,JUNC00000050,15,-,1770,2056,255;0;0,2,56,144,0,142,1826,1912,86,0
18409ref1,1785,1964,JUNC00000051,4,+,1785,1964,255;0;0,2,65,46,0,133,1850,1918,68,0
18409ref1,1756,2059,JUNC00000052,7,-,1756,2059,255;0;0,2,104,147,0,156,1860,1912,52,0
18409ref1,1858,2164,JUNC00000053,10,+,1858,2164,255;0;0,2,149,150,0,156,2007,2014,7,0
18409ref1,1876,6045,JUNC00000054,4,+,1876,6045,255;0;0,2,147,149,0,4020,2023,5896,3873,0
18409ref1,1890,2226,JUNC00000055,173,+,1890,2226,255;0;0,2,144,76,0,260,2034,2150,116,0
18409ref1,2128,2315,JUNC00000056,8,+,2128,2315,255;0;0,2,10,149,0,38,2138,2166,28,0
18409ref1,2140,2540,JUNC00000057,42,+,2140,2540,255;0;0,2,57,147,0,253,2197,2393,196,0
18409ref1,2061,2503,JUNC00000058,31,-,2061,2503,255;0;0,2,146,149,0,293,2207,2354,147,0
18409ref1,2152,2467,JUNC00000059,12,+,2152,2467,255;0;0,2,129,150,0,165,2281,2317,36,0
18409ref1,2174,2598,JUNC00000060,37,+,2174,2598,255;0;0,2,148,147,0,277,2322,2451,129,0
18409ref1,2380,2646,JUNC00000061,6,+,2380,2646,255;0;0,2,18,147,0,119,2398,2499,101,0
18409ref1,2410,2574,JUNC00000062,45,+,2410,2574,255;0;0,2,8,148,0,16,2418,2426,8,0
18409ref1,2438,2753,JUNC00000063,4,+,2438,2753,255;0;0,2,24,150,0,165,2462,2603,141,0
18409ref1,2439,2630,JUNC00000064,18,-,2439,2630,255;0;0,2,25,147,0,44,2464,2483,19,0
18409ref1,2439,2763,JUNC00000065,23,-,2439,2763,255;0;0,2,25,147,0,177,2464,2616,152,0
18409ref1,2330,2763,JUNC00000066,9,-,2330,2763,255;0;0,2,145,147,0,286,2475,2616,141,0
18409ref1,2355,2651,JUNC00000067,2,+,2355,2651,255;0;0,2,146,144,0,152,2501,2507,6,0
18409ref1,2415,2750,JUNC00000068,13,+,2415,2750,255;0;0,2,150,144,0,191,2565,2606,41,0
18409ref1,2417,2720,JUNC00000069,15,-,2417,2720,255;0;0,2,149,149,0,154,2566,2571,5,0
18409ref1,2443,2763,JUNC00000070,5,+,2443,2763,255;0;0,2,150,150,0,170,2593,2613,20,0
18409ref1,2483,2771,JUNC00000071,13,-,2483,2771,255;0;0,2,115,150,0,138,2598,2621,23,0
18409ref1,2597,2777,JUNC00000072,3,+,2597,2777,255;0;0,2,17,148,0,32,2614,2629,15,0
18409ref1,2603,2800,JUNC00000073,8,+,2603,2800,255;0;0,2,44,148,0,49,2647,2652,5,0
18409ref1,2606,2988,JUNC00000074,20,+,2606,2988,255;0;0,2,91,148,0,234,2697,2840,143,0
18409ref1,2751,2920,JUNC00000075,24,-,2751,2920,255;0;0,2,8,149,0,20,2759,2771,12,0
18409ref1,2746,3177,JUNC00000076,125,+,2746,3177,255;0;0,2,25,130,0,301,2771,3047,276,0
18409ref1,2772,2980,JUNC00000077,40,-,2772,2980,255;0;0,2,30,148,0,60,2802,2832,30,0
18409ref1,2659,2987,JUNC00000078,24,+,2659,2987,255;0;0,2,147,147,0,181,2806,2840,34,0
18409ref1,2667,2988,JUNC00000079,16,-,2667,2988,255;0;0,2,149,148,0,173,2816,2840,24,0
18409ref1,2821,2994,JUNC00000080,43,+,2821,2994,255;0;0,2,9,149,0,24,2830,2845,15,0
18409ref1,2698,3006,JUNC00000081,19,+,2698,3006,255;0;0,2,148,150,0,158,2846,2856,10,0
18409ref1,2697,3012,JUNC00000082,11,+,2697,3012,255;0;0,2,149,150,0,165,2846,2862,16,0
18409ref1,2700,3012,JUNC00000083,6,+,2700,3012,255;0;0,2,148,148,0,164,2848,2864,16,0
18409ref1,2717,3030,JUNC00000084,19,+,2717,3030,255;0;0,2,148,149,0,164,2865,2881,16,0
18409ref1,2725,3128,JUNC00000085,24,-,2725,3128,255;0;0,2,148,150,0,253,2873,2978,105,0
18409ref1,2764,3038,JUNC00000086,20,-,2764,3038,255;0;0,2,127,119,0,155,2891,2919,28,0
18409ref1,2743,3062,JUNC00000087,13,+,2743,3062,255;0;0,2,150,150,0,169,2893,2912,19,0
18409ref1,2860,8065,JUNC00000088,378,+,2860,8065,255;0;0,2,59,143,0,5062,2919,7922,5003,0
18409ref1,2802,3127,JUNC00000089,33,-,2802,3127,255;0;0,2,147,143,0,182,2949,2984,35,0
18409ref1,2901,3161,JUNC00000090,130,-,2901,3161,255;0;0,2,48,147,0,113,2949,3014,65,0
18409ref1,2870,3393,JUNC00000091,1,-,2870,3393,255;0;0,2,102,49,0,474,2972,3344,372,0
18409ref1,3008,3170,JUNC00000092,21,-,3008,3170,255;0;0,2,8,149,0,13,3016,3021,5,0
18409ref1,3023,3344,JUNC00000093,57,+,3023,3344,255;0;0,2,148,148,0,173,3171,3196,25,0
18409ref1,3023,3349,JUNC00000094,253,-,3023,3349,255;0;0,2,150,148,0,178,3173,3201,28,0
18409ref1,3641,3975,JUNC00000095,36,-,3641,3975,255;0;0,2,92,149,0,185,3733,3826,93,0
18409ref1,3778,4041,JUNC00000096,836,+,3778,4041,255;0;0,2,44,147,0,116,3822,3894,72,0
18409ref1,3833,4043,JUNC00000097,35,+,3833,4043,255;0;0,2,37,149,0,61,3870,3894,24,0
18409ref1,3748,4170,JUNC00000098,119,+,3748,4170,255;0;0,2,146,145,0,277,3894,4025,131,0
18409ref1,3884,4132,JUNC00000099,6,-,3884,4132,255;0;0,2,25,146,0,102,3909,3986,77,0
18409ref1,3884,4139,JUNC00000100,13,-,3884,4139,255;0;0,2,25,150,0,105,3909,3989,80,0
18409ref1,3868,4205,JUNC00000101,19,-,3868,4205,255;0;0,2,41,148,0,189,3909,4057,148,0
18409ref1,3909,4113,JUNC00000102,11,+,3909,4113,255;0;0,2,21,147,0,57,3930,3966,36,0
18409ref1,3831,4129,JUNC00000103,7,+,3831,4129,255;0;0,2,144,149,0,149,3975,3980,5,0
18409ref1,3875,4400,JUNC00000104,7,+,3875,4400,255;0;0,2,150,143,0,382,4025,4257,232,0
18409ref1,4077,4297,JUNC00000105,103,+,4077,4297,255;0;0,2,43,148,0,72,4120,4149,29,0
18409ref1,4092,4331,JUNC00000106,193,-,4092,4331,255;0;0,2,48,109,0,130,4140,4222,82,0
18409ref1,4089,4646,JUNC00000107,300,-,4089,4646,255;0;0,2,102,149,0,408,4191,4497,306,0
18409ref1,4198,4407,JUNC00000108,6,-,4198,4407,255;0;0,2,41,150,0,59,4239,4257,18,0
18409ref1,4107,4417,JUNC00000109,16,+,4107,4417,255;0;0,2,150,146,0,164,4257,4271,14,0
18409ref1,4244,5968,JUNC00000110,1,+,4244,5968,255;0;0,2,79,72,0,1652,4323,5896,1573,0
18409ref1,4300,4530,JUNC00000111,33,-,4300,4530,255;0;0,2,52,148,0,82,4352,4382,30,0
18409ref1,4232,4414,JUNC00000112,257,-,4232,4414,255;0;0,2,150,26,0,156,4382,4388,6,0
18409ref1,4264,4568,JUNC00000113,87,-,4264,4568,255;0;0,2,149,150,0,154,4413,4418,5,0
18409ref1,4367,4698,JUNC00000114,58,-,4367,4698,255;0;0,2,130,143,0,188,4497,4555,58,0
18409ref1,4393,4727,JUNC00000115,24,-,4393,4727,255;0;0,2,139,60,0,274,4532,4667,135,0
18409ref1,4408,4793,JUNC00000116,14,-,4408,4793,255;0;0,2,131,119,0,266,4539,4674,135,0
18409ref1,4566,4784,JUNC00000117,2,+,4566,4784,255;0;0,2,147,64,0,154,4713,4720,7,0
18409ref1,4721,4928,JUNC00000118,44,+,4721,4928,255;0;0,2,44,145,0,62,4765,4783,18,0
18409ref1,4640,4952,JUNC00000119,57,+,4640,4952,255;0;0,2,125,148,0,164,4765,4804,39,0
18409ref1,4824,5076,JUNC00000120,3,+,4824,5076,255;0;0,2,18,149,0,103,4842,4927,85,0
18409ref1,5133,5791,JUNC00000121,3,-,5133,5791,255;0;0,2,33,148,0,510,5166,5643,477,0
18409ref1,5244,5744,JUNC00000122,14,+,5244,5744,255;0;0,2,49,150,0,350,5293,5594,301,0
18409ref1,5358,5775,JUNC00000123,2,+,5358,5775,255;0;0,2,42,144,0,273,5400,5631,231,0
18409ref1,5268,5855,JUNC00000124,1875,+,5268,5855,255;0;0,2,150,107,0,480,5418,5748,330,0
18409ref1,5427,5614,JUNC00000125,11,+,5427,5614,255;0;0,2,27,149,0,38,5454,5465,11,0
18409ref1,5397,5716,JUNC00000126,7,+,5397,5716,255;0;0,2,146,148,0,171,5543,5568,25,0
18409ref1,5424,5735,JUNC00000127,4,+,5424,5735,255;0;0,2,147,148,0,163,5571,5587,16,0
18409ref1,5452,5780,JUNC00000128,28,-,5452,5780,255;0;0,2,148,147,0,181,5600,5633,33,0
18409ref1,5577,5757,JUNC00000129,1,-,5577,5757,255;0;0,2,27,124,0,56,5604,5633,29,0
18409ref1,5696,5979,JUNC00000130,36,+,5696,5979,255;0;0,2,145,125,0,158,5841,5854,13,0
18409ref1,5728,6031,JUNC00000131,12,+,5728,6031,255;0;0,2,150,147,0,156,5878,5884,6,0
18409ref1,5752,6059,JUNC00000132,4,+,5752,6059,255;0;0,2,149,150,0,157,5901,5909,8,0
18409ref1,5788,6128,JUNC00000133,14,+,5788,6128,255;0;0,2,149,148,0,192,5937,5980,43,0
18409ref1,5804,6139,JUNC00000134,2,-,5804,6139,255;0;0,2,149,146,0,189,5953,5993,40,0
18409ref1,5865,6342,JUNC00000135,95,+,5865,6342,255;0;0,2,147,111,0,366,6012,6231,219,0
18409ref1,6056,6317,JUNC00000136,7,+,6056,6317,255;0;0,2,150,61,0,200,6206,6256,50,0
18409ref1,6392,6636,JUNC00000137,37,+,6392,6636,255;0;0,2,92,145,0,99,6484,6491,7,0
18409ref1,6547,6886,JUNC00000138,2,-,6547,6886,255;0;0,2,147,144,0,195,6694,6742,48,0
18409ref1,6712,6891,JUNC00000139,30,+,6712,6891,255;0;0,2,8,149,0,30,6720,6742,22,0
18409ref1,6681,6968,JUNC00000140,11,-,6681,6968,255;0;0,2,48,150,0,137,6729,6818,89,0
18409ref1,6774,7404,JUNC00000141,30,+,6774,7404,255;0;0,2,21,147,0,483,6795,7257,462,0
18409ref1,6749,6977,JUNC00000142,25,-,6749,6977,255;0;0,2,55,149,0,79,6804,6828,24,0
18409ref1,6810,7357,JUNC00000143,29,-,6810,7357,255;0;0,2,82,143,0,404,6892,7214,322,0
18409ref1,6805,7125,JUNC00000144,3,-,6805,7125,255;0;0,2,146,148,0,172,6951,6977,26,0
18409ref1,6942,7198,JUNC00000145,64,-,6942,7198,255;0;0,2,63,146,0,110,7005,7052,47,0
18409ref1,7120,7390,JUNC00000146,56,+,7120,7390,255;0;0,2,8,150,0,120,7128,7240,112,0
18409ref1,7130,7448,JUNC00000147,6,-,7130,7448,255;0;0,2,148,150,0,168,7278,7298,20,0
18409ref1,7155,7366,JUNC00000148,12,-,7155,7366,255;0;0,2,146,24,0,187,7301,7342,41,0
18409ref1,7179,7525,JUNC00000149,129,-,7179,7525,255;0;0,2,146,149,0,197,7325,7376,51,0
18409ref1,7259,7699,JUNC00000150,79,-,7259,7699,255;0;0,2,150,139,0,301,7409,7560,151,0
18409ref1,7362,7725,JUNC00000151,118,-,7362,7725,255;0;0,2,149,147,0,216,7511,7578,67,0
18409ref1,7385,7579,JUNC00000152,3,-,7385,7579,255;0;0,2,145,23,0,171,7530,7556,26,0
18409ref1,7424,7621,JUNC00000153,11,-,7424,7621,255;0;0,2,149,43,0,154,7573,7578,5,0
18409ref1,7550,7761,JUNC00000154,10,-,7550,7761,255;0;0,2,23,147,0,64,7573,7614,41,0
18409ref1,7511,7837,JUNC00000155,4,+,7511,7837,255;0;0,2,149,141,0,185,7660,7696,36,0
18409ref1,7539,7845,JUNC00000156,3,+,7539,7845,255;0;0,2,150,149,0,157,7689,7696,7,0
18409ref1,7703,7956,JUNC00000157,24,-,7703,7956,255;0;0,2,49,150,0,103,7752,7806,54,0
18409ref1,7754,8066,JUNC00000158,23,-,7754,8066,255;0;0,2,25,150,0,162,7779,7916,137,0
18409ref1,7685,7993,JUNC00000159,8,-,7685,7993,255;0;0,2,121,144,0,164,7806,7849,43,0
18409ref1,7721,8064,JUNC00000160,18,-,7721,8064,255;0;0,2,145,148,0,195,7866,7916,50,0
18409ref1,7727,8027,JUNC00000161,2,-,7727,8027,255;0;0,2,148,147,0,153,7875,7880,5,0
18409ref1,7964,8276,JUNC00000162,46,-,7964,8276,255;0;0,2,148,147,0,165,8112,8129,17,0
18409ref1,7966,8281,JUNC00000163,11,-,7966,8281,255;0;0,2,149,150,0,165,8115,8131,16,0
18409ref1,8311,8498,JUNC00000164,3,+,8311,8498,255;0;0,2,107,24,0,163,8418,8474,56,0
18409ref1,8282,8629,JUNC00000165,7,+,8282,8629,255;0;0,2,149,145,0,202,8431,8484,53,0
18409ref1,8343,8695,JUNC00000166,6,+,8343,8695,255;0;0,2,145,149,0,203,8488,8546,58,0
18409ref1,8524,9092,JUNC00000167,28,+,8524,9092,255;0;0,2,150,143,0,425,8674,8949,275,0
18409ref1,8699,9084,JUNC00000168,2,+,8699,9084,255;0;0,2,76,144,0,241,8775,8940,165,0
18409ref1,8687,9001,JUNC00000169,3,+,8687,9001,255;0;0,2,95,150,0,164,8782,8851,69,0
18409ref1,8776,9078,JUNC00000170,595,+,8776,9078,255;0;0,2,147,150,0,152,8923,8928,5,0
18409ref1,9061,9260,JUNC00000171,2,-,9061,9260,255;0;0,2,17,128,0,71,9078,9132,54,0
18409ref1,9015,9212,JUNC00000172,2,+,9015,9212,255;0;0,2,147,8,0,189,9162,9204,42,0
18409ref1,9047,9384,JUNC00000173,153,+,9047,9384,255;0;0,2,150,150,0,187,9197,9234,37,0
18409ref1,9356,9676,JUNC00000174,487,+,9356,9676,255;0;0,2,150,146,0,174,9506,9530,24,0
18409ref1,9767,9971,JUNC00000175,20,+,9767,9971,255;0;0,2,8,148,0,56,9775,9823,48,0
18409ref1,9668,9972,JUNC00000176,152,-,9668,9972,255;0;0,2,141,148,0,156,9809,9824,15,0